Time Steps,Polymerase Count,Active Histone Count,Acetylated Histone Count,Methylated Histone Count,Unmodified Histone Count,Noisy Changes Count,Enzyme Changes Count
1,0,30,0,30,30,0,0
1001,0,40,4,36,20,0,0
2001,0,43,11,32,17,0,0
3001,0,43,17,26,17,0,0
4001,0,40,31,9,20,0,0
5001,0,40,26,14,20,0,0
6001,0,33,24,9,27,1,0
7001,0,36,17,19,24,0,0
8001,0,32,21,11,28,0,0
9001,0,32,16,16,28,0,0
10001,0,38,31,7,22,0,0
11001,0,40,17,23,20,0,0
12001,0,35,12,23,25,1,0
13001,0,36,15,21,24,0,0
14001,0,34,6,28,26,0,0
15001,0,35,3,32,25,1,0
16001,0,35,16,19,25,0,0
17001,0,39,17,22,21,0,0
18001,0,37,7,30,23,0,0
19001,0,39,23,16,21,0,0
20001,0,33,13,20,27,0,0
21001,0,30,17,13,30,0,0
22001,0,36,25,11,24,0,0
23001,0,43,33,10,17,0,0
24001,0,33,5,28,27,0,0
25001,0,38,20,18,22,0,0
26001,0,31,24,7,29,0,0
27001,0,32,10,22,28,0,1
28001,0,25,15,10,35,0,0
29001,0,30,13,17,30,0,0
30001,0,34,15,19,26,0,0
31001,0,39,12,27,21,0,0
32001,0,35,13,22,25,0,0
33001,0,40,9,31,20,0,0
34001,0,35,18,17,25,0,0
35001,0,41,30,11,19,0,0
36001,0,37,26,11,23,0,0
37001,0,33,14,19,27,1,1
38001,0,39,20,19,21,0,1
39001,0,45,36,9,15,0,0
40001,0,46,44,2,14,0,0
41001,0,32,23,9,28,0,0
42001,0,47,38,9,13,0,0
43001,0,37,31,6,23,0,0
44001,0,28,16,12,32,0,1
45001,0,35,12,23,25,0,1
46001,0,35,5,30,25,0,0
47001,0,36,13,23,24,1,1
48001,0,38,2,36,22,0,0
49001,0,36,12,24,24,0,0
50001,0,41,29,12,19,0,0
51001,0,40,24,16,20,0,0
52001,0,44,41,3,16,0,0
53001,0,41,38,3,19,0,0
54001,0,38,24,14,22,0,1
55001,0,31,16,15,29,0,0
56001,0,33,11,22,27,0,0
57001,0,37,14,23,23,0,0
58001,0,40,29,11,20,0,1
59001,0,33,19,14,27,0,0
60001,0,37,17,20,23,0,1
61001,0,30,19,11,30,0,0
62001,0,38,4,34,22,0,0
63001,0,40,3,37,20,0,0
64001,0,45,5,40,15,0,0
65001,0,35,4,31,25,0,0
66001,0,35,18,17,25,0,0
67001,0,39,29,10,21,0,0
68001,0,34,22,12,26,0,1
69001,0,34,19,15,26,0,0
70001,0,38,34,4,22,0,0
71001,0,42,40,2,18,0,0
72001,0,47,45,2,13,0,0
73001,0,43,42,1,17,0,0
74001,0,42,36,6,18,0,0
75001,0,35,32,3,25,1,0
76001,0,39,23,16,21,0,0
77001,0,31,24,7,29,0,0
78001,0,42,14,28,18,0,0
79001,0,35,20,15,25,0,0
80001,0,36,14,22,24,1,0
81001,0,37,21,16,23,0,0
82001,0,42,36,6,18,1,0
83001,0,31,8,23,29,0,0
84001,0,39,4,35,21,1,0
85001,0,38,13,25,22,1,0
86001,0,31,6,25,29,0,0
87001,0,35,26,9,25,0,0
88001,0,31,24,7,29,0,1
89001,0,38,25,13,22,0,0
90001,0,33,22,11,27,0,0
91001,0,38,24,14,22,0,0
92001,0,40,5,35,20,0,0
93001,0,40,1,39,20,0,0
94001,0,30,4,26,30,0,0
95001,0,45,19,26,15,0,0
96001,0,37,27,10,23,0,0
97001,0,35,17,18,25,0,0
98001,0,43,9,34,17,0,1
99001,0,45,7,38,15,0,0
100001,0,35,15,20,25,0,0
101001,0,43,30,13,17,0,0
102001,0,34,26,8,26,0,0
103001,0,26,13,13,34,0,0
104001,0,33,23,10,27,0,0
105001,0,40,18,22,20,0,0
106001,0,41,23,18,19,0,0
107001,0,36,25,11,24,0,0
108001,0,37,34,3,23,0,0
109001,0,33,19,14,27,0,0
110001,0,30,15,15,30,0,0
111001,0,30,13,17,30,0,0
112001,0,34,23,11,26,0,0
113001,0,41,28,13,19,0,0
114001,0,41,34,7,19,0,0
115001,0,42,29,13,18,0,0
116001,0,40,37,3,20,0,0
117001,0,38,22,16,22,0,0
118001,0,40,30,10,20,0,1
119001,0,31,21,10,29,0,1
120001,0,39,15,24,21,0,0
121001,0,31,8,23,29,0,0
122001,0,45,31,14,15,0,0
123001,0,32,23,9,28,0,1
124001,0,32,22,10,28,0,0
125001,0,38,38,0,22,0,0
126001,0,43,42,1,17,1,0
127001,0,37,29,8,23,1,1
128001,0,39,10,29,21,0,0
129001,0,39,26,13,21,0,0
130001,0,33,13,20,27,0,1
131001,0,36,16,20,24,0,0
132001,0,36,27,9,24,0,0
133001,0,34,30,4,26,0,0
134001,0,36,7,29,24,0,1
135001,0,38,25,13,22,0,1
136001,0,37,34,3,23,0,0
137001,0,40,34,6,20,0,0
138001,0,35,25,10,25,0,0
139001,0,42,33,9,18,0,0
140001,0,33,20,13,27,0,0
141001,0,37,16,21,23,0,0
142001,0,30,22,8,30,0,0
143001,0,38,31,7,22,0,0
144001,0,24,11,13,36,0,1
145001,0,37,16,21,23,0,0
146001,0,36,9,27,24,0,0
147001,0,41,4,37,19,0,0
148001,0,35,15,20,25,0,0
149001,0,51,47,4,9,0,0
150001,0,40,32,8,20,0,0
151001,0,39,32,7,21,0,1
152001,0,39,32,7,21,0,0
153001,0,29,24,5,31,0,0
154001,0,41,22,19,19,0,0
155001,0,33,14,19,27,0,1
156001,0,37,23,14,23,0,0
157001,0,31,15,16,29,0,1
158001,0,36,7,29,24,0,0
159001,0,32,14,18,28,0,0
160001,0,37,26,11,23,0,0
161001,0,31,22,9,29,0,0
162001,0,39,27,12,21,0,0
163001,0,37,23,14,23,0,0
164001,0,40,35,5,20,0,0
165001,0,30,2,28,30,0,0
166001,0,26,12,14,34,0,0
167001,0,40,10,30,20,0,0
168001,0,33,4,29,27,0,0
169001,0,33,8,25,27,0,0
170001,0,33,0,33,27,0,0
171001,0,35,1,34,25,0,0
172001,0,41,6,35,19,0,1
173001,0,38,26,12,22,0,0
174001,0,45,40,5,15,0,0
175001,0,39,32,7,21,0,0
176001,0,28,12,16,32,0,1
177001,0,35,18,17,25,0,1
178001,0,44,25,19,16,0,1
179001,0,37,22,15,23,0,1
180001,0,30,19,11,30,0,0
181001,0,41,26,15,19,1,0
182001,0,31,18,13,29,0,0
183001,0,44,27,17,16,0,0
184001,0,35,17,18,25,0,0
185001,0,37,17,20,23,0,0
186001,0,36,8,28,24,0,0
187001,0,40,4,36,20,0,1
188001,0,36,7,29,24,0,0
189001,0,37,2,35,23,0,0
190001,0,34,11,23,26,0,0
191001,0,32,8,24,28,0,0
192001,0,35,28,7,25,0,0
193001,0,33,29,4,27,0,0
194001,0,34,21,13,26,0,1
195001,0,38,7,31,22,0,0
196001,0,40,7,33,20,0,0
197001,0,29,12,17,31,0,0
198001,0,36,15,21,24,0,0
199001,0,39,31,8,21,0,0
200001,0,39,22,17,21,0,0
201001,0,35,17,18,25,0,1
202001,0,42,6,36,18,0,0
203001,0,42,7,35,18,0,0
204001,0,32,14,18,28,0,0
205001,0,37,32,5,23,0,0
206001,0,34,33,1,26,0,0
207001,0,33,20,13,27,0,0
208001,0,29,20,9,31,0,0
209001,0,41,32,9,19,0,1
210001,0,45,30,15,15,0,0
211001,0,31,17,14,29,1,0
212001,0,37,24,13,23,0,0
213001,0,38,12,26,22,0,0
214001,0,38,9,29,22,0,0
215001,0,31,8,23,29,0,0
216001,0,40,14,26,20,0,1
217001,0,42,11,31,18,0,0
218001,0,38,22,16,22,1,0
219001,0,46,45,1,14,0,0
220001,0,41,30,11,19,0,0
221001,0,34,21,13,26,0,0
222001,0,37,19,18,23,0,1
223001,0,37,10,27,23,0,0
224001,0,36,1,35,24,0,0
225001,0,39,15,24,21,0,0
226001,0,39,26,13,21,0,0
227001,0,35,17,18,25,0,0
228001,0,36,8,28,24,0,0
229001,0,41,17,24,19,0,0
230001,0,38,24,14,22,0,0
231001,0,39,28,11,21,1,0
232001,0,39,30,9,21,0,0
233001,0,31,11,20,29,0,0
234001,0,37,13,24,23,0,0
235001,0,36,25,11,24,1,0
236001,0,30,20,10,30,0,0
237001,0,27,17,10,33,0,0
238001,0,36,25,11,24,0,0
239001,0,35,19,16,25,0,0
240001,0,30,6,24,30,0,0
241001,0,31,11,20,29,0,0
242001,0,37,20,17,23,0,1
243001,0,46,33,13,14,0,0
244001,0,37,25,12,23,0,0
245001,0,38,10,28,22,0,0
246001,0,39,14,25,21,0,0
247001,0,39,3,36,21,0,0
248001,0,35,10,25,25,0,1
249001,0,36,10,26,24,0,0
250001,0,39,19,20,21,0,0
251001,0,38,27,11,22,0,1
252001,0,35,23,12,25,0,1
253001,0,32,7,25,28,1,0
254001,0,40,16,24,20,0,0
255001,0,35,27,8,25,0,0
256001,0,35,32,3,25,0,1
257001,0,37,21,16,23,0,0
258001,0,31,9,22,29,1,0
259001,0,42,5,37,18,0,0
260001,0,42,17,25,18,1,0
261001,0,36,27,9,24,0,0
262001,0,29,16,13,31,0,0
263001,0,41,18,23,19,0,0
264001,0,37,15,22,23,0,0
265001,0,32,11,21,28,0,0
266001,0,35,28,7,25,0,0
267001,0,42,17,25,18,0,0
268001,0,35,8,27,25,0,0
269001,0,37,19,18,23,0,0
270001,0,24,15,9,36,1,0
271001,0,42,40,2,18,0,0
272001,0,39,26,13,21,0,0
273001,0,37,25,12,23,0,0
274001,0,36,19,17,24,0,1
275001,0,37,30,7,23,0,0
276001,0,38,20,18,22,0,1
277001,0,32,17,15,28,0,0
278001,0,31,12,19,29,0,0
279001,0,38,4,34,22,0,0
280001,0,29,4,25,31,0,0
281001,0,36,9,27,24,0,1
282001,0,41,18,23,19,1,0
283001,0,38,18,20,22,0,0
284001,0,32,23,9,28,0,1
285001,0,36,15,21,24,1,0
286001,0,35,15,20,25,0,0
287001,0,43,10,33,17,0,0
288001,0,36,21,15,24,0,0
289001,0,35,29,6,25,0,1
290001,0,44,37,7,16,0,0
291001,0,35,28,7,25,0,0
292001,0,34,28,6,26,0,0
293001,0,41,18,23,19,0,0
294001,0,34,6,28,26,0,1
295001,0,35,9,26,25,0,0
296001,0,35,6,29,25,0,0
297001,0,35,6,29,25,0,1
298001,0,42,4,38,18,0,0
299001,0,45,2,43,15,0,0
300001,0,30,9,21,30,0,0
301001,0,38,25,13,22,1,0
302001,0,34,15,19,26,0,1
303001,0,29,14,15,31,1,0
304001,0,41,31,10,19,0,0
305001,0,42,35,7,18,0,0
306001,0,45,39,6,15,0,0
307001,0,36,34,2,24,0,0
308001,0,38,33,5,22,0,0
309001,0,34,16,18,26,1,1
310001,0,31,13,18,29,0,0
311001,0,34,11,23,26,1,1
312001,0,40,9,31,20,0,0
313001,0,33,15,18,27,1,0
314001,0,32,9,23,28,0,0
315001,0,36,25,11,24,1,0
316001,0,38,33,5,22,0,0
317001,0,42,35,7,18,0,0
318001,0,38,33,5,22,0,0
319001,0,42,31,11,18,0,0
320001,0,37,8,29,23,0,0
321001,0,34,17,17,26,0,0
322001,0,43,16,27,17,0,0
323001,0,37,17,20,23,0,0
324001,0,38,14,24,22,0,0
325001,0,33,6,27,27,0,0
326001,0,44,3,41,16,0,1
327001,0,39,8,31,21,0,0
328001,0,38,15,23,22,0,0
329001,0,37,18,19,23,0,0
330001,0,25,3,22,35,0,0
331001,0,41,2,39,19,0,0
332001,0,26,10,16,34,0,0
333001,0,29,21,8,31,0,0
334001,0,30,20,10,30,0,0
335001,0,39,7,32,21,0,0
336001,0,37,16,21,23,0,1
337001,0,30,12,18,30,0,0
338001,0,36,13,23,24,0,0
339001,0,36,14,22,24,0,1
340001,0,36,24,12,24,0,0
341001,0,37,26,11,23,0,0
342001,0,35,17,18,25,0,1
343001,0,42,11,31,18,0,0
344001,0,43,6,37,17,0,0
345001,0,42,4,38,18,0,1
346001,0,39,2,37,21,0,0
347001,0,36,5,31,24,0,0
348001,0,34,21,13,26,0,1
349001,0,31,14,17,29,0,0
350001,0,32,20,12,28,0,0
351001,0,36,22,14,24,0,0
352001,0,37,19,18,23,0,0
353001,0,35,14,21,25,0,0
354001,0,34,24,10,26,0,0
355001,0,33,11,22,27,0,0
356001,0,38,6,32,22,0,0
357001,0,35,12,23,25,0,0
358001,0,42,11,31,18,0,0
359001,0,29,12,17,31,0,0
360001,0,34,12,22,26,1,0
361001,0,40,15,25,20,0,0
362001,0,35,12,23,25,0,0
363001,0,27,7,20,33,1,0
364001,0,43,35,8,17,0,0
365001,0,39,31,8,21,0,0
366001,0,33,19,14,27,0,0
367001,0,33,20,13,27,0,0
368001,0,40,9,31,20,0,0
369001,0,35,5,30,25,0,0
370001,0,34,8,26,26,0,1
371001,0,35,5,30,25,0,0
372001,0,43,4,39,17,1,0
373001,0,38,2,36,22,0,0
374001,0,41,8,33,19,0,1
375001,0,35,24,11,25,0,0
376001,0,35,17,18,25,0,0
377001,0,38,13,25,22,0,0
378001,0,33,18,15,27,0,0
379001,0,30,13,17,30,0,1
380001,0,41,34,7,19,0,0
381001,0,43,41,2,17,0,0
382001,0,31,24,7,29,1,0
383001,0,36,29,7,24,0,0
384001,0,33,24,9,27,0,0
385001,0,38,29,9,22,0,1
386001,0,35,20,15,25,0,0
387001,0,32,9,23,28,0,0
388001,0,38,10,28,22,0,1
389001,0,36,2,34,24,0,0
390001,0,39,10,29,21,0,0
391001,0,34,24,10,26,0,1
392001,0,31,23,8,29,0,0
393001,0,35,26,9,25,0,0
394001,0,41,26,15,19,0,1
395001,0,37,8,29,23,0,0
396001,0,26,12,14,34,0,1
397001,0,32,24,8,28,0,0
398001,0,38,31,7,22,0,0
399001,0,34,24,10,26,0,0
400001,0,32,24,8,28,0,0
401001,0,37,18,19,23,0,1
402001,0,39,8,31,21,0,0
403001,0,37,11,26,23,0,0
404001,0,34,14,20,26,0,0
405001,0,39,20,19,21,0,0
406001,0,34,19,15,26,1,0
407001,0,39,11,28,21,0,0
408001,0,42,29,13,18,0,0
409001,0,37,22,15,23,0,0
410001,0,42,34,8,18,1,0
411001,0,36,31,5,24,0,0
412001,0,38,30,8,22,0,0
413001,0,38,26,12,22,0,0
414001,0,39,27,12,21,0,1
415001,0,35,23,12,25,0,0
416001,0,36,16,20,24,0,0
417001,0,42,25,17,18,0,0
418001,0,34,11,23,26,0,0
419001,0,32,11,21,28,0,0
420001,0,30,8,22,30,0,1
421001,0,38,16,22,22,0,0
422001,0,35,24,11,25,0,0
423001,0,37,25,12,23,0,0
424001,0,36,23,13,24,0,0
425001,0,37,21,16,23,1,0
426001,0,36,7,29,24,0,0
427001,0,39,27,12,21,0,0
428001,0,39,34,5,21,0,0
429001,0,31,13,18,29,0,0
430001,0,40,19,21,20,0,0
431001,0,28,18,10,32,0,0
432001,0,38,22,16,22,0,0
433001,0,39,20,19,21,0,0
434001,0,42,7,35,18,0,0
435001,0,31,11,20,29,0,0
436001,0,35,21,14,25,0,0
437001,0,34,24,10,26,0,0
438001,0,32,25,7,28,0,0
439001,0,37,27,10,23,0,1
440001,0,43,31,12,17,0,0
441001,0,34,21,13,26,0,0
442001,0,37,21,16,23,0,0
443001,0,35,24,11,25,0,0
444001,0,36,32,4,24,0,0
445001,0,40,34,6,20,0,0
446001,0,41,37,4,19,0,0
447001,0,42,35,7,18,0,0
448001,0,33,11,22,27,0,0
449001,0,39,12,27,21,0,0
450001,0,34,4,30,26,0,0
451001,0,40,16,24,20,0,0
452001,0,37,14,23,23,0,0
453001,0,33,12,21,27,0,0
454001,0,35,11,24,25,1,0
455001,0,37,9,28,23,0,0
456001,0,36,15,21,24,0,0
457001,0,34,25,9,26,0,0
458001,0,31,18,13,29,0,0
459001,0,41,22,19,19,0,0
460001,0,44,6,38,16,0,0
461001,0,33,5,28,27,0,0
462001,0,41,4,37,19,0,1
463001,0,32,13,19,28,0,0
464001,0,38,19,19,22,0,0
465001,0,37,27,10,23,0,0
466001,0,38,36,2,22,0,0
467001,0,37,33,4,23,0,0
468001,0,40,31,9,20,0,0
469001,0,40,35,5,20,0,0
470001,0,38,30,8,22,0,0
471001,0,37,29,8,23,0,1
472001,0,43,41,2,17,0,0
473001,0,36,21,15,24,0,0
474001,0,31,15,16,29,0,0
475001,0,33,12,21,27,1,0
476001,0,34,12,22,26,0,1
477001,0,33,8,25,27,0,0
478001,0,31,13,18,29,0,0
479001,0,41,37,4,19,0,1
480001,0,40,38,2,20,0,0
481001,0,40,37,3,20,0,1
482001,0,43,37,6,17,0,0
483001,0,31,27,4,29,0,0
484001,0,35,28,7,25,0,1
485001,0,37,11,26,23,0,0
486001,0,36,10,26,24,0,0
487001,0,40,7,33,20,0,0
488001,0,45,4,41,15,0,0
489001,0,33,14,19,27,0,0
490001,0,37,15,22,23,0,0
491001,0,28,7,21,32,0,0
492001,0,40,15,25,20,0,0
493001,0,33,17,16,27,0,0
494001,0,37,25,12,23,0,1
495001,0,32,19,13,28,1,0
496001,0,39,34,5,21,0,0
497001,0,39,31,8,21,0,0
498001,0,38,13,25,22,0,0
499001,0,42,0,42,18,0,0
500001,0,33,7,26,27,0,0
501001,0,36,15,21,24,1,1
502001,0,33,24,9,27,0,0
503001,0,36,27,9,24,0,0
504001,0,47,43,4,13,0,0
505001,0,30,20,10,30,0,0
506001,0,32,28,4,28,0,0
507001,0,37,10,27,23,0,0
508001,0,38,14,24,22,0,0
509001,0,40,24,16,20,0,0
510001,0,30,13,17,30,0,0
511001,0,40,12,28,20,0,0
512001,0,43,6,37,17,0,0
513001,0,40,4,36,20,0,1
514001,0,34,10,24,26,0,1
515001,0,26,9,17,34,0,0
516001,0,37,13,24,23,0,1
517001,0,32,20,12,28,0,0
518001,0,39,25,14,21,0,0
519001,0,35,32,3,25,0,0
520001,0,38,22,16,22,0,1
521001,0,28,16,12,32,0,0
522001,0,30,12,18,30,0,0
523001,0,38,23,15,22,0,0
524001,0,37,19,18,23,0,0
525001,0,34,10,24,26,0,0
526001,0,34,6,28,26,0,0
527001,0,41,15,26,19,1,0
528001,0,37,20,17,23,0,0
529001,0,33,29,4,27,0,0
530001,0,37,30,7,23,0,1
531001,0,41,32,9,19,0,1
532001,0,31,5,26,29,0,0
533001,0,31,5,26,29,0,0
534001,0,42,29,13,18,0,1
535001,0,37,23,14,23,0,0
536001,0,31,8,23,29,0,0
537001,0,39,6,33,21,1,0
538001,0,34,11,23,26,1,0
539001,0,30,13,17,30,0,0
540001,0,44,2,42,16,0,0
541001,0,43,7,36,17,0,1
542001,0,40,13,27,20,0,0
543001,0,36,20,16,24,0,0
544001,0,35,15,20,25,0,0
545001,0,37,6,31,23,0,0
546001,0,34,20,14,26,0,0
547001,0,47,7,40,13,0,0
548001,0,45,1,44,15,0,0
549001,0,44,4,40,16,0,0
550001,0,37,16,21,23,1,0
551001,0,43,21,22,17,0,1
552001,0,36,14,22,24,0,0
553001,0,29,11,18,31,0,0
554001,0,39,10,29,21,0,0
555001,0,32,24,8,28,0,0
556001,0,34,16,18,26,0,1
557001,0,34,12,22,26,0,0
558001,0,30,10,20,30,0,1
559001,0,34,14,20,26,0,0
560001,0,35,24,11,25,0,1
561001,0,41,35,6,19,0,0
562001,0,39,36,3,21,0,0
563001,0,42,35,7,18,0,0
564001,0,41,24,17,19,1,0
565001,0,35,16,19,25,0,0
566001,0,27,11,16,33,0,0
567001,0,35,25,10,25,0,0
568001,0,44,34,10,16,0,0
569001,0,32,13,19,28,1,1
570001,0,34,12,22,26,0,0
571001,0,34,18,16,26,0,0
572001,0,36,21,15,24,0,0
573001,0,39,18,21,21,0,1
574001,0,38,26,12,22,0,0
575001,0,36,8,28,24,0,0
576001,0,41,6,35,19,0,0
577001,0,41,9,32,19,0,0
578001,0,41,7,34,19,0,0
579001,0,39,6,33,21,0,0
580001,0,39,14,25,21,0,0
581001,0,41,4,37,19,0,0
582001,0,41,10,31,19,0,0
583001,0,39,18,21,21,0,0
584001,0,40,12,28,20,0,0
585001,0,40,8,32,20,0,0
586001,0,32,12,20,28,0,0
587001,0,37,29,8,23,0,0
588001,0,35,29,6,25,0,1
589001,0,38,25,13,22,0,0
590001,0,27,15,12,33,0,0
591001,0,35,6,29,25,0,0
592001,0,41,5,36,19,0,0
593001,0,42,3,39,18,0,0
594001,0,42,3,39,18,0,0
595001,0,49,6,43,11,0,0
596001,0,40,1,39,20,0,0
597001,0,36,12,24,24,0,0
598001,0,36,21,15,24,0,0
599001,0,34,14,20,26,0,0
600001,0,38,9,29,22,0,0
601001,0,33,17,16,27,0,1
602001,0,41,11,30,19,0,1
603001,0,32,14,18,28,0,0
604001,0,33,14,19,27,0,0
605001,0,36,3,33,24,0,1
606001,0,33,11,22,27,0,1
607001,0,32,21,11,28,0,0
608001,0,36,27,9,24,0,0
609001,0,42,35,7,18,0,0
610001,0,35,24,11,25,0,1
611001,0,36,25,11,24,0,1
612001,0,38,28,10,22,0,0
613001,0,36,25,11,24,0,1
614001,0,36,23,13,24,0,0
615001,0,34,14,20,26,0,0
616001,0,36,31,5,24,0,0
617001,0,36,23,13,24,0,0
618001,0,41,11,30,19,0,0
619001,0,40,15,25,20,0,1
620001,0,34,27,7,26,0,0
621001,0,41,39,2,19,0,1
622001,0,42,38,4,18,0,0
623001,0,37,22,15,23,0,0
624001,0,34,27,7,26,0,0
625001,0,40,29,11,20,0,0
626001,0,39,34,5,21,0,0
627001,0,40,29,11,20,0,0
628001,0,45,40,5,15,1,0
629001,0,41,36,5,19,1,0
630001,0,36,29,7,24,0,0
631001,0,37,25,12,23,0,0
632001,0,30,14,16,30,0,0
633001,0,42,28,14,18,0,0
634001,0,30,17,13,30,0,0
635001,0,37,11,26,23,0,0
636001,0,37,10,27,23,0,0
637001,0,31,11,20,29,0,0
638001,0,26,15,11,34,0,0
639001,0,42,32,10,18,0,0
640001,0,45,40,5,15,0,0
641001,0,43,39,4,17,0,0
642001,0,36,21,15,24,0,0
643001,0,38,19,19,22,0,0
644001,0,32,14,18,28,0,0
645001,0,40,3,37,20,0,0
646001,0,30,9,21,30,0,0
647001,0,44,6,38,16,0,0
648001,0,33,13,20,27,0,0
649001,0,29,13,16,31,0,0
650001,0,32,27,5,28,0,0
651001,0,37,30,7,23,0,0
652001,0,43,35,8,17,0,0
653001,0,35,32,3,25,0,0
654001,0,36,23,13,24,1,0
655001,0,37,30,7,23,0,0
656001,0,37,25,12,23,0,0
657001,0,42,14,28,18,0,0
658001,0,38,5,33,22,0,0
659001,0,36,9,27,24,0,0
660001,0,38,33,5,22,1,0
661001,0,37,15,22,23,0,0
662001,0,40,23,17,20,0,1
663001,0,36,23,13,24,0,0
664001,0,39,14,25,21,0,0
665001,0,43,22,21,17,0,0
666001,0,37,28,9,23,0,1
667001,0,36,30,6,24,0,0
668001,0,36,26,10,24,0,0
669001,0,34,7,27,26,0,0
670001,0,38,24,14,22,0,0
671001,0,32,23,9,28,0,0
672001,0,36,18,18,24,0,0
673001,0,40,6,34,20,0,0
674001,0,36,11,25,24,0,1
675001,0,47,42,5,13,0,1
676001,0,36,14,22,24,0,0
677001,0,32,21,11,28,0,0
678001,0,40,32,8,20,0,0
679001,0,35,23,12,25,0,0
680001,0,31,14,17,29,0,0
681001,0,37,12,25,23,0,0
682001,0,35,16,19,25,0,0
683001,0,33,12,21,27,0,0
684001,0,34,16,18,26,0,0
685001,0,34,13,21,26,0,0
686001,0,40,21,19,20,1,0
687001,0,36,31,5,24,0,0
688001,0,38,33,5,22,0,0
689001,0,33,19,14,27,0,1
690001,0,36,18,18,24,0,0
691001,0,34,12,22,26,1,0
692001,0,36,27,9,24,0,0
693001,0,32,24,8,28,0,0
694001,0,41,26,15,19,0,0
695001,0,32,20,12,28,0,0
696001,0,37,13,24,23,0,0
697001,0,32,17,15,28,0,0
698001,0,36,5,31,24,0,0
699001,0,36,4,32,24,1,1
700001,0,36,7,29,24,0,0
701001,0,30,7,23,30,0,0
702001,0,33,12,21,27,1,0
703001,0,35,13,22,25,0,0
704001,0,37,25,12,23,0,1
705001,0,41,14,27,19,0,0
706001,0,39,12,27,21,1,0
707001,0,44,11,33,16,0,1
708001,0,36,1,35,24,0,0
709001,0,40,8,32,20,0,1
710001,0,40,2,38,20,0,0
711001,0,42,10,32,18,0,1
712001,0,35,10,25,25,0,0
713001,0,31,13,18,29,0,0
714001,0,40,32,8,20,0,1
715001,0,40,14,26,20,0,0
716001,0,43,39,4,17,0,0
717001,0,38,31,7,22,1,0
718001,0,39,8,31,21,0,0
719001,0,43,5,38,17,0,0
720001,0,38,16,22,22,0,0
721001,0,33,31,2,27,0,0
722001,0,41,32,9,19,0,0
723001,0,38,32,6,22,0,1
724001,0,35,19,16,25,1,1
725001,0,30,22,8,30,0,1
726001,0,35,26,9,25,0,0
727001,0,36,17,19,24,0,0
728001,0,39,35,4,21,0,0
729001,0,37,15,22,23,0,0
730001,0,35,29,6,25,0,0
731001,0,40,29,11,20,0,1
732001,0,36,21,15,24,0,0
733001,0,39,25,14,21,1,0
734001,0,35,13,22,25,0,0
735001,0,26,11,15,34,0,0
736001,0,39,8,31,21,0,0
737001,0,28,3,25,32,0,0
738001,0,46,10,36,14,0,0
739001,0,31,7,24,29,0,0
740001,0,36,11,25,24,0,0
741001,0,40,37,3,20,0,0
742001,0,35,16,19,25,1,0
743001,0,48,7,41,12,0,1
744001,0,47,0,47,13,0,0
745001,0,45,1,44,15,0,0
746001,0,41,5,36,19,0,1
747001,0,33,15,18,27,0,0
748001,0,32,16,16,28,0,0
749001,0,40,10,30,20,0,0
750001,0,40,4,36,20,0,1
751001,0,30,12,18,30,0,1
752001,0,36,4,32,24,0,0
753001,0,43,2,41,17,0,0
754001,0,33,7,26,27,0,0
755001,0,35,11,24,25,0,0
756001,0,38,17,21,22,0,0
757001,0,43,23,20,17,0,0
758001,0,40,24,16,20,0,0
759001,0,34,14,20,26,0,0
760001,0,34,18,16,26,0,0
761001,0,36,22,14,24,0,0
762001,0,29,12,17,31,0,0
763001,0,41,18,23,19,0,1
764001,0,46,9,37,14,0,0
765001,0,39,5,34,21,0,0
766001,0,33,16,17,27,0,0
767001,0,26,19,7,34,0,1
768001,0,38,30,8,22,0,0
769001,0,33,18,15,27,0,0
770001,0,41,9,32,19,0,0
771001,0,39,29,10,21,0,0
772001,0,36,19,17,24,0,0
773001,0,36,10,26,24,0,0
774001,0,35,20,15,25,0,1
775001,0,40,18,22,20,1,0
776001,0,30,10,20,30,0,1
777001,0,42,6,36,18,0,0
778001,0,36,15,21,24,0,0
779001,0,36,24,12,24,0,0
780001,0,34,14,20,26,0,0
781001,0,36,9,27,24,0,0
782001,0,39,14,25,21,0,0
783001,0,37,21,16,23,0,0
784001,0,36,25,11,24,1,0
785001,0,37,20,17,23,1,0
786001,0,34,26,8,26,1,0
787001,0,27,16,11,33,0,0
788001,0,37,19,18,23,0,0
789001,0,38,37,1,22,0,0
790001,0,33,21,12,27,0,1
791001,0,38,21,17,22,0,0
792001,0,38,27,11,22,0,0
793001,0,32,7,25,28,0,1
794001,0,40,4,36,20,1,0
795001,0,35,13,22,25,0,0
796001,0,39,13,26,21,1,0
797001,0,43,3,40,17,0,0
798001,0,39,12,27,21,0,0
799001,0,36,12,24,24,0,0
800001,0,39,22,17,21,0,1
801001,0,37,30,7,23,0,0
802001,0,36,29,7,24,0,0
803001,0,41,23,18,19,0,0
804001,0,33,17,16,27,0,0
805001,0,31,8,23,29,0,0
806001,0,36,14,22,24,1,0
807001,0,38,27,11,22,0,0
808001,0,37,11,26,23,0,0
809001,0,40,18,22,20,0,1
810001,0,40,32,8,20,1,0
811001,0,46,41,5,14,0,0
812001,0,43,38,5,17,0,0
813001,0,35,24,11,25,0,0
814001,0,45,24,21,15,0,0
815001,0,39,31,8,21,0,0
816001,0,31,19,12,29,0,0
817001,0,40,10,30,20,0,1
818001,0,35,17,18,25,0,0
819001,0,39,30,9,21,0,0
820001,0,40,14,26,20,0,1
821001,0,43,9,34,17,0,0
822001,0,33,7,26,27,0,0
823001,0,41,23,18,19,0,1
824001,0,34,21,13,26,0,0
825001,0,46,20,26,14,0,0
826001,0,43,35,8,17,0,0
827001,0,28,19,9,32,0,0
828001,0,38,18,20,22,1,0
829001,0,41,9,32,19,0,0
830001,0,38,34,4,22,0,0
831001,0,38,32,6,22,0,0
832001,0,30,11,19,30,0,0
833001,0,43,0,43,17,1,0
834001,0,34,10,24,26,0,0
835001,0,29,25,4,31,0,0
836001,0,35,26,9,25,0,0
837001,0,30,16,14,30,0,1
838001,0,40,23,17,20,0,0
839001,0,36,6,30,24,0,0
840001,0,41,15,26,19,0,1
841001,0,34,21,13,26,0,0
842001,0,39,4,35,21,0,0
843001,0,33,5,28,27,0,0
844001,0,39,35,4,21,1,0
845001,0,36,26,10,24,0,0
846001,0,35,23,12,25,0,0
847001,0,36,28,8,24,0,0
848001,0,38,31,7,22,1,0
849001,0,41,30,11,19,1,0
850001,0,33,12,21,27,0,0
851001,0,38,16,22,22,0,0
852001,0,45,16,29,15,0,0
853001,0,27,14,13,33,0,0
854001,0,33,23,10,27,0,0
855001,0,41,28,13,19,0,1
856001,0,40,18,22,20,1,0
857001,0,41,34,7,19,0,0
858001,0,24,18,6,36,0,0
859001,0,37,25,12,23,1,0
860001,0,33,18,15,27,0,0
861001,0,38,31,7,22,0,0
862001,0,32,23,9,28,0,0
863001,0,39,21,18,21,0,0
864001,0,43,10,33,17,0,0
865001,0,33,19,14,27,0,0
866001,0,37,31,6,23,0,0
867001,0,44,32,12,16,0,1
868001,0,36,27,9,24,0,0
869001,0,35,30,5,25,0,0
870001,0,39,23,16,21,0,0
871001,0,38,9,29,22,0,0
872001,0,39,11,28,21,0,0
873001,0,33,18,15,27,0,0
874001,0,46,40,6,14,0,0
875001,0,36,24,12,24,0,0
876001,0,30,15,15,30,0,0
877001,0,40,25,15,20,1,0
878001,0,31,26,5,29,0,0
879001,0,42,29,13,18,1,0
880001,0,39,26,13,21,0,0
881001,0,33,25,8,27,0,0
882001,0,41,9,32,19,0,0
883001,0,39,26,13,21,0,0
884001,0,37,26,11,23,0,0
885001,0,38,5,33,22,0,0
886001,0,40,13,27,20,0,0
887001,0,33,22,11,27,0,0
888001,0,33,24,9,27,0,0
889001,0,42,25,17,18,0,0
890001,0,40,5,35,20,0,0
891001,0,36,14,22,24,0,0
892001,0,37,10,27,23,0,0
893001,0,37,16,21,23,0,0
894001,0,31,13,18,29,0,0
895001,0,38,25,13,22,0,0
896001,0,28,16,12,32,0,1
897001,0,35,32,3,25,0,0
898001,0,39,26,13,21,0,0
899001,0,39,33,6,21,0,0
900001,0,41,31,10,19,0,0
901001,0,38,22,16,22,0,0
902001,0,39,18,21,21,0,1
903001,0,32,9,23,28,0,0
904001,0,43,5,38,17,0,0
905001,0,34,7,27,26,0,0
906001,0,39,8,31,21,0,0
907001,0,40,15,25,20,0,0
908001,0,41,14,27,19,0,0
909001,0,37,7,30,23,0,1
910001,0,39,4,35,21,0,0
911001,0,44,0,44,16,0,0
912001,0,35,7,28,25,0,0
913001,0,31,14,17,29,0,0
914001,0,39,26,13,21,0,0
915001,0,30,21,9,30,0,0
916001,0,38,20,18,22,0,0
917001,0,35,8,27,25,0,0
918001,0,37,25,12,23,1,1
919001,0,37,23,14,23,0,0
920001,0,43,28,15,17,0,0
921001,0,33,5,28,27,0,0
922001,0,40,8,32,20,0,0
923001,0,32,5,27,28,1,1
924001,0,37,16,21,23,0,0
925001,0,38,17,21,22,0,1
926001,0,35,21,14,25,0,0
927001,0,33,13,20,27,0,0
928001,0,32,11,21,28,0,0
929001,0,41,37,4,19,0,0
930001,0,38,36,2,22,0,0
931001,0,40,28,12,20,0,0
932001,0,46,33,13,14,0,0
933001,0,46,43,3,14,0,0
934001,0,37,29,8,23,0,0
935001,0,42,32,10,18,0,0
936001,0,41,34,7,19,0,0
937001,0,35,19,16,25,0,0
938001,0,41,26,15,19,0,0
939001,0,36,23,13,24,0,0
940001,0,45,3,42,15,0,0
941001,0,48,8,40,12,0,0
942001,0,34,9,25,26,0,0
943001,0,38,26,12,22,0,0
944001,0,32,18,14,28,1,0
945001,0,29,12,17,31,1,0
946001,0,34,17,17,26,0,0
947001,0,39,32,7,21,0,0
948001,0,39,35,4,21,0,0
949001,0,42,38,4,18,0,0
950001,0,27,13,14,33,0,0
951001,0,35,14,21,25,0,1
952001,0,36,35,1,24,0,0
953001,0,35,29,6,25,0,0
954001,0,32,19,13,28,1,0
955001,0,38,32,6,22,0,0
956001,0,35,31,4,25,1,0
957001,0,37,23,14,23,0,0
958001,0,38,2,36,22,0,1
959001,0,34,15,19,26,0,0
960001,0,30,22,8,30,0,0
961001,0,36,29,7,24,0,0
962001,0,41,30,11,19,0,1
963001,0,39,30,9,21,0,1
964001,0,37,11,26,23,0,0
965001,0,44,5,39,16,0,0
966001,0,41,2,39,19,0,0
967001,0,28,7,21,32,1,0
968001,0,29,23,6,31,0,1
969001,0,34,22,12,26,0,0
970001,0,35,28,7,25,0,0
971001,0,35,22,13,25,0,0
972001,0,42,31,11,18,1,0
973001,0,34,26,8,26,0,0
974001,0,32,19,13,28,0,0
975001,0,40,34,6,20,1,1
976001,0,37,20,17,23,0,0
977001,0,36,14,22,24,0,0
978001,0,39,23,16,21,0,0
979001,0,31,18,13,29,0,0
980001,0,36,23,13,24,0,0
981001,0,38,21,17,22,0,0
982001,0,33,17,16,27,0,0
983001,0,31,5,26,29,0,0
984001,0,45,6,39,15,0,0
985001,0,38,5,33,22,1,0
986001,0,37,2,35,23,0,0
987001,0,45,2,43,15,0,0
988001,0,38,8,30,22,0,0
989001,0,43,4,39,17,0,0
990001,0,41,6,35,19,0,0
991001,0,31,11,20,29,0,1
992001,0,37,21,16,23,0,1
993001,0,36,19,17,24,0,1
994001,0,37,23,14,23,1,0
995001,0,31,20,11,29,0,1
996001,0,41,11,30,19,0,0
997001,0,38,28,10,22,0,0
998001,0,40,34,6,20,0,0
999001,0,37,11,26,23,0,0
