Time Steps,Polymerase Count,Active Histone Count,Acetylated Histone Count,Methylated Histone Count,Unmodified Histone Count,Noisy Changes Count,Enzyme Changes Count,Chromatine Array
1,1,104,95,9,94,0,0,"['A' 'A' 'U' 'A' 'U' 'U' 'U' 'A' 'A' 'U' 'U' 'U' 'U' 'A' 'A' 'U' 'U' 'A'
 'U' 'U' 'A' 'A' 'U' 'A' 'U' 'A' 'U' 'U' 'A' 'U' 'U' 'U' 'U' 'U' 'A' 'U'
 'U' 'A' 'U' 'A' 'A' 'U' 'U' 'A' 'A' 'U' 'U' 'A' 'A' 'A' 'A' 'U' 'A' 'A'
 'A' 'U' 'U' 'A' 'A' 'A' 'U' 'A' 'U' 'A' 'A' 'M' 'M' 'M' 'M' 'M' 'M' 'M'
 'M' 'M' 'U' 'U' 'U' 'A' 'U' 'A' 'A' 'A' 'U' 'A' 'A' 'U' 'A' 'A' 'A' 'A'
 'U' 'A' 'A' 'U' 'A' 'U' 'U' 'U' 'U' 'A' 'U' 'U' 'A' 'A' 'U' 'A' 'A' 'A'
 'A' 'U' 'A' 'U' 'A' 'U' 'U' 'U' 'A' 'U' 'A' 'U' 'A' 'A' 'U' 'A' 'U' 'U'
 'U' 'U' 'A' 'A' 'A' 'A' 'U' 'A' 'A' 'U' 'A' 'U' 'U' 'U' 'U' 'U' 'U' 'U'
 'A' 'A' 'U' 'U' 'U' 'A' 'U' 'A' 'A' 'A' 'A' 'A' 'U' 'A' 'U' 'U' 'A' 'U'
 'U' 'U' 'U' 'A' 'A' 'U' 'U' 'A' 'U' 'U' 'U' 'A' 'A' 'U' 'U' 'A' 'A' 'A'
 'A' 'A' 'A' 'A' 'U' 'U' 'A' 'U' 'A' 'U' 'A' 'U' 'A' 'U' 'A' 'U' 'A' 'A']"
101,3,118,100,18,80,0,0,"['A' 'A' 'U' 'U' 'U' 'U' 'A' 'A' 'A' 'U' 'U' 'U' 'M' 'A' 'A' 'U' 'U' 'U'
 'U' 'U' 'A' 'A' 'U' 'A' 'U' 'A' 'U' 'U' 'A' 'A' 'U' 'U' 'U' 'A' 'A' 'U'
 'U' 'U' 'A' 'A' 'A' 'U' 'U' 'A' 'A' 'U' 'M' 'A' 'A' 'A' 'A' 'U' 'A' 'A'
 'A' 'U' 'U' 'A' 'A' 'A' 'U' 'A' 'M' 'A' 'A' 'M' 'M' 'U' 'M' 'M' 'M' 'M'
 'M' 'M' 'M' 'U' 'U' 'A' 'U' 'A' 'U' 'U' 'U' 'A' 'A' 'U' 'A' 'A' 'A' 'A'
 'A' 'U' 'A' 'U' 'A' 'U' 'U' 'U' 'U' 'M' 'U' 'M' 'A' 'A' 'A' 'A' 'A' 'A'
 'A' 'U' 'A' 'U' 'U' 'U' 'U' 'U' 'A' 'U' 'A' 'U' 'A' 'A' 'U' 'A' 'M' 'U'
 'A' 'A' 'A' 'A' 'U' 'A' 'A' 'A' 'A' 'A' 'A' 'A' 'A' 'U' 'M' 'U' 'A' 'U'
 'A' 'A' 'U' 'U' 'U' 'A' 'U' 'A' 'A' 'A' 'A' 'A' 'U' 'A' 'U' 'U' 'A' 'U'
 'U' 'M' 'A' 'A' 'A' 'A' 'U' 'A' 'U' 'U' 'A' 'A' 'A' 'U' 'U' 'A' 'A' 'A'
 'A' 'A' 'A' 'A' 'U' 'U' 'M' 'U' 'A' 'U' 'A' 'U' 'A' 'U' 'A' 'U' 'U' 'A']"
201,1,118,97,21,80,0,0,"['A' 'A' 'U' 'U' 'M' 'U' 'A' 'A' 'A' 'M' 'U' 'A' 'M' 'A' 'U' 'U' 'U' 'U'
 'U' 'U' 'A' 'A' 'U' 'U' 'U' 'A' 'U' 'U' 'A' 'U' 'U' 'U' 'U' 'A' 'A' 'A'
 'U' 'A' 'A' 'A' 'A' 'U' 'U' 'A' 'A' 'A' 'M' 'U' 'A' 'A' 'A' 'U' 'A' 'U'
 'U' 'U' 'U' 'A' 'A' 'U' 'M' 'U' 'M' 'A' 'A' 'M' 'M' 'M' 'M' 'M' 'U' 'M'
 'M' 'M' 'M' 'U' 'U' 'U' 'A' 'A' 'A' 'U' 'U' 'A' 'U' 'A' 'A' 'A' 'A' 'A'
 'A' 'U' 'A' 'U' 'A' 'A' 'U' 'A' 'U' 'M' 'U' 'M' 'U' 'A' 'A' 'U' 'A' 'A'
 'A' 'U' 'A' 'U' 'U' 'A' 'U' 'U' 'A' 'A' 'A' 'U' 'A' 'A' 'U' 'U' 'M' 'U'
 'A' 'A' 'A' 'A' 'U' 'U' 'U' 'A' 'A' 'A' 'A' 'A' 'A' 'U' 'M' 'U' 'A' 'M'
 'A' 'A' 'U' 'A' 'U' 'U' 'A' 'A' 'A' 'U' 'A' 'A' 'U' 'A' 'A' 'U' 'A' 'U'
 'U' 'M' 'A' 'A' 'A' 'U' 'U' 'A' 'U' 'U' 'A' 'A' 'A' 'U' 'U' 'A' 'U' 'A'
 'A' 'A' 'A' 'A' 'U' 'U' 'A' 'U' 'A' 'U' 'A' 'A' 'A' 'U' 'A' 'U' 'A' 'U']"
301,2,128,101,27,70,1,0,"['A' 'A' 'U' 'U' 'M' 'U' 'A' 'A' 'A' 'M' 'A' 'A' 'M' 'A' 'U' 'A' 'M' 'M'
 'U' 'U' 'A' 'A' 'A' 'U' 'U' 'A' 'U' 'U' 'A' 'A' 'U' 'U' 'U' 'U' 'A' 'A'
 'U' 'A' 'U' 'A' 'A' 'U' 'U' 'A' 'A' 'A' 'M' 'A' 'U' 'A' 'A' 'M' 'A' 'U'
 'U' 'U' 'U' 'A' 'A' 'U' 'M' 'U' 'U' 'A' 'A' 'M' 'M' 'M' 'M' 'M' 'M' 'U'
 'M' 'M' 'M' 'U' 'U' 'U' 'A' 'A' 'A' 'U' 'U' 'A' 'U' 'A' 'A' 'U' 'A' 'A'
 'A' 'A' 'A' 'A' 'A' 'A' 'U' 'A' 'U' 'U' 'U' 'M' 'U' 'A' 'A' 'A' 'U' 'A'
 'A' 'M' 'A' 'U' 'U' 'A' 'U' 'U' 'A' 'A' 'A' 'U' 'A' 'A' 'A' 'U' 'M' 'U'
 'A' 'A' 'A' 'U' 'U' 'A' 'A' 'A' 'A' 'A' 'A' 'A' 'A' 'A' 'M' 'U' 'A' 'M'
 'U' 'A' 'A' 'U' 'U' 'M' 'U' 'A' 'A' 'M' 'A' 'U' 'A' 'A' 'A' 'U' 'A' 'U'
 'M' 'M' 'A' 'A' 'A' 'U' 'A' 'U' 'U' 'U' 'A' 'A' 'A' 'U' 'U' 'A' 'M' 'U'
 'A' 'A' 'A' 'A' 'A' 'A' 'A' 'U' 'A' 'U' 'A' 'A' 'U' 'U' 'A' 'U' 'A' 'U']"
401,2,118,93,25,80,0,0,"['A' 'A' 'A' 'U' 'U' 'U' 'A' 'U' 'A' 'U' 'U' 'A' 'M' 'A' 'U' 'A' 'U' 'M'
 'U' 'U' 'A' 'A' 'A' 'U' 'U' 'A' 'U' 'U' 'A' 'A' 'U' 'U' 'U' 'U' 'A' 'A'
 'U' 'A' 'U' 'U' 'M' 'U' 'U' 'A' 'A' 'A' 'M' 'A' 'U' 'A' 'A' 'M' 'U' 'A'
 'U' 'U' 'U' 'A' 'A' 'U' 'M' 'U' 'U' 'A' 'A' 'U' 'M' 'M' 'M' 'M' 'M' 'M'
 'M' 'M' 'M' 'A' 'M' 'U' 'A' 'A' 'A' 'U' 'U' 'A' 'U' 'U' 'A' 'U' 'A' 'A'
 'A' 'A' 'A' 'A' 'A' 'A' 'U' 'A' 'M' 'U' 'U' 'U' 'U' 'A' 'U' 'A' 'A' 'U'
 'A' 'U' 'A' 'U' 'M' 'U' 'U' 'U' 'U' 'U' 'A' 'U' 'A' 'A' 'A' 'A' 'M' 'U'
 'A' 'A' 'A' 'U' 'U' 'U' 'A' 'A' 'A' 'A' 'A' 'A' 'A' 'A' 'U' 'U' 'U' 'M'
 'U' 'A' 'A' 'U' 'U' 'M' 'U' 'A' 'U' 'M' 'A' 'U' 'A' 'A' 'A' 'U' 'U' 'U'
 'M' 'M' 'A' 'A' 'A' 'U' 'A' 'A' 'U' 'U' 'A' 'U' 'A' 'U' 'U' 'A' 'M' 'A'
 'A' 'U' 'A' 'A' 'A' 'A' 'A' 'A' 'U' 'U' 'A' 'A' 'A' 'A' 'A' 'U' 'U' 'A']"
501,2,121,91,30,77,1,0,"['A' 'A' 'A' 'U' 'U' 'U' 'A' 'U' 'A' 'U' 'M' 'A' 'U' 'A' 'U' 'A' 'U' 'U'
 'U' 'U' 'U' 'U' 'A' 'U' 'U' 'U' 'U' 'U' 'A' 'A' 'M' 'U' 'U' 'U' 'A' 'A'
 'M' 'A' 'U' 'U' 'M' 'A' 'A' 'A' 'A' 'A' 'M' 'A' 'U' 'A' 'U' 'M' 'U' 'A'
 'U' 'U' 'U' 'A' 'A' 'A' 'M' 'U' 'U' 'A' 'A' 'M' 'M' 'M' 'M' 'M' 'M' 'M'
 'M' 'M' 'U' 'U' 'M' 'U' 'U' 'U' 'A' 'U' 'M' 'A' 'M' 'U' 'A' 'U' 'A' 'A'
 'A' 'A' 'A' 'A' 'A' 'A' 'U' 'A' 'U' 'U' 'U' 'A' 'U' 'A' 'U' 'A' 'A' 'U'
 'A' 'U' 'A' 'U' 'M' 'A' 'M' 'M' 'U' 'U' 'A' 'U' 'A' 'U' 'U' 'A' 'M' 'U'
 'A' 'A' 'A' 'U' 'U' 'A' 'A' 'A' 'A' 'A' 'A' 'A' 'A' 'A' 'U' 'U' 'U' 'M'
 'A' 'A' 'U' 'A' 'U' 'M' 'U' 'U' 'U' 'M' 'A' 'A' 'A' 'U' 'A' 'U' 'U' 'U'
 'M' 'M' 'A' 'A' 'U' 'A' 'A' 'A' 'U' 'U' 'A' 'U' 'A' 'A' 'M' 'A' 'M' 'U'
 'A' 'U' 'A' 'A' 'A' 'A' 'A' 'A' 'U' 'A' 'U' 'A' 'A' 'A' 'A' 'U' 'A' 'A']"
601,1,125,85,40,73,0,0,"['A' 'A' 'U' 'U' 'U' 'A' 'U' 'U' 'A' 'U' 'M' 'U' 'M' 'U' 'M' 'A' 'U' 'U'
 'U' 'U' 'U' 'M' 'A' 'U' 'U' 'M' 'U' 'A' 'A' 'U' 'U' 'M' 'U' 'M' 'A' 'M'
 'M' 'U' 'U' 'U' 'U' 'A' 'A' 'A' 'U' 'A' 'M' 'A' 'U' 'U' 'U' 'U' 'U' 'A'
 'U' 'U' 'M' 'A' 'A' 'M' 'M' 'U' 'A' 'A' 'A' 'M' 'M' 'M' 'M' 'M' 'M' 'M'
 'U' 'M' 'M' 'M' 'M' 'A' 'U' 'U' 'A' 'A' 'M' 'A' 'M' 'U' 'U' 'A' 'A' 'A'
 'A' 'A' 'A' 'A' 'M' 'U' 'U' 'M' 'U' 'U' 'A' 'A' 'A' 'M' 'U' 'A' 'A' 'U'
 'U' 'U' 'A' 'A' 'M' 'U' 'M' 'M' 'A' 'U' 'U' 'U' 'A' 'U' 'M' 'A' 'U' 'U'
 'A' 'U' 'A' 'U' 'A' 'A' 'A' 'A' 'A' 'A' 'A' 'A' 'A' 'A' 'A' 'U' 'U' 'M'
 'A' 'A' 'U' 'A' 'A' 'M' 'U' 'U' 'U' 'M' 'U' 'A' 'A' 'U' 'A' 'M' 'U' 'U'
 'M' 'M' 'A' 'A' 'U' 'A' 'A' 'A' 'U' 'U' 'A' 'A' 'A' 'A' 'M' 'A' 'U' 'U'
 'A' 'A' 'A' 'A' 'A' 'A' 'A' 'A' 'U' 'A' 'U' 'A' 'U' 'A' 'A' 'U' 'A' 'A']"
701,0,119,78,41,79,0,0,"['A' 'A' 'U' 'U' 'U' 'A' 'A' 'U' 'A' 'U' 'U' 'U' 'M' 'U' 'M' 'A' 'U' 'U'
 'U' 'A' 'U' 'U' 'A' 'M' 'U' 'M' 'U' 'A' 'A' 'U' 'U' 'M' 'U' 'M' 'A' 'M'
 'M' 'U' 'U' 'U' 'U' 'U' 'A' 'A' 'U' 'A' 'U' 'A' 'U' 'U' 'U' 'A' 'U' 'A'
 'U' 'U' 'M' 'A' 'A' 'M' 'M' 'M' 'A' 'A' 'A' 'M' 'M' 'M' 'U' 'M' 'M' 'M'
 'M' 'M' 'M' 'M' 'U' 'A' 'U' 'A' 'A' 'A' 'M' 'U' 'M' 'U' 'U' 'A' 'A' 'U'
 'A' 'A' 'U' 'A' 'M' 'M' 'U' 'M' 'U' 'U' 'A' 'A' 'A' 'M' 'U' 'A' 'A' 'U'
 'U' 'U' 'U' 'A' 'M' 'M' 'U' 'M' 'U' 'U' 'U' 'U' 'A' 'M' 'U' 'A' 'U' 'U'
 'A' 'U' 'A' 'M' 'A' 'U' 'A' 'A' 'A' 'A' 'A' 'A' 'A' 'A' 'A' 'U' 'U' 'M'
 'A' 'U' 'M' 'A' 'U' 'M' 'M' 'U' 'U' 'M' 'U' 'A' 'U' 'U' 'A' 'U' 'U' 'U'
 'U' 'M' 'A' 'A' 'M' 'A' 'A' 'A' 'U' 'U' 'A' 'A' 'A' 'A' 'M' 'A' 'U' 'A'
 'A' 'A' 'A' 'U' 'A' 'A' 'A' 'A' 'U' 'A' 'U' 'A' 'U' 'U' 'A' 'U' 'A' 'A']"
801,0,121,79,42,77,0,0,"['A' 'A' 'A' 'A' 'U' 'A' 'A' 'U' 'A' 'U' 'U' 'U' 'U' 'A' 'M' 'A' 'U' 'A'
 'U' 'A' 'U' 'U' 'U' 'M' 'U' 'M' 'A' 'A' 'A' 'U' 'U' 'M' 'U' 'M' 'A' 'U'
 'M' 'U' 'U' 'U' 'U' 'U' 'A' 'A' 'U' 'A' 'M' 'A' 'M' 'U' 'A' 'U' 'M' 'A'
 'U' 'U' 'M' 'A' 'U' 'U' 'M' 'M' 'A' 'U' 'A' 'M' 'M' 'M' 'U' 'M' 'M' 'M'
 'M' 'M' 'M' 'M' 'U' 'U' 'U' 'A' 'A' 'A' 'M' 'A' 'M' 'U' 'A' 'A' 'A' 'U'
 'A' 'A' 'U' 'A' 'M' 'A' 'U' 'M' 'U' 'U' 'A' 'A' 'A' 'M' 'U' 'U' 'A' 'M'
 'U' 'U' 'U' 'A' 'U' 'M' 'A' 'M' 'U' 'M' 'U' 'A' 'A' 'M' 'A' 'A' 'U' 'U'
 'U' 'U' 'A' 'U' 'A' 'A' 'A' 'A' 'A' 'A' 'A' 'A' 'A' 'A' 'U' 'U' 'A' 'M'
 'M' 'U' 'U' 'A' 'U' 'M' 'M' 'U' 'M' 'M' 'U' 'A' 'U' 'U' 'A' 'U' 'U' 'U'
 'U' 'U' 'U' 'A' 'M' 'A' 'A' 'A' 'U' 'U' 'M' 'A' 'U' 'A' 'M' 'A' 'U' 'A'
 'A' 'A' 'A' 'A' 'U' 'U' 'A' 'A' 'U' 'A' 'U' 'A' 'U' 'M' 'A' 'U' 'A' 'A']"
901,1,120,75,45,78,1,0,"['A' 'A' 'A' 'A' 'U' 'A' 'A' 'U' 'A' 'M' 'U' 'U' 'U' 'U' 'M' 'A' 'A' 'U'
 'A' 'A' 'U' 'U' 'U' 'U' 'U' 'U' 'A' 'A' 'U' 'U' 'U' 'M' 'M' 'M' 'U' 'U'
 'M' 'M' 'U' 'U' 'U' 'U' 'A' 'A' 'U' 'A' 'M' 'A' 'M' 'A' 'A' 'U' 'M' 'A'
 'U' 'U' 'M' 'A' 'A' 'A' 'U' 'M' 'U' 'U' 'A' 'M' 'U' 'M' 'M' 'M' 'M' 'M'
 'M' 'M' 'M' 'U' 'U' 'A' 'U' 'A' 'A' 'A' 'M' 'A' 'M' 'U' 'A' 'A' 'A' 'A'
 'A' 'A' 'M' 'A' 'M' 'A' 'U' 'U' 'U' 'A' 'U' 'A' 'A' 'M' 'A' 'U' 'A' 'M'
 'A' 'U' 'U' 'A' 'U' 'M' 'U' 'M' 'U' 'U' 'U' 'M' 'U' 'M' 'A' 'A' 'M' 'A'
 'U' 'U' 'A' 'U' 'U' 'A' 'A' 'A' 'A' 'A' 'A' 'A' 'A' 'A' 'U' 'U' 'A' 'M'
 'M' 'U' 'U' 'A' 'U' 'U' 'M' 'U' 'M' 'M' 'U' 'A' 'U' 'M' 'A' 'A' 'U' 'M'
 'U' 'M' 'U' 'A' 'M' 'A' 'A' 'A' 'U' 'U' 'U' 'U' 'U' 'U' 'M' 'A' 'U' 'U'
 'A' 'M' 'A' 'A' 'M' 'U' 'A' 'A' 'U' 'U' 'U' 'A' 'U' 'M' 'A' 'U' 'A' 'U']"
1001,1,111,71,40,87,1,0,"['A' 'A' 'A' 'A' 'U' 'A' 'U' 'U' 'A' 'M' 'U' 'U' 'U' 'U' 'U' 'A' 'A' 'U'
 'A' 'A' 'U' 'U' 'U' 'U' 'U' 'U' 'U' 'A' 'M' 'A' 'U' 'A' 'M' 'M' 'U' 'U'
 'M' 'M' 'A' 'U' 'U' 'M' 'A' 'A' 'U' 'A' 'M' 'A' 'M' 'U' 'A' 'U' 'A' 'A'
 'U' 'M' 'U' 'A' 'A' 'A' 'U' 'M' 'U' 'U' 'A' 'U' 'M' 'M' 'M' 'M' 'M' 'M'
 'M' 'M' 'M' 'A' 'U' 'U' 'M' 'U' 'A' 'A' 'M' 'A' 'M' 'U' 'A' 'A' 'A' 'A'
 'A' 'A' 'M' 'A' 'U' 'U' 'A' 'U' 'A' 'A' 'U' 'A' 'A' 'U' 'A' 'U' 'A' 'M'
 'A' 'U' 'U' 'A' 'U' 'M' 'U' 'M' 'U' 'U' 'U' 'U' 'U' 'M' 'A' 'U' 'M' 'U'
 'U' 'U' 'A' 'U' 'U' 'A' 'A' 'A' 'A' 'A' 'A' 'A' 'A' 'A' 'U' 'A' 'U' 'M'
 'U' 'U' 'U' 'A' 'U' 'U' 'M' 'U' 'M' 'M' 'U' 'A' 'U' 'U' 'U' 'U' 'U' 'U'
 'M' 'M' 'U' 'A' 'U' 'A' 'A' 'U' 'U' 'U' 'U' 'U' 'M' 'A' 'M' 'A' 'U' 'U'
 'A' 'M' 'A' 'A' 'M' 'U' 'A' 'U' 'U' 'M' 'A' 'A' 'U' 'U' 'U' 'U' 'A' 'U']"
1101,1,104,63,41,94,0,0,"['A' 'U' 'U' 'A' 'U' 'A' 'U' 'U' 'A' 'M' 'U' 'U' 'U' 'U' 'A' 'U' 'A' 'U'
 'A' 'A' 'U' 'U' 'A' 'M' 'U' 'U' 'U' 'A' 'M' 'A' 'M' 'A' 'M' 'M' 'A' 'U'
 'M' 'M' 'U' 'A' 'U' 'M' 'A' 'A' 'U' 'U' 'M' 'A' 'U' 'U' 'A' 'U' 'U' 'A'
 'U' 'U' 'U' 'M' 'U' 'U' 'M' 'U' 'U' 'U' 'U' 'M' 'M' 'M' 'M' 'M' 'M' 'U'
 'M' 'M' 'M' 'A' 'A' 'U' 'M' 'U' 'A' 'A' 'U' 'A' 'M' 'U' 'A' 'M' 'U' 'A'
 'A' 'A' 'M' 'A' 'U' 'A' 'A' 'U' 'A' 'A' 'U' 'A' 'A' 'U' 'A' 'A' 'A' 'U'
 'U' 'A' 'U' 'A' 'A' 'U' 'U' 'M' 'U' 'M' 'U' 'U' 'U' 'M' 'A' 'U' 'M' 'A'
 'U' 'U' 'U' 'U' 'U' 'A' 'A' 'A' 'A' 'A' 'A' 'A' 'A' 'A' 'U' 'U' 'A' 'U'
 'U' 'U' 'U' 'U' 'U' 'U' 'M' 'U' 'M' 'M' 'U' 'U' 'U' 'U' 'U' 'U' 'U' 'U'
 'M' 'M' 'U' 'A' 'U' 'U' 'A' 'U' 'U' 'U' 'A' 'U' 'U' 'A' 'M' 'A' 'M' 'U'
 'A' 'M' 'A' 'A' 'M' 'U' 'A' 'U' 'U' 'M' 'A' 'U' 'M' 'U' 'M' 'U' 'U' 'U']"
1201,1,112,65,47,86,0,0,"['A' 'A' 'U' 'A' 'M' 'A' 'U' 'U' 'A' 'M' 'U' 'U' 'U' 'U' 'A' 'U' 'U' 'U'
 'A' 'A' 'U' 'U' 'A' 'M' 'U' 'U' 'A' 'A' 'M' 'A' 'M' 'A' 'M' 'M' 'A' 'U'
 'M' 'M' 'U' 'A' 'U' 'M' 'U' 'A' 'U' 'U' 'M' 'U' 'U' 'U' 'A' 'A' 'U' 'A'
 'A' 'U' 'U' 'M' 'U' 'U' 'M' 'U' 'U' 'U' 'A' 'M' 'M' 'M' 'M' 'M' 'M' 'M'
 'U' 'M' 'M' 'U' 'A' 'U' 'M' 'U' 'A' 'M' 'U' 'A' 'M' 'U' 'A' 'U' 'U' 'A'
 'A' 'A' 'M' 'A' 'A' 'A' 'A' 'U' 'A' 'A' 'U' 'A' 'A' 'U' 'A' 'A' 'A' 'A'
 'U' 'A' 'U' 'A' 'U' 'U' 'M' 'M' 'M' 'M' 'U' 'U' 'A' 'M' 'A' 'U' 'M' 'A'
 'U' 'M' 'M' 'M' 'A' 'A' 'A' 'A' 'A' 'A' 'A' 'A' 'A' 'A' 'U' 'U' 'A' 'M'
 'U' 'U' 'U' 'U' 'U' 'U' 'M' 'U' 'U' 'M' 'U' 'U' 'U' 'M' 'M' 'U' 'U' 'U'
 'M' 'U' 'U' 'A' 'U' 'A' 'U' 'U' 'U' 'U' 'A' 'U' 'U' 'U' 'M' 'A' 'M' 'M'
 'A' 'M' 'A' 'A' 'U' 'U' 'A' 'U' 'U' 'M' 'U' 'A' 'M' 'U' 'U' 'U' 'U' 'U']"
1301,2,113,65,48,85,0,1,"['A' 'A' 'U' 'A' 'M' 'A' 'U' 'U' 'A' 'M' 'U' 'U' 'U' 'U' 'A' 'U' 'A' 'U'
 'A' 'A' 'A' 'U' 'A' 'M' 'U' 'U' 'A' 'A' 'U' 'A' 'M' 'A' 'M' 'M' 'A' 'U'
 'M' 'U' 'U' 'A' 'U' 'M' 'U' 'A' 'A' 'U' 'M' 'A' 'U' 'U' 'U' 'A' 'U' 'U'
 'A' 'U' 'U' 'U' 'U' 'U' 'M' 'U' 'U' 'U' 'A' 'M' 'M' 'M' 'M' 'M' 'M' 'M'
 'U' 'M' 'M' 'A' 'A' 'U' 'M' 'U' 'A' 'U' 'U' 'A' 'M' 'U' 'U' 'U' 'M' 'U'
 'A' 'A' 'M' 'A' 'A' 'A' 'A' 'U' 'A' 'U' 'M' 'A' 'A' 'U' 'A' 'A' 'U' 'A'
 'U' 'A' 'U' 'A' 'M' 'U' 'M' 'U' 'U' 'M' 'U' 'A' 'A' 'M' 'U' 'M' 'M' 'U'
 'U' 'M' 'M' 'U' 'A' 'A' 'A' 'A' 'A' 'A' 'A' 'A' 'A' 'U' 'M' 'U' 'A' 'M'
 'A' 'U' 'U' 'M' 'A' 'U' 'M' 'A' 'U' 'M' 'U' 'U' 'M' 'M' 'U' 'U' 'U' 'U'
 'M' 'U' 'U' 'U' 'U' 'A' 'U' 'U' 'U' 'A' 'A' 'U' 'U' 'U' 'M' 'A' 'M' 'M'
 'U' 'U' 'A' 'A' 'U' 'U' 'A' 'M' 'U' 'M' 'U' 'A' 'M' 'M' 'U' 'M' 'U' 'A']"
1401,0,113,70,43,85,0,1,"['A' 'A' 'U' 'A' 'U' 'A' 'A' 'U' 'A' 'M' 'U' 'A' 'U' 'U' 'A' 'U' 'A' 'U'
 'A' 'A' 'A' 'A' 'U' 'M' 'U' 'U' 'A' 'A' 'U' 'U' 'U' 'A' 'M' 'U' 'A' 'U'
 'U' 'M' 'U' 'A' 'U' 'M' 'M' 'A' 'A' 'U' 'U' 'A' 'U' 'U' 'A' 'A' 'U' 'A'
 'A' 'U' 'U' 'M' 'U' 'U' 'M' 'U' 'U' 'A' 'A' 'M' 'M' 'M' 'M' 'M' 'M' 'M'
 'M' 'M' 'U' 'A' 'A' 'A' 'M' 'U' 'A' 'U' 'U' 'A' 'M' 'U' 'U' 'U' 'M' 'U'
 'A' 'U' 'M' 'A' 'A' 'U' 'A' 'U' 'A' 'M' 'M' 'A' 'A' 'U' 'A' 'A' 'U' 'A'
 'U' 'A' 'U' 'A' 'U' 'U' 'M' 'U' 'U' 'U' 'U' 'A' 'A' 'M' 'U' 'M' 'U' 'U'
 'U' 'M' 'M' 'U' 'A' 'A' 'A' 'A' 'A' 'A' 'A' 'A' 'A' 'U' 'U' 'U' 'A' 'M'
 'A' 'M' 'U' 'M' 'A' 'M' 'M' 'A' 'M' 'M' 'U' 'U' 'M' 'M' 'U' 'U' 'U' 'M'
 'U' 'U' 'A' 'U' 'U' 'M' 'U' 'A' 'U' 'A' 'A' 'U' 'U' 'U' 'U' 'U' 'U' 'M'
 'U' 'A' 'A' 'A' 'A' 'U' 'U' 'M' 'A' 'U' 'U' 'A' 'M' 'M' 'U' 'U' 'U' 'A']"
1501,0,115,65,50,83,0,0,"['A' 'U' 'U' 'A' 'A' 'A' 'A' 'U' 'A' 'M' 'M' 'A' 'U' 'U' 'A' 'U' 'A' 'U'
 'U' 'A' 'A' 'A' 'U' 'M' 'M' 'U' 'A' 'A' 'U' 'A' 'M' 'A' 'M' 'U' 'A' 'U'
 'M' 'M' 'M' 'U' 'U' 'M' 'M' 'A' 'U' 'U' 'M' 'U' 'M' 'M' 'A' 'A' 'U' 'U'
 'A' 'U' 'U' 'A' 'M' 'U' 'M' 'U' 'U' 'A' 'A' 'M' 'M' 'M' 'M' 'U' 'M' 'M'
 'M' 'M' 'M' 'U' 'U' 'A' 'M' 'U' 'A' 'U' 'U' 'A' 'M' 'U' 'M' 'U' 'M' 'U'
 'A' 'U' 'M' 'A' 'A' 'U' 'U' 'U' 'U' 'M' 'M' 'A' 'A' 'U' 'A' 'A' 'U' 'A'
 'A' 'A' 'A' 'U' 'M' 'U' 'M' 'U' 'U' 'U' 'U' 'A' 'A' 'M' 'U' 'U' 'U' 'U'
 'U' 'M' 'M' 'U' 'A' 'A' 'A' 'A' 'A' 'A' 'A' 'A' 'A' 'U' 'A' 'U' 'A' 'M'
 'A' 'M' 'U' 'U' 'A' 'M' 'U' 'A' 'M' 'U' 'U' 'A' 'U' 'M' 'U' 'U' 'U' 'M'
 'U' 'U' 'M' 'M' 'U' 'M' 'U' 'A' 'U' 'U' 'A' 'A' 'U' 'U' 'M' 'U' 'U' 'U'
 'U' 'A' 'A' 'A' 'A' 'U' 'U' 'M' 'A' 'U' 'U' 'A' 'M' 'M' 'U' 'U' 'U' 'A']"
1601,2,112,59,53,86,0,0,"['A' 'U' 'M' 'U' 'A' 'A' 'A' 'U' 'U' 'M' 'U' 'U' 'U' 'U' 'A' 'M' 'A' 'U'
 'M' 'U' 'A' 'A' 'U' 'M' 'M' 'U' 'A' 'A' 'U' 'A' 'M' 'A' 'M' 'U' 'A' 'A'
 'M' 'M' 'M' 'U' 'M' 'U' 'M' 'U' 'U' 'U' 'M' 'U' 'U' 'U' 'A' 'A' 'U' 'U'
 'A' 'U' 'U' 'U' 'M' 'A' 'M' 'U' 'U' 'A' 'U' 'M' 'M' 'M' 'M' 'M' 'M' 'M'
 'M' 'M' 'U' 'U' 'U' 'U' 'M' 'U' 'A' 'U' 'U' 'A' 'M' 'U' 'M' 'U' 'M' 'M'
 'A' 'M' 'M' 'A' 'A' 'U' 'U' 'U' 'U' 'M' 'M' 'A' 'U' 'U' 'A' 'A' 'U' 'A'
 'A' 'M' 'A' 'U' 'M' 'U' 'U' 'U' 'M' 'U' 'U' 'A' 'A' 'U' 'A' 'U' 'A' 'U'
 'U' 'U' 'U' 'U' 'A' 'A' 'A' 'A' 'A' 'A' 'A' 'A' 'A' 'M' 'M' 'U' 'A' 'M'
 'A' 'M' 'U' 'U' 'M' 'M' 'U' 'A' 'M' 'U' 'A' 'A' 'A' 'M' 'U' 'U' 'U' 'M'
 'U' 'A' 'M' 'M' 'U' 'M' 'U' 'A' 'M' 'U' 'A' 'A' 'U' 'U' 'M' 'U' 'A' 'U'
 'U' 'A' 'U' 'U' 'A' 'U' 'U' 'M' 'A' 'A' 'U' 'U' 'M' 'U' 'U' 'A' 'U' 'U']"
1701,2,120,62,58,78,0,0,"['A' 'U' 'M' 'U' 'U' 'A' 'U' 'A' 'M' 'M' 'U' 'U' 'M' 'U' 'A' 'U' 'A' 'M'
 'M' 'U' 'A' 'A' 'U' 'M' 'M' 'A' 'A' 'U' 'U' 'A' 'U' 'A' 'M' 'U' 'A' 'A'
 'U' 'M' 'M' 'U' 'M' 'U' 'U' 'U' 'U' 'M' 'M' 'U' 'A' 'A' 'U' 'A' 'U' 'M'
 'A' 'U' 'U' 'A' 'M' 'A' 'M' 'U' 'U' 'A' 'U' 'M' 'M' 'M' 'U' 'M' 'M' 'M'
 'M' 'M' 'M' 'U' 'U' 'U' 'M' 'U' 'A' 'M' 'M' 'A' 'M' 'U' 'M' 'U' 'U' 'U'
 'A' 'M' 'M' 'U' 'A' 'U' 'U' 'U' 'M' 'M' 'M' 'A' 'U' 'U' 'A' 'A' 'U' 'A'
 'A' 'M' 'A' 'U' 'M' 'U' 'U' 'U' 'U' 'U' 'A' 'A' 'A' 'U' 'A' 'U' 'M' 'M'
 'U' 'U' 'U' 'U' 'A' 'A' 'A' 'A' 'A' 'A' 'U' 'A' 'A' 'M' 'U' 'A' 'A' 'M'
 'A' 'M' 'U' 'M' 'U' 'M' 'A' 'A' 'M' 'U' 'A' 'A' 'A' 'M' 'A' 'U' 'M' 'M'
 'U' 'U' 'M' 'M' 'U' 'M' 'M' 'A' 'M' 'U' 'A' 'U' 'U' 'A' 'M' 'U' 'U' 'A'
 'M' 'A' 'U' 'U' 'A' 'U' 'U' 'U' 'A' 'A' 'A' 'M' 'M' 'U' 'U' 'A' 'A' 'U']"
1801,3,112,59,53,86,0,0,"['A' 'U' 'U' 'U' 'U' 'A' 'U' 'A' 'M' 'M' 'U' 'U' 'M' 'U' 'A' 'U' 'A' 'M'
 'M' 'M' 'A' 'M' 'M' 'M' 'M' 'A' 'A' 'M' 'M' 'M' 'U' 'A' 'U' 'U' 'A' 'A'
 'U' 'U' 'M' 'U' 'M' 'U' 'M' 'U' 'U' 'U' 'M' 'U' 'A' 'U' 'U' 'A' 'U' 'M'
 'A' 'U' 'A' 'A' 'U' 'A' 'M' 'U' 'M' 'A' 'U' 'M' 'M' 'M' 'M' 'M' 'M' 'U'
 'M' 'M' 'M' 'U' 'A' 'U' 'U' 'U' 'U' 'M' 'M' 'A' 'U' 'A' 'M' 'U' 'U' 'U'
 'A' 'U' 'U' 'U' 'U' 'A' 'U' 'A' 'M' 'M' 'M' 'U' 'U' 'U' 'U' 'A' 'U' 'A'
 'A' 'M' 'A' 'U' 'M' 'U' 'U' 'U' 'U' 'U' 'A' 'A' 'A' 'U' 'A' 'U' 'U' 'M'
 'A' 'U' 'U' 'A' 'A' 'A' 'A' 'A' 'A' 'A' 'A' 'A' 'A' 'U' 'U' 'A' 'U' 'M'
 'A' 'M' 'A' 'U' 'U' 'M' 'A' 'U' 'M' 'U' 'A' 'A' 'A' 'M' 'A' 'U' 'M' 'M'
 'A' 'U' 'M' 'U' 'U' 'M' 'A' 'U' 'M' 'M' 'U' 'U' 'U' 'A' 'U' 'U' 'U' 'U'
 'M' 'U' 'U' 'M' 'U' 'U' 'U' 'U' 'A' 'A' 'A' 'M' 'M' 'U' 'U' 'A' 'A' 'U']"
1901,1,113,62,51,85,1,0,"['A' 'A' 'U' 'U' 'U' 'A' 'U' 'A' 'M' 'U' 'U' 'U' 'U' 'U' 'A' 'A' 'M' 'U'
 'M' 'U' 'A' 'M' 'M' 'A' 'M' 'A' 'A' 'M' 'M' 'M' 'U' 'U' 'U' 'U' 'A' 'A'
 'M' 'U' 'M' 'U' 'U' 'U' 'M' 'U' 'U' 'A' 'M' 'A' 'A' 'U' 'U' 'A' 'U' 'M'
 'A' 'U' 'A' 'A' 'U' 'A' 'M' 'U' 'U' 'A' 'U' 'M' 'M' 'M' 'M' 'M' 'M' 'M'
 'M' 'M' 'U' 'U' 'A' 'U' 'U' 'M' 'U' 'M' 'M' 'U' 'U' 'A' 'M' 'U' 'U' 'U'
 'A' 'U' 'U' 'U' 'U' 'A' 'U' 'A' 'M' 'M' 'M' 'U' 'U' 'U' 'U' 'U' 'U' 'A'
 'A' 'M' 'A' 'U' 'M' 'U' 'U' 'U' 'U' 'U' 'U' 'A' 'A' 'U' 'A' 'A' 'M' 'M'
 'A' 'M' 'A' 'A' 'M' 'A' 'A' 'A' 'A' 'A' 'A' 'A' 'A' 'U' 'U' 'A' 'U' 'M'
 'A' 'M' 'A' 'M' 'U' 'M' 'A' 'U' 'M' 'M' 'U' 'A' 'A' 'U' 'A' 'A' 'M' 'M'
 'A' 'A' 'M' 'M' 'U' 'M' 'A' 'U' 'U' 'M' 'U' 'U' 'U' 'U' 'A' 'U' 'U' 'U'
 'U' 'U' 'U' 'M' 'U' 'U' 'U' 'A' 'A' 'A' 'A' 'M' 'U' 'U' 'U' 'A' 'A' 'U']"
2001,1,119,67,52,79,0,0,"['A' 'U' 'A' 'U' 'U' 'A' 'A' 'U' 'M' 'U' 'U' 'A' 'U' 'U' 'U' 'U' 'M' 'U'
 'M' 'U' 'A' 'U' 'A' 'A' 'M' 'A' 'A' 'M' 'M' 'U' 'U' 'M' 'U' 'U' 'A' 'A'
 'M' 'M' 'M' 'U' 'U' 'U' 'M' 'U' 'U' 'U' 'M' 'A' 'A' 'U' 'U' 'A' 'M' 'M'
 'U' 'U' 'U' 'A' 'U' 'U' 'M' 'U' 'U' 'U' 'U' 'M' 'M' 'M' 'M' 'M' 'M' 'M'
 'M' 'U' 'M' 'U' 'U' 'M' 'U' 'M' 'M' 'M' 'M' 'M' 'U' 'A' 'M' 'A' 'A' 'A'
 'A' 'U' 'U' 'U' 'U' 'A' 'U' 'A' 'M' 'M' 'M' 'M' 'U' 'U' 'U' 'U' 'A' 'A'
 'A' 'M' 'A' 'U' 'U' 'U' 'U' 'A' 'U' 'U' 'U' 'A' 'A' 'M' 'A' 'A' 'M' 'U'
 'A' 'M' 'A' 'A' 'M' 'A' 'A' 'A' 'A' 'A' 'A' 'A' 'A' 'U' 'A' 'A' 'A' 'M'
 'A' 'M' 'A' 'M' 'U' 'U' 'A' 'U' 'M' 'M' 'A' 'A' 'A' 'U' 'A' 'A' 'U' 'M'
 'A' 'A' 'M' 'M' 'U' 'M' 'A' 'U' 'U' 'M' 'U' 'U' 'U' 'U' 'A' 'A' 'A' 'U'
 'U' 'A' 'A' 'U' 'M' 'U' 'U' 'U' 'A' 'A' 'A' 'M' 'U' 'U' 'U' 'A' 'A' 'U']"
2101,2,113,64,49,85,0,0,"['A' 'U' 'U' 'A' 'U' 'A' 'A' 'U' 'M' 'A' 'U' 'A' 'U' 'U' 'M' 'U' 'U' 'A'
 'M' 'U' 'A' 'M' 'A' 'A' 'M' 'U' 'A' 'M' 'M' 'U' 'U' 'M' 'A' 'U' 'A' 'A'
 'M' 'M' 'U' 'U' 'A' 'U' 'U' 'U' 'U' 'A' 'M' 'A' 'A' 'U' 'U' 'U' 'M' 'M'
 'U' 'U' 'U' 'A' 'U' 'M' 'M' 'U' 'U' 'U' 'U' 'M' 'M' 'M' 'M' 'M' 'M' 'U'
 'M' 'M' 'M' 'U' 'U' 'M' 'U' 'M' 'M' 'M' 'U' 'M' 'U' 'U' 'U' 'U' 'U' 'A'
 'A' 'U' 'U' 'U' 'M' 'U' 'U' 'A' 'M' 'A' 'M' 'U' 'U' 'U' 'U' 'U' 'A' 'U'
 'A' 'M' 'A' 'U' 'U' 'U' 'U' 'U' 'U' 'U' 'U' 'A' 'A' 'M' 'A' 'A' 'M' 'U'
 'A' 'M' 'A' 'A' 'M' 'A' 'A' 'A' 'A' 'A' 'A' 'A' 'A' 'U' 'A' 'A' 'U' 'M'
 'U' 'M' 'A' 'M' 'M' 'U' 'A' 'U' 'U' 'M' 'A' 'A' 'A' 'U' 'A' 'A' 'M' 'U'
 'A' 'A' 'M' 'U' 'U' 'U' 'A' 'U' 'A' 'M' 'U' 'U' 'U' 'U' 'A' 'A' 'A' 'U'
 'U' 'A' 'A' 'M' 'M' 'A' 'U' 'M' 'A' 'A' 'U' 'M' 'U' 'U' 'U' 'A' 'A' 'U']"
2201,0,103,57,46,95,1,0,"['A' 'U' 'M' 'A' 'U' 'A' 'A' 'U' 'M' 'U' 'U' 'A' 'A' 'A' 'U' 'U' 'A' 'A'
 'M' 'U' 'A' 'M' 'A' 'A' 'M' 'U' 'U' 'M' 'M' 'U' 'U' 'M' 'A' 'U' 'U' 'A'
 'U' 'U' 'M' 'U' 'A' 'U' 'U' 'U' 'U' 'A' 'A' 'U' 'U' 'U' 'U' 'A' 'M' 'M'
 'U' 'U' 'U' 'U' 'A' 'M' 'M' 'A' 'U' 'U' 'U' 'M' 'U' 'M' 'M' 'M' 'M' 'M'
 'M' 'M' 'M' 'U' 'U' 'M' 'U' 'U' 'M' 'M' 'U' 'M' 'U' 'U' 'U' 'M' 'U' 'A'
 'A' 'U' 'M' 'U' 'M' 'U' 'U' 'M' 'U' 'U' 'M' 'U' 'U' 'U' 'U' 'U' 'A' 'M'
 'A' 'M' 'U' 'A' 'U' 'M' 'U' 'U' 'A' 'U' 'U' 'A' 'U' 'M' 'A' 'U' 'M' 'U'
 'U' 'U' 'U' 'A' 'M' 'A' 'A' 'A' 'A' 'A' 'A' 'U' 'A' 'U' 'A' 'A' 'U' 'M'
 'U' 'M' 'A' 'M' 'M' 'U' 'A' 'U' 'U' 'M' 'A' 'U' 'A' 'U' 'A' 'U' 'M' 'U'
 'A' 'A' 'U' 'U' 'U' 'U' 'U' 'A' 'A' 'M' 'U' 'U' 'U' 'M' 'A' 'A' 'A' 'A'
 'U' 'U' 'U' 'U' 'U' 'A' 'U' 'M' 'A' 'A' 'U' 'A' 'U' 'U' 'U' 'A' 'A' 'U']"
2301,2,112,62,50,86,0,0,"['A' 'U' 'M' 'A' 'U' 'A' 'A' 'U' 'M' 'A' 'U' 'U' 'A' 'A' 'U' 'U' 'A' 'U'
 'M' 'U' 'A' 'U' 'A' 'A' 'M' 'U' 'U' 'M' 'M' 'M' 'U' 'M' 'A' 'U' 'U' 'A'
 'U' 'U' 'U' 'U' 'A' 'U' 'U' 'U' 'U' 'A' 'A' 'A' 'U' 'U' 'U' 'A' 'M' 'M'
 'U' 'U' 'U' 'U' 'U' 'U' 'M' 'A' 'A' 'U' 'M' 'M' 'M' 'M' 'M' 'M' 'M' 'M'
 'M' 'M' 'U' 'U' 'U' 'M' 'U' 'U' 'M' 'U' 'M' 'M' 'U' 'U' 'M' 'M' 'U' 'A'
 'A' 'U' 'U' 'U' 'M' 'A' 'U' 'M' 'U' 'U' 'M' 'M' 'U' 'U' 'U' 'U' 'A' 'M'
 'A' 'M' 'M' 'A' 'M' 'M' 'A' 'U' 'A' 'U' 'U' 'A' 'M' 'M' 'A' 'U' 'U' 'U'
 'U' 'M' 'U' 'A' 'U' 'A' 'A' 'A' 'A' 'A' 'A' 'A' 'A' 'A' 'A' 'U' 'U' 'M'
 'A' 'M' 'A' 'M' 'M' 'A' 'A' 'U' 'U' 'M' 'A' 'U' 'A' 'U' 'A' 'U' 'M' 'U'
 'A' 'A' 'U' 'A' 'U' 'U' 'M' 'U' 'A' 'M' 'U' 'U' 'U' 'M' 'A' 'A' 'A' 'A'
 'U' 'U' 'U' 'U' 'U' 'A' 'U' 'M' 'A' 'U' 'U' 'A' 'U' 'U' 'A' 'A' 'A' 'M']"
2401,0,119,65,54,79,1,0,"['A' 'U' 'M' 'U' 'M' 'A' 'A' 'M' 'M' 'A' 'U' 'U' 'A' 'A' 'U' 'U' 'A' 'A'
 'M' 'U' 'U' 'U' 'A' 'A' 'M' 'U' 'U' 'U' 'U' 'M' 'U' 'M' 'U' 'U' 'U' 'U'
 'U' 'M' 'M' 'A' 'A' 'M' 'U' 'U' 'A' 'A' 'A' 'A' 'U' 'M' 'A' 'A' 'M' 'U'
 'A' 'U' 'U' 'U' 'U' 'U' 'U' 'U' 'A' 'A' 'U' 'U' 'M' 'M' 'M' 'M' 'M' 'M'
 'M' 'M' 'M' 'U' 'U' 'U' 'U' 'U' 'M' 'U' 'M' 'U' 'U' 'A' 'M' 'M' 'U' 'A'
 'U' 'U' 'M' 'U' 'M' 'A' 'U' 'M' 'U' 'U' 'M' 'M' 'U' 'M' 'A' 'U' 'A' 'M'
 'A' 'M' 'M' 'A' 'M' 'M' 'A' 'M' 'A' 'A' 'U' 'A' 'M' 'M' 'A' 'A' 'M' 'U'
 'U' 'M' 'A' 'A' 'U' 'U' 'A' 'A' 'A' 'A' 'A' 'A' 'A' 'A' 'A' 'U' 'U' 'U'
 'U' 'M' 'A' 'M' 'M' 'A' 'A' 'U' 'U' 'A' 'A' 'U' 'A' 'A' 'A' 'U' 'M' 'U'
 'A' 'U' 'U' 'U' 'U' 'U' 'M' 'U' 'A' 'M' 'U' 'U' 'U' 'M' 'A' 'A' 'A' 'A'
 'M' 'U' 'U' 'U' 'U' 'A' 'M' 'M' 'A' 'U' 'M' 'A' 'U' 'U' 'A' 'A' 'A' 'M']"
2501,2,121,63,58,77,0,0,"['A' 'U' 'M' 'U' 'M' 'A' 'A' 'M' 'M' 'A' 'M' 'U' 'A' 'U' 'M' 'M' 'A' 'A'
 'M' 'U' 'M' 'U' 'A' 'U' 'M' 'U' 'A' 'U' 'U' 'M' 'U' 'M' 'U' 'U' 'A' 'M'
 'U' 'M' 'M' 'A' 'A' 'M' 'U' 'A' 'A' 'A' 'A' 'U' 'U' 'U' 'A' 'A' 'U' 'U'
 'A' 'A' 'U' 'M' 'A' 'U' 'U' 'U' 'U' 'A' 'U' 'M' 'U' 'M' 'M' 'M' 'M' 'M'
 'M' 'M' 'M' 'U' 'U' 'A' 'M' 'A' 'M' 'M' 'U' 'U' 'U' 'A' 'M' 'M' 'U' 'A'
 'U' 'U' 'M' 'U' 'M' 'U' 'U' 'M' 'U' 'U' 'U' 'U' 'U' 'M' 'A' 'A' 'U' 'M'
 'A' 'M' 'M' 'A' 'M' 'M' 'A' 'M' 'U' 'A' 'M' 'A' 'M' 'M' 'U' 'U' 'M' 'U'
 'U' 'M' 'A' 'A' 'U' 'A' 'A' 'A' 'A' 'A' 'A' 'A' 'A' 'A' 'U' 'U' 'U' 'U'
 'U' 'A' 'U' 'U' 'M' 'A' 'U' 'M' 'U' 'A' 'A' 'U' 'A' 'A' 'A' 'M' 'M' 'U'
 'U' 'M' 'U' 'U' 'U' 'U' 'M' 'A' 'U' 'M' 'U' 'U' 'U' 'M' 'A' 'A' 'A' 'A'
 'U' 'U' 'U' 'U' 'U' 'A' 'U' 'M' 'A' 'M' 'M' 'A' 'U' 'A' 'A' 'A' 'A' 'M']"
2601,1,123,71,52,75,1,0,"['A' 'U' 'M' 'U' 'M' 'U' 'A' 'M' 'M' 'A' 'U' 'A' 'A' 'U' 'U' 'M' 'A' 'A'
 'M' 'M' 'M' 'U' 'A' 'U' 'M' 'U' 'A' 'M' 'U' 'M' 'U' 'U' 'A' 'U' 'M' 'M'
 'A' 'M' 'M' 'A' 'A' 'M' 'U' 'A' 'A' 'A' 'A' 'A' 'U' 'U' 'A' 'A' 'M' 'U'
 'A' 'A' 'A' 'U' 'A' 'U' 'A' 'U' 'M' 'A' 'U' 'M' 'M' 'M' 'M' 'M' 'M' 'M'
 'M' 'U' 'M' 'U' 'A' 'A' 'A' 'A' 'M' 'M' 'A' 'A' 'A' 'A' 'M' 'U' 'U' 'U'
 'U' 'M' 'M' 'A' 'U' 'U' 'U' 'M' 'U' 'A' 'U' 'U' 'A' 'M' 'A' 'U' 'U' 'M'
 'A' 'M' 'M' 'U' 'U' 'M' 'A' 'M' 'U' 'A' 'U' 'A' 'M' 'U' 'U' 'U' 'M' 'M'
 'U' 'M' 'U' 'A' 'A' 'A' 'A' 'A' 'A' 'A' 'A' 'A' 'A' 'U' 'M' 'U' 'U' 'U'
 'U' 'A' 'U' 'U' 'U' 'A' 'A' 'M' 'U' 'U' 'U' 'U' 'A' 'A' 'A' 'M' 'U' 'U'
 'U' 'M' 'U' 'U' 'U' 'U' 'M' 'A' 'U' 'M' 'U' 'A' 'A' 'M' 'A' 'A' 'A' 'A'
 'U' 'U' 'U' 'U' 'U' 'A' 'U' 'U' 'A' 'U' 'M' 'A' 'U' 'A' 'U' 'A' 'A' 'M']"
2701,0,116,67,49,82,0,0,"['A' 'U' 'M' 'U' 'M' 'A' 'A' 'M' 'M' 'A' 'U' 'U' 'U' 'A' 'U' 'M' 'A' 'A'
 'M' 'M' 'M' 'U' 'A' 'U' 'M' 'U' 'A' 'M' 'U' 'M' 'U' 'A' 'U' 'U' 'M' 'M'
 'A' 'M' 'U' 'U' 'U' 'M' 'U' 'A' 'A' 'A' 'U' 'A' 'U' 'U' 'A' 'A' 'U' 'U'
 'A' 'A' 'M' 'U' 'A' 'U' 'A' 'U' 'M' 'A' 'U' 'M' 'M' 'M' 'M' 'M' 'M' 'M'
 'M' 'M' 'U' 'U' 'U' 'A' 'A' 'A' 'M' 'U' 'A' 'U' 'A' 'A' 'U' 'M' 'U' 'U'
 'U' 'M' 'U' 'A' 'U' 'U' 'U' 'M' 'U' 'A' 'A' 'U' 'A' 'U' 'A' 'U' 'U' 'U'
 'A' 'M' 'M' 'A' 'U' 'M' 'A' 'M' 'U' 'U' 'U' 'A' 'A' 'M' 'U' 'M' 'U' 'M'
 'U' 'U' 'U' 'A' 'A' 'A' 'A' 'A' 'A' 'A' 'A' 'A' 'A' 'U' 'U' 'U' 'M' 'U'
 'U' 'A' 'U' 'U' 'U' 'A' 'U' 'M' 'U' 'U' 'A' 'U' 'U' 'A' 'U' 'M' 'U' 'A'
 'A' 'M' 'A' 'U' 'U' 'M' 'U' 'A' 'U' 'M' 'U' 'A' 'U' 'M' 'A' 'A' 'A' 'A'
 'U' 'M' 'U' 'U' 'U' 'A' 'M' 'U' 'U' 'A' 'M' 'A' 'M' 'A' 'U' 'A' 'A' 'M']"
2801,1,113,67,46,85,1,0,"['A' 'M' 'M' 'U' 'M' 'A' 'A' 'U' 'M' 'A' 'U' 'U' 'A' 'U' 'A' 'M' 'A' 'A'
 'M' 'M' 'U' 'U' 'A' 'U' 'M' 'U' 'A' 'M' 'M' 'M' 'U' 'A' 'U' 'U' 'U' 'M'
 'A' 'U' 'U' 'U' 'U' 'M' 'U' 'A' 'U' 'A' 'U' 'U' 'M' 'A' 'A' 'A' 'U' 'M'
 'A' 'U' 'M' 'U' 'U' 'U' 'A' 'U' 'M' 'A' 'U' 'M' 'M' 'M' 'U' 'M' 'M' 'M'
 'M' 'M' 'M' 'M' 'U' 'A' 'A' 'A' 'M' 'U' 'A' 'A' 'A' 'U' 'U' 'M' 'U' 'A'
 'U' 'U' 'U' 'A' 'U' 'U' 'U' 'U' 'U' 'A' 'A' 'U' 'U' 'U' 'U' 'U' 'U' 'U'
 'A' 'M' 'M' 'A' 'A' 'M' 'U' 'M' 'U' 'A' 'U' 'A' 'A' 'U' 'A' 'M' 'U' 'M'
 'U' 'U' 'A' 'A' 'A' 'A' 'U' 'A' 'A' 'A' 'A' 'A' 'A' 'U' 'M' 'U' 'U' 'A'
 'M' 'U' 'U' 'U' 'U' 'U' 'U' 'M' 'U' 'A' 'A' 'U' 'U' 'A' 'U' 'M' 'U' 'A'
 'A' 'M' 'A' 'U' 'U' 'M' 'U' 'A' 'A' 'U' 'U' 'A' 'U' 'U' 'A' 'A' 'A' 'U'
 'U' 'U' 'M' 'U' 'U' 'A' 'U' 'U' 'M' 'A' 'M' 'A' 'M' 'A' 'A' 'A' 'A' 'M']"
2901,4,117,70,47,81,1,0,"['A' 'M' 'M' 'M' 'U' 'A' 'A' 'U' 'M' 'A' 'U' 'U' 'U' 'U' 'A' 'M' 'A' 'A'
 'M' 'M' 'U' 'U' 'A' 'U' 'M' 'U' 'A' 'M' 'M' 'M' 'U' 'A' 'U' 'U' 'U' 'U'
 'A' 'M' 'A' 'U' 'U' 'M' 'U' 'A' 'U' 'A' 'U' 'U' 'M' 'A' 'A' 'A' 'A' 'M'
 'A' 'U' 'M' 'U' 'U' 'U' 'A' 'U' 'M' 'A' 'U' 'M' 'U' 'M' 'M' 'M' 'M' 'M'
 'M' 'M' 'M' 'U' 'U' 'A' 'A' 'A' 'U' 'U' 'A' 'A' 'U' 'U' 'U' 'M' 'U' 'A'
 'U' 'M' 'U' 'U' 'U' 'U' 'U' 'U' 'U' 'A' 'A' 'A' 'M' 'U' 'U' 'U' 'A' 'A'
 'A' 'U' 'M' 'A' 'A' 'M' 'A' 'M' 'M' 'U' 'M' 'A' 'A' 'U' 'A' 'M' 'M' 'M'
 'A' 'U' 'A' 'A' 'U' 'A' 'A' 'A' 'A' 'A' 'A' 'A' 'A' 'U' 'U' 'U' 'A' 'A'
 'M' 'M' 'A' 'U' 'M' 'U' 'U' 'M' 'U' 'U' 'A' 'U' 'U' 'U' 'U' 'M' 'U' 'A'
 'A' 'M' 'A' 'U' 'U' 'M' 'A' 'A' 'A' 'A' 'U' 'A' 'U' 'U' 'A' 'U' 'A' 'U'
 'U' 'U' 'U' 'M' 'U' 'A' 'A' 'U' 'M' 'U' 'U' 'A' 'M' 'A' 'U' 'A' 'A' 'U']"
3001,3,120,64,56,78,0,0,"['A' 'M' 'M' 'M' 'A' 'A' 'U' 'U' 'M' 'A' 'M' 'U' 'A' 'U' 'A' 'U' 'A' 'U'
 'U' 'M' 'A' 'U' 'A' 'U' 'U' 'A' 'A' 'M' 'M' 'M' 'U' 'A' 'U' 'U' 'U' 'M'
 'A' 'M' 'A' 'U' 'U' 'A' 'U' 'A' 'U' 'A' 'U' 'U' 'M' 'A' 'A' 'U' 'A' 'M'
 'A' 'M' 'M' 'A' 'U' 'U' 'A' 'M' 'M' 'A' 'U' 'M' 'M' 'M' 'M' 'U' 'M' 'M'
 'M' 'M' 'M' 'U' 'U' 'U' 'A' 'U' 'U' 'M' 'A' 'U' 'U' 'U' 'A' 'M' 'U' 'A'
 'U' 'A' 'M' 'U' 'U' 'U' 'U' 'U' 'U' 'A' 'A' 'A' 'M' 'U' 'U' 'M' 'A' 'U'
 'U' 'U' 'M' 'A' 'A' 'M' 'A' 'M' 'M' 'U' 'M' 'A' 'U' 'U' 'U' 'M' 'U' 'M'
 'A' 'M' 'A' 'A' 'U' 'U' 'A' 'A' 'A' 'A' 'A' 'A' 'A' 'U' 'M' 'A' 'M' 'U'
 'M' 'U' 'U' 'M' 'M' 'U' 'A' 'M' 'M' 'U' 'U' 'A' 'M' 'U' 'U' 'M' 'U' 'A'
 'A' 'U' 'A' 'U' 'M' 'M' 'A' 'A' 'M' 'A' 'U' 'A' 'U' 'M' 'A' 'U' 'A' 'U'
 'U' 'M' 'U' 'U' 'U' 'U' 'A' 'U' 'M' 'U' 'M' 'A' 'M' 'A' 'U' 'A' 'U' 'A']"
3101,0,126,65,61,72,0,0,"['A' 'M' 'M' 'M' 'A' 'A' 'U' 'U' 'U' 'M' 'U' 'A' 'A' 'U' 'A' 'M' 'A' 'U'
 'U' 'M' 'M' 'U' 'U' 'M' 'M' 'A' 'A' 'M' 'M' 'U' 'U' 'A' 'U' 'U' 'A' 'M'
 'M' 'M' 'A' 'U' 'U' 'A' 'U' 'A' 'U' 'U' 'U' 'U' 'M' 'A' 'A' 'A' 'A' 'U'
 'A' 'M' 'M' 'A' 'U' 'U' 'A' 'M' 'M' 'U' 'U' 'M' 'M' 'M' 'M' 'M' 'M' 'U'
 'M' 'M' 'M' 'U' 'U' 'U' 'A' 'U' 'A' 'M' 'A' 'U' 'U' 'U' 'A' 'M' 'U' 'A'
 'U' 'A' 'M' 'M' 'M' 'U' 'U' 'A' 'U' 'A' 'A' 'A' 'M' 'U' 'U' 'M' 'U' 'U'
 'A' 'U' 'M' 'U' 'A' 'U' 'A' 'M' 'M' 'U' 'M' 'A' 'U' 'U' 'U' 'M' 'A' 'M'
 'U' 'M' 'A' 'A' 'A' 'A' 'A' 'U' 'A' 'A' 'U' 'A' 'A' 'A' 'M' 'A' 'M' 'U'
 'M' 'U' 'A' 'M' 'M' 'A' 'A' 'M' 'M' 'U' 'A' 'A' 'M' 'U' 'U' 'M' 'U' 'A'
 'A' 'U' 'A' 'U' 'M' 'M' 'A' 'U' 'M' 'A' 'M' 'U' 'U' 'M' 'A' 'A' 'A' 'U'
 'U' 'M' 'U' 'U' 'M' 'U' 'A' 'M' 'M' 'U' 'U' 'A' 'M' 'A' 'U' 'A' 'U' 'A']"
3201,1,125,66,59,73,0,1,"['A' 'M' 'U' 'M' 'U' 'U' 'U' 'U' 'U' 'M' 'U' 'A' 'A' 'A' 'U' 'M' 'U' 'A'
 'M' 'M' 'M' 'U' 'U' 'U' 'M' 'A' 'A' 'M' 'A' 'A' 'U' 'A' 'U' 'U' 'A' 'M'
 'M' 'M' 'U' 'U' 'U' 'A' 'U' 'A' 'U' 'U' 'U' 'M' 'M' 'A' 'A' 'U' 'A' 'A'
 'U' 'M' 'U' 'A' 'U' 'U' 'A' 'M' 'M' 'A' 'U' 'M' 'M' 'M' 'M' 'M' 'M' 'M'
 'U' 'M' 'M' 'U' 'U' 'A' 'A' 'U' 'A' 'M' 'A' 'U' 'U' 'U' 'A' 'M' 'U' 'A'
 'U' 'A' 'M' 'M' 'M' 'U' 'M' 'A' 'A' 'A' 'A' 'A' 'U' 'U' 'U' 'M' 'U' 'U'
 'A' 'U' 'M' 'A' 'A' 'U' 'M' 'M' 'M' 'U' 'A' 'A' 'U' 'U' 'A' 'U' 'A' 'M'
 'U' 'M' 'A' 'U' 'A' 'A' 'A' 'A' 'A' 'A' 'A' 'A' 'A' 'A' 'M' 'A' 'M' 'U'
 'M' 'U' 'U' 'M' 'M' 'A' 'U' 'M' 'M' 'A' 'A' 'U' 'M' 'U' 'U' 'M' 'U' 'A'
 'A' 'U' 'A' 'U' 'M' 'M' 'A' 'U' 'M' 'A' 'M' 'U' 'M' 'M' 'A' 'A' 'A' 'U'
 'A' 'M' 'U' 'U' 'M' 'U' 'A' 'U' 'M' 'U' 'U' 'U' 'M' 'A' 'M' 'U' 'U' 'A']"
3301,1,121,65,56,77,1,0,"['A' 'U' 'U' 'U' 'U' 'U' 'U' 'U' 'U' 'M' 'A' 'A' 'U' 'A' 'U' 'M' 'M' 'A'
 'M' 'M' 'A' 'U' 'U' 'M' 'M' 'A' 'U' 'M' 'A' 'A' 'A' 'A' 'U' 'U' 'A' 'U'
 'M' 'M' 'U' 'U' 'U' 'A' 'A' 'A' 'M' 'A' 'M' 'M' 'M' 'A' 'U' 'U' 'U' 'A'
 'U' 'M' 'U' 'A' 'A' 'U' 'A' 'M' 'M' 'A' 'U' 'M' 'M' 'M' 'M' 'M' 'U' 'M'
 'M' 'M' 'M' 'U' 'U' 'A' 'A' 'U' 'A' 'M' 'U' 'M' 'A' 'U' 'A' 'M' 'U' 'U'
 'U' 'A' 'M' 'M' 'M' 'U' 'U' 'A' 'A' 'A' 'A' 'A' 'U' 'U' 'U' 'M' 'U' 'U'
 'A' 'U' 'M' 'A' 'U' 'U' 'M' 'M' 'M' 'U' 'M' 'A' 'U' 'U' 'A' 'U' 'A' 'U'
 'U' 'U' 'A' 'U' 'U' 'A' 'A' 'A' 'A' 'A' 'A' 'A' 'A' 'U' 'M' 'M' 'M' 'U'
 'M' 'A' 'U' 'M' 'U' 'U' 'M' 'M' 'M' 'A' 'U' 'U' 'M' 'U' 'A' 'U' 'U' 'U'
 'A' 'U' 'U' 'M' 'M' 'M' 'A' 'M' 'U' 'A' 'M' 'U' 'M' 'M' 'A' 'A' 'A' 'A'
 'A' 'A' 'U' 'A' 'U' 'A' 'A' 'A' 'M' 'U' 'U' 'U' 'M' 'A' 'U' 'U' 'U' 'A']"
3401,1,121,65,56,77,0,0,"['A' 'U' 'U' 'A' 'U' 'A' 'U' 'A' 'A' 'U' 'U' 'A' 'U' 'A' 'U' 'U' 'M' 'A'
 'M' 'M' 'U' 'M' 'U' 'M' 'A' 'U' 'U' 'M' 'A' 'A' 'U' 'A' 'A' 'U' 'A' 'U'
 'M' 'M' 'U' 'M' 'U' 'A' 'U' 'A' 'A' 'A' 'M' 'M' 'M' 'A' 'U' 'U' 'U' 'A'
 'U' 'M' 'U' 'A' 'A' 'U' 'A' 'M' 'M' 'A' 'U' 'M' 'M' 'M' 'M' 'M' 'M' 'U'
 'M' 'M' 'M' 'U' 'M' 'A' 'A' 'A' 'A' 'M' 'U' 'M' 'A' 'U' 'A' 'M' 'U' 'U'
 'U' 'A' 'M' 'U' 'U' 'U' 'U' 'A' 'M' 'A' 'A' 'A' 'U' 'U' 'M' 'U' 'U' 'U'
 'A' 'U' 'M' 'A' 'U' 'U' 'U' 'M' 'M' 'M' 'U' 'A' 'U' 'A' 'A' 'U' 'A' 'U'
 'M' 'U' 'U' 'M' 'U' 'A' 'A' 'A' 'A' 'A' 'A' 'A' 'A' 'U' 'M' 'M' 'U' 'U'
 'M' 'U' 'U' 'M' 'M' 'A' 'M' 'M' 'U' 'A' 'U' 'U' 'M' 'U' 'A' 'U' 'U' 'U'
 'A' 'U' 'A' 'M' 'M' 'M' 'A' 'M' 'M' 'A' 'M' 'U' 'M' 'M' 'A' 'A' 'A' 'U'
 'A' 'A' 'U' 'A' 'U' 'A' 'A' 'U' 'M' 'U' 'U' 'U' 'M' 'A' 'U' 'U' 'M' 'U']"
3501,2,120,57,63,78,0,0,"['A' 'U' 'U' 'A' 'A' 'U' 'A' 'A' 'U' 'U' 'U' 'A' 'M' 'A' 'A' 'U' 'M' 'A'
 'M' 'M' 'U' 'M' 'U' 'M' 'U' 'U' 'A' 'M' 'A' 'U' 'A' 'A' 'U' 'U' 'U' 'M'
 'M' 'M' 'U' 'M' 'A' 'A' 'M' 'A' 'U' 'A' 'M' 'M' 'M' 'A' 'U' 'U' 'U' 'A'
 'A' 'M' 'U' 'A' 'A' 'U' 'A' 'M' 'M' 'A' 'M' 'M' 'M' 'M' 'M' 'M' 'M' 'M'
 'U' 'M' 'M' 'U' 'M' 'U' 'A' 'A' 'U' 'M' 'U' 'M' 'A' 'U' 'U' 'M' 'U' 'U'
 'U' 'A' 'U' 'M' 'U' 'U' 'U' 'A' 'U' 'U' 'A' 'A' 'U' 'U' 'M' 'M' 'M' 'U'
 'U' 'U' 'M' 'A' 'U' 'U' 'U' 'M' 'M' 'M' 'U' 'A' 'M' 'A' 'A' 'U' 'A' 'U'
 'M' 'A' 'U' 'M' 'M' 'A' 'A' 'A' 'A' 'A' 'A' 'A' 'A' 'U' 'M' 'M' 'U' 'U'
 'M' 'U' 'U' 'M' 'M' 'U' 'M' 'M' 'U' 'A' 'U' 'M' 'M' 'U' 'A' 'U' 'U' 'M'
 'A' 'U' 'U' 'M' 'M' 'U' 'A' 'U' 'M' 'A' 'M' 'U' 'M' 'M' 'A' 'U' 'A' 'U'
 'A' 'U' 'U' 'A' 'U' 'A' 'A' 'U' 'M' 'U' 'U' 'U' 'M' 'A' 'U' 'U' 'M' 'U']"
3601,0,114,53,61,84,0,1,"['A' 'U' 'U' 'A' 'U' 'U' 'A' 'A' 'U' 'A' 'U' 'A' 'M' 'U' 'A' 'U' 'M' 'A'
 'M' 'M' 'U' 'M' 'U' 'M' 'U' 'M' 'U' 'M' 'A' 'U' 'A' 'A' 'U' 'M' 'U' 'M'
 'M' 'M' 'U' 'U' 'U' 'A' 'U' 'A' 'U' 'A' 'M' 'A' 'M' 'A' 'U' 'U' 'M' 'A'
 'A' 'U' 'U' 'A' 'A' 'U' 'A' 'M' 'M' 'A' 'U' 'M' 'M' 'U' 'M' 'M' 'M' 'M'
 'M' 'M' 'M' 'M' 'U' 'U' 'A' 'A' 'M' 'M' 'M' 'M' 'A' 'U' 'U' 'M' 'U' 'U'
 'U' 'A' 'U' 'U' 'A' 'U' 'U' 'U' 'U' 'U' 'A' 'A' 'U' 'U' 'M' 'M' 'M' 'A'
 'U' 'M' 'M' 'A' 'U' 'U' 'U' 'M' 'M' 'M' 'U' 'U' 'M' 'U' 'A' 'U' 'A' 'A'
 'M' 'A' 'U' 'M' 'M' 'A' 'A' 'A' 'A' 'A' 'A' 'A' 'A' 'M' 'M' 'M' 'U' 'U'
 'M' 'U' 'U' 'U' 'M' 'U' 'U' 'M' 'U' 'A' 'U' 'U' 'M' 'M' 'A' 'U' 'U' 'M'
 'A' 'U' 'M' 'M' 'M' 'U' 'A' 'U' 'U' 'U' 'M' 'U' 'M' 'M' 'A' 'U' 'U' 'U'
 'A' 'M' 'U' 'A' 'U' 'A' 'U' 'U' 'M' 'U' 'U' 'A' 'U' 'A' 'U' 'U' 'U' 'U']"
3701,3,126,57,69,72,0,0,"['A' 'U' 'U' 'A' 'M' 'U' 'A' 'A' 'U' 'U' 'U' 'A' 'M' 'U' 'A' 'A' 'M' 'M'
 'M' 'M' 'U' 'M' 'M' 'M' 'U' 'U' 'U' 'M' 'A' 'U' 'A' 'A' 'A' 'M' 'U' 'M'
 'M' 'M' 'M' 'U' 'M' 'A' 'U' 'A' 'U' 'A' 'M' 'M' 'M' 'A' 'U' 'U' 'M' 'M'
 'A' 'A' 'M' 'A' 'A' 'U' 'A' 'M' 'U' 'U' 'U' 'M' 'M' 'M' 'U' 'M' 'M' 'M'
 'M' 'M' 'M' 'M' 'U' 'M' 'A' 'A' 'U' 'U' 'M' 'M' 'A' 'U' 'U' 'M' 'U' 'A'
 'U' 'A' 'U' 'M' 'A' 'A' 'M' 'U' 'U' 'A' 'U' 'A' 'A' 'M' 'M' 'M' 'M' 'A'
 'U' 'M' 'M' 'A' 'U' 'M' 'M' 'U' 'M' 'M' 'U' 'U' 'M' 'U' 'A' 'U' 'A' 'U'
 'U' 'A' 'U' 'M' 'M' 'A' 'A' 'A' 'A' 'A' 'A' 'A' 'A' 'M' 'A' 'M' 'A' 'M'
 'M' 'U' 'U' 'A' 'M' 'U' 'U' 'U' 'M' 'A' 'M' 'U' 'M' 'U' 'A' 'U' 'U' 'U'
 'A' 'A' 'M' 'M' 'M' 'U' 'A' 'U' 'U' 'U' 'M' 'U' 'M' 'U' 'A' 'U' 'U' 'U'
 'A' 'M' 'U' 'A' 'U' 'U' 'M' 'U' 'M' 'U' 'A' 'A' 'U' 'A' 'U' 'U' 'M' 'U']"
3801,1,112,45,67,86,1,0,"['A' 'U' 'U' 'A' 'U' 'U' 'A' 'U' 'U' 'U' 'U' 'U' 'M' 'U' 'A' 'A' 'M' 'U'
 'U' 'U' 'U' 'M' 'M' 'M' 'U' 'A' 'M' 'M' 'A' 'U' 'U' 'A' 'U' 'M' 'U' 'M'
 'M' 'U' 'U' 'U' 'U' 'A' 'U' 'A' 'U' 'A' 'M' 'M' 'M' 'U' 'U' 'M' 'M' 'M'
 'A' 'M' 'U' 'U' 'U' 'U' 'A' 'U' 'U' 'U' 'M' 'M' 'M' 'M' 'M' 'M' 'M' 'M'
 'M' 'M' 'U' 'M' 'M' 'M' 'A' 'A' 'M' 'U' 'M' 'U' 'A' 'U' 'M' 'M' 'U' 'A'
 'U' 'A' 'U' 'M' 'U' 'A' 'M' 'U' 'U' 'U' 'U' 'U' 'U' 'M' 'M' 'M' 'M' 'A'
 'U' 'M' 'U' 'U' 'U' 'M' 'M' 'U' 'M' 'M' 'M' 'U' 'M' 'M' 'A' 'A' 'U' 'U'
 'U' 'A' 'U' 'M' 'M' 'A' 'A' 'A' 'A' 'A' 'A' 'A' 'A' 'M' 'A' 'U' 'A' 'M'
 'M' 'M' 'M' 'A' 'M' 'M' 'U' 'A' 'M' 'A' 'M' 'U' 'U' 'U' 'A' 'U' 'A' 'U'
 'U' 'A' 'M' 'U' 'M' 'U' 'A' 'U' 'U' 'U' 'M' 'U' 'M' 'U' 'A' 'M' 'A' 'U'
 'U' 'M' 'U' 'A' 'U' 'A' 'M' 'U' 'U' 'U' 'U' 'U' 'U' 'A' 'U' 'U' 'M' 'U']"
3901,1,110,44,66,88,0,1,"['A' 'U' 'U' 'A' 'U' 'U' 'A' 'A' 'U' 'A' 'U' 'U' 'M' 'U' 'U' 'U' 'M' 'U'
 'U' 'U' 'U' 'M' 'M' 'M' 'U' 'U' 'M' 'U' 'A' 'U' 'U' 'A' 'U' 'M' 'U' 'M'
 'M' 'M' 'A' 'U' 'U' 'U' 'M' 'U' 'A' 'A' 'M' 'U' 'M' 'M' 'U' 'U' 'U' 'M'
 'A' 'M' 'U' 'M' 'U' 'A' 'A' 'U' 'U' 'M' 'M' 'M' 'M' 'M' 'M' 'M' 'M' 'M'
 'M' 'M' 'U' 'M' 'M' 'M' 'A' 'A' 'M' 'U' 'U' 'U' 'A' 'U' 'M' 'U' 'U' 'A'
 'U' 'A' 'U' 'M' 'M' 'A' 'M' 'U' 'U' 'M' 'U' 'U' 'M' 'M' 'M' 'M' 'M' 'A'
 'M' 'M' 'U' 'U' 'U' 'M' 'U' 'U' 'M' 'M' 'U' 'M' 'U' 'U' 'U' 'A' 'U' 'U'
 'U' 'A' 'U' 'M' 'M' 'A' 'A' 'A' 'A' 'A' 'U' 'A' 'A' 'U' 'U' 'U' 'U' 'M'
 'U' 'M' 'M' 'A' 'M' 'M' 'U' 'U' 'M' 'A' 'A' 'A' 'U' 'U' 'A' 'U' 'A' 'M'
 'U' 'A' 'M' 'U' 'M' 'U' 'A' 'U' 'U' 'U' 'U' 'M' 'M' 'A' 'A' 'M' 'A' 'M'
 'U' 'U' 'U' 'U' 'M' 'A' 'M' 'U' 'U' 'U' 'U' 'U' 'A' 'A' 'U' 'U' 'M' 'A']"
4001,1,116,55,61,82,0,0,"['A' 'U' 'U' 'A' 'A' 'U' 'A' 'A' 'M' 'A' 'U' 'U' 'M' 'U' 'U' 'U' 'M' 'M'
 'U' 'U' 'U' 'U' 'M' 'M' 'U' 'U' 'M' 'U' 'A' 'U' 'A' 'U' 'A' 'M' 'M' 'U'
 'M' 'M' 'A' 'U' 'U' 'U' 'M' 'U' 'A' 'A' 'M' 'U' 'A' 'M' 'A' 'M' 'U' 'M'
 'A' 'U' 'U' 'M' 'A' 'A' 'A' 'M' 'A' 'M' 'M' 'M' 'M' 'U' 'M' 'M' 'M' 'M'
 'M' 'M' 'M' 'M' 'M' 'M' 'U' 'A' 'U' 'A' 'A' 'U' 'A' 'U' 'M' 'U' 'M' 'A'
 'A' 'A' 'U' 'M' 'M' 'A' 'U' 'U' 'U' 'M' 'U' 'U' 'M' 'A' 'M' 'U' 'M' 'A'
 'U' 'M' 'U' 'U' 'U' 'U' 'U' 'U' 'M' 'M' 'U' 'U' 'U' 'M' 'U' 'U' 'U' 'U'
 'U' 'A' 'U' 'U' 'M' 'A' 'A' 'A' 'A' 'A' 'A' 'A' 'A' 'U' 'U' 'U' 'U' 'M'
 'U' 'M' 'M' 'A' 'M' 'M' 'U' 'U' 'M' 'A' 'A' 'A' 'U' 'U' 'A' 'A' 'A' 'M'
 'A' 'U' 'M' 'M' 'M' 'A' 'U' 'U' 'U' 'U' 'U' 'M' 'A' 'A' 'A' 'M' 'U' 'M'
 'U' 'A' 'U' 'U' 'M' 'A' 'M' 'U' 'U' 'U' 'U' 'U' 'A' 'A' 'U' 'U' 'M' 'A']"
4101,3,129,60,69,69,0,0,"['A' 'U' 'U' 'A' 'A' 'U' 'A' 'A' 'M' 'U' 'M' 'A' 'M' 'U' 'U' 'U' 'M' 'M'
 'U' 'M' 'U' 'U' 'M' 'M' 'U' 'U' 'M' 'U' 'A' 'U' 'A' 'U' 'U' 'M' 'M' 'U'
 'U' 'M' 'A' 'U' 'M' 'U' 'U' 'M' 'A' 'A' 'M' 'M' 'A' 'M' 'A' 'U' 'A' 'M'
 'A' 'A' 'U' 'M' 'A' 'A' 'A' 'M' 'A' 'M' 'M' 'M' 'M' 'M' 'M' 'M' 'M' 'M'
 'U' 'M' 'M' 'M' 'U' 'M' 'A' 'A' 'M' 'A' 'M' 'U' 'A' 'U' 'M' 'U' 'M' 'A'
 'A' 'A' 'M' 'U' 'M' 'A' 'U' 'U' 'U' 'M' 'U' 'A' 'M' 'A' 'M' 'U' 'M' 'A'
 'U' 'M' 'M' 'A' 'U' 'M' 'U' 'U' 'M' 'M' 'M' 'U' 'A' 'M' 'A' 'U' 'M' 'U'
 'U' 'U' 'A' 'U' 'M' 'A' 'A' 'A' 'A' 'A' 'A' 'A' 'A' 'M' 'U' 'U' 'U' 'M'
 'U' 'U' 'M' 'U' 'U' 'M' 'A' 'U' 'M' 'U' 'A' 'A' 'U' 'U' 'A' 'A' 'A' 'M'
 'A' 'U' 'M' 'M' 'M' 'A' 'U' 'U' 'U' 'U' 'U' 'M' 'A' 'A' 'A' 'A' 'U' 'U'
 'M' 'A' 'U' 'U' 'M' 'U' 'M' 'U' 'M' 'M' 'U' 'U' 'A' 'A' 'M' 'A' 'M' 'A']"
4201,2,123,58,65,75,0,0,"['A' 'M' 'U' 'A' 'A' 'A' 'A' 'U' 'M' 'U' 'M' 'A' 'M' 'U' 'U' 'A' 'M' 'M'
 'U' 'A' 'M' 'U' 'M' 'M' 'U' 'M' 'M' 'U' 'A' 'M' 'A' 'U' 'U' 'U' 'M' 'A'
 'U' 'M' 'U' 'A' 'U' 'U' 'M' 'M' 'A' 'A' 'M' 'U' 'A' 'U' 'A' 'U' 'A' 'M'
 'A' 'A' 'U' 'M' 'U' 'A' 'A' 'M' 'A' 'M' 'M' 'M' 'M' 'M' 'M' 'U' 'M' 'M'
 'M' 'M' 'M' 'U' 'U' 'M' 'U' 'A' 'M' 'A' 'M' 'U' 'A' 'U' 'M' 'U' 'M' 'U'
 'A' 'A' 'M' 'U' 'M' 'A' 'U' 'U' 'M' 'M' 'U' 'U' 'M' 'A' 'M' 'U' 'M' 'A'
 'U' 'M' 'U' 'A' 'U' 'U' 'A' 'U' 'M' 'M' 'U' 'U' 'A' 'U' 'A' 'M' 'M' 'M'
 'U' 'U' 'U' 'U' 'U' 'A' 'A' 'A' 'A' 'A' 'A' 'A' 'A' 'U' 'M' 'U' 'U' 'U'
 'A' 'U' 'M' 'M' 'U' 'M' 'A' 'U' 'M' 'U' 'A' 'A' 'U' 'U' 'U' 'A' 'A' 'U'
 'A' 'M' 'U' 'M' 'U' 'A' 'U' 'M' 'U' 'U' 'M' 'M' 'A' 'A' 'A' 'A' 'U' 'M'
 'U' 'A' 'M' 'U' 'U' 'U' 'M' 'U' 'U' 'U' 'M' 'U' 'A' 'A' 'M' 'U' 'M' 'A']"
4301,2,128,61,67,70,0,0,"['A' 'M' 'U' 'A' 'A' 'U' 'U' 'U' 'M' 'U' 'M' 'A' 'M' 'U' 'M' 'A' 'M' 'U'
 'U' 'A' 'M' 'U' 'M' 'M' 'U' 'M' 'U' 'U' 'A' 'M' 'A' 'U' 'U' 'U' 'M' 'A'
 'U' 'M' 'M' 'A' 'M' 'M' 'M' 'M' 'A' 'A' 'M' 'U' 'A' 'M' 'A' 'U' 'A' 'M'
 'A' 'A' 'U' 'M' 'U' 'A' 'A' 'U' 'A' 'M' 'M' 'M' 'M' 'M' 'M' 'M' 'U' 'M'
 'M' 'M' 'M' 'U' 'U' 'M' 'A' 'U' 'M' 'A' 'M' 'U' 'A' 'U' 'M' 'U' 'M' 'M'
 'A' 'A' 'M' 'U' 'U' 'A' 'A' 'U' 'M' 'M' 'M' 'U' 'U' 'A' 'M' 'U' 'M' 'A'
 'M' 'M' 'U' 'A' 'U' 'U' 'A' 'U' 'M' 'M' 'U' 'U' 'U' 'U' 'A' 'M' 'M' 'M'
 'U' 'U' 'U' 'A' 'A' 'A' 'A' 'A' 'A' 'A' 'A' 'A' 'A' 'U' 'M' 'U' 'U' 'A'
 'U' 'M' 'A' 'U' 'A' 'U' 'A' 'U' 'M' 'A' 'A' 'U' 'U' 'U' 'U' 'A' 'A' 'U'
 'A' 'M' 'U' 'M' 'U' 'A' 'U' 'M' 'U' 'M' 'M' 'M' 'A' 'A' 'A' 'A' 'U' 'M'
 'U' 'M' 'M' 'U' 'U' 'U' 'U' 'A' 'U' 'U' 'M' 'U' 'A' 'A' 'M' 'A' 'M' 'A']"
4401,2,121,59,62,77,1,0,"['A' 'M' 'U' 'A' 'A' 'U' 'U' 'U' 'M' 'U' 'M' 'A' 'M' 'U' 'M' 'A' 'U' 'M'
 'U' 'M' 'M' 'A' 'M' 'M' 'U' 'M' 'U' 'U' 'A' 'M' 'A' 'U' 'U' 'U' 'M' 'A'
 'U' 'M' 'M' 'U' 'M' 'U' 'M' 'M' 'A' 'A' 'U' 'U' 'A' 'M' 'A' 'U' 'A' 'U'
 'A' 'U' 'U' 'U' 'U' 'A' 'A' 'U' 'A' 'M' 'M' 'M' 'M' 'M' 'M' 'M' 'M' 'M'
 'M' 'M' 'U' 'U' 'U' 'A' 'A' 'U' 'M' 'A' 'M' 'M' 'A' 'U' 'M' 'U' 'U' 'U'
 'A' 'A' 'A' 'A' 'U' 'A' 'A' 'U' 'U' 'M' 'M' 'U' 'U' 'A' 'M' 'U' 'M' 'A'
 'U' 'M' 'M' 'U' 'U' 'U' 'A' 'U' 'M' 'M' 'U' 'U' 'U' 'U' 'A' 'U' 'M' 'U'
 'U' 'U' 'M' 'A' 'A' 'A' 'A' 'A' 'A' 'A' 'A' 'A' 'A' 'U' 'M' 'U' 'U' 'A'
 'U' 'M' 'A' 'U' 'A' 'M' 'U' 'U' 'M' 'U' 'U' 'U' 'U' 'A' 'U' 'A' 'A' 'M'
 'A' 'A' 'U' 'M' 'U' 'U' 'U' 'M' 'M' 'M' 'M' 'M' 'A' 'A' 'A' 'A' 'M' 'M'
 'U' 'M' 'M' 'U' 'U' 'U' 'U' 'A' 'A' 'U' 'M' 'A' 'A' 'U' 'M' 'U' 'M' 'A']"
4501,1,117,56,61,81,1,0,"['A' 'U' 'U' 'A' 'A' 'M' 'U' 'A' 'M' 'U' 'M' 'A' 'M' 'A' 'M' 'A' 'M' 'M'
 'M' 'U' 'M' 'A' 'M' 'M' 'A' 'M' 'U' 'U' 'U' 'U' 'A' 'U' 'U' 'U' 'M' 'A'
 'M' 'U' 'M' 'U' 'M' 'U' 'U' 'M' 'U' 'A' 'U' 'U' 'U' 'M' 'A' 'U' 'A' 'U'
 'U' 'U' 'U' 'U' 'U' 'A' 'A' 'U' 'A' 'M' 'M' 'M' 'M' 'M' 'M' 'U' 'M' 'M'
 'M' 'M' 'M' 'U' 'U' 'A' 'U' 'M' 'M' 'A' 'U' 'M' 'A' 'U' 'U' 'M' 'A' 'U'
 'A' 'A' 'A' 'A' 'A' 'A' 'A' 'M' 'M' 'M' 'M' 'U' 'M' 'A' 'M' 'U' 'M' 'A'
 'A' 'U' 'U' 'U' 'U' 'U' 'U' 'U' 'M' 'M' 'U' 'M' 'U' 'U' 'A' 'U' 'U' 'U'
 'U' 'U' 'M' 'M' 'A' 'A' 'A' 'A' 'A' 'A' 'A' 'A' 'A' 'U' 'M' 'U' 'U' 'U'
 'U' 'M' 'A' 'U' 'A' 'M' 'U' 'M' 'M' 'U' 'U' 'A' 'U' 'A' 'A' 'A' 'A' 'M'
 'A' 'A' 'A' 'U' 'U' 'U' 'U' 'U' 'M' 'U' 'M' 'M' 'A' 'A' 'U' 'U' 'M' 'M'
 'U' 'M' 'U' 'U' 'U' 'U' 'U' 'A' 'U' 'U' 'M' 'A' 'U' 'U' 'M' 'M' 'M' 'A']"
4601,3,124,55,69,74,0,0,"['A' 'U' 'U' 'A' 'M' 'M' 'U' 'A' 'M' 'U' 'U' 'A' 'A' 'U' 'M' 'A' 'U' 'M'
 'M' 'U' 'M' 'A' 'U' 'M' 'A' 'M' 'U' 'M' 'U' 'U' 'A' 'U' 'U' 'U' 'M' 'A'
 'M' 'A' 'M' 'M' 'M' 'U' 'U' 'M' 'A' 'A' 'U' 'U' 'A' 'M' 'A' 'A' 'U' 'U'
 'U' 'U' 'U' 'U' 'U' 'A' 'A' 'U' 'A' 'M' 'M' 'M' 'M' 'M' 'M' 'M' 'M' 'M'
 'M' 'U' 'M' 'M' 'U' 'A' 'U' 'M' 'M' 'A' 'M' 'M' 'U' 'U' 'M' 'M' 'A' 'M'
 'A' 'A' 'A' 'U' 'A' 'A' 'U' 'M' 'M' 'M' 'M' 'M' 'M' 'U' 'M' 'U' 'M' 'A'
 'A' 'A' 'M' 'U' 'U' 'U' 'U' 'M' 'M' 'A' 'U' 'M' 'U' 'U' 'A' 'U' 'U' 'U'
 'U' 'M' 'M' 'M' 'A' 'A' 'A' 'A' 'A' 'A' 'A' 'A' 'A' 'U' 'U' 'U' 'U' 'M'
 'U' 'M' 'A' 'U' 'A' 'M' 'U' 'M' 'U' 'M' 'U' 'U' 'U' 'A' 'A' 'U' 'M' 'M'
 'A' 'A' 'A' 'U' 'U' 'U' 'U' 'U' 'U' 'U' 'M' 'M' 'A' 'A' 'U' 'U' 'M' 'M'
 'M' 'M' 'U' 'M' 'A' 'U' 'U' 'A' 'U' 'U' 'M' 'A' 'U' 'M' 'M' 'M' 'A' 'A']"
4701,0,121,48,73,77,0,1,"['A' 'U' 'U' 'M' 'M' 'M' 'U' 'A' 'M' 'U' 'A' 'A' 'A' 'U' 'M' 'A' 'U' 'M'
 'M' 'U' 'A' 'A' 'M' 'M' 'U' 'M' 'U' 'M' 'U' 'U' 'A' 'U' 'U' 'A' 'M' 'A'
 'M' 'U' 'M' 'M' 'M' 'M' 'U' 'M' 'U' 'U' 'U' 'U' 'A' 'M' 'A' 'U' 'U' 'U'
 'U' 'U' 'U' 'U' 'U' 'A' 'A' 'M' 'A' 'M' 'M' 'M' 'M' 'M' 'M' 'M' 'M' 'M'
 'M' 'M' 'U' 'U' 'M' 'U' 'U' 'M' 'M' 'U' 'M' 'U' 'U' 'U' 'M' 'M' 'A' 'M'
 'A' 'U' 'U' 'U' 'A' 'A' 'U' 'M' 'M' 'M' 'M' 'M' 'M' 'U' 'U' 'M' 'M' 'U'
 'A' 'A' 'U' 'U' 'M' 'U' 'A' 'M' 'M' 'U' 'U' 'M' 'U' 'U' 'A' 'U' 'U' 'A'
 'U' 'M' 'M' 'M' 'A' 'A' 'A' 'A' 'A' 'A' 'A' 'A' 'A' 'A' 'M' 'M' 'U' 'M'
 'U' 'U' 'M' 'U' 'A' 'M' 'U' 'A' 'U' 'M' 'U' 'A' 'M' 'A' 'A' 'U' 'M' 'M'
 'U' 'A' 'A' 'U' 'U' 'M' 'M' 'U' 'U' 'U' 'M' 'M' 'A' 'U' 'M' 'U' 'M' 'M'
 'U' 'M' 'A' 'M' 'U' 'U' 'U' 'A' 'U' 'U' 'M' 'A' 'U' 'M' 'U' 'U' 'A' 'A']"
4801,0,121,47,74,77,0,0,"['A' 'U' 'U' 'M' 'M' 'M' 'M' 'U' 'M' 'U' 'A' 'U' 'A' 'U' 'M' 'A' 'U' 'U'
 'M' 'M' 'A' 'A' 'M' 'M' 'M' 'U' 'U' 'U' 'A' 'M' 'U' 'M' 'U' 'A' 'M' 'M'
 'M' 'U' 'M' 'M' 'M' 'M' 'U' 'M' 'A' 'U' 'U' 'A' 'A' 'M' 'A' 'M' 'U' 'U'
 'U' 'U' 'U' 'U' 'U' 'M' 'A' 'M' 'A' 'M' 'M' 'M' 'M' 'M' 'M' 'M' 'M' 'M'
 'U' 'M' 'M' 'A' 'M' 'M' 'U' 'U' 'M' 'U' 'M' 'A' 'U' 'U' 'U' 'M' 'A' 'U'
 'A' 'A' 'U' 'U' 'A' 'A' 'A' 'M' 'M' 'A' 'M' 'M' 'M' 'U' 'A' 'M' 'M' 'U'
 'A' 'A' 'U' 'A' 'M' 'U' 'U' 'M' 'M' 'U' 'A' 'M' 'U' 'U' 'A' 'U' 'M' 'A'
 'U' 'M' 'M' 'U' 'A' 'U' 'A' 'A' 'A' 'A' 'A' 'A' 'A' 'A' 'M' 'M' 'U' 'M'
 'U' 'U' 'M' 'U' 'A' 'M' 'U' 'A' 'U' 'M' 'M' 'A' 'U' 'U' 'M' 'U' 'M' 'U'
 'U' 'A' 'U' 'U' 'A' 'M' 'U' 'U' 'U' 'U' 'M' 'M' 'U' 'U' 'M' 'U' 'M' 'M'
 'M' 'M' 'U' 'U' 'U' 'U' 'U' 'A' 'U' 'U' 'M' 'A' 'U' 'M' 'U' 'U' 'A' 'U']"
4901,2,122,50,72,76,0,1,"['A' 'U' 'U' 'U' 'M' 'M' 'U' 'U' 'M' 'U' 'A' 'U' 'A' 'U' 'U' 'A' 'U' 'U'
 'M' 'M' 'A' 'A' 'M' 'U' 'M' 'U' 'U' 'U' 'A' 'M' 'U' 'M' 'U' 'A' 'U' 'M'
 'M' 'U' 'M' 'M' 'M' 'U' 'U' 'M' 'A' 'U' 'U' 'U' 'A' 'M' 'A' 'M' 'M' 'M'
 'U' 'U' 'U' 'U' 'U' 'M' 'A' 'M' 'A' 'M' 'M' 'M' 'M' 'M' 'M' 'M' 'M' 'U'
 'M' 'M' 'M' 'A' 'M' 'M' 'M' 'U' 'M' 'U' 'M' 'A' 'A' 'U' 'A' 'U' 'U' 'M'
 'A' 'A' 'A' 'A' 'A' 'A' 'U' 'M' 'M' 'U' 'M' 'M' 'M' 'U' 'A' 'U' 'M' 'A'
 'A' 'U' 'A' 'A' 'M' 'U' 'U' 'M' 'M' 'U' 'A' 'M' 'U' 'U' 'U' 'U' 'M' 'A'
 'U' 'A' 'M' 'A' 'A' 'A' 'A' 'A' 'A' 'A' 'A' 'A' 'A' 'A' 'M' 'U' 'M' 'M'
 'M' 'U' 'M' 'U' 'U' 'M' 'U' 'A' 'U' 'M' 'U' 'U' 'U' 'U' 'M' 'M' 'M' 'U'
 'U' 'A' 'M' 'M' 'A' 'M' 'U' 'U' 'M' 'M' 'M' 'M' 'U' 'A' 'U' 'U' 'M' 'M'
 'M' 'U' 'A' 'U' 'A' 'U' 'U' 'A' 'U' 'U' 'M' 'A' 'U' 'M' 'U' 'U' 'U' 'U']"
5001,1,127,51,76,71,0,0,"['A' 'U' 'U' 'U' 'U' 'M' 'U' 'U' 'M' 'U' 'A' 'M' 'A' 'U' 'M' 'A' 'U' 'A'
 'M' 'M' 'U' 'A' 'M' 'U' 'M' 'U' 'U' 'M' 'A' 'M' 'U' 'M' 'U' 'A' 'U' 'M'
 'M' 'U' 'M' 'U' 'M' 'A' 'U' 'M' 'U' 'U' 'M' 'M' 'A' 'M' 'A' 'M' 'M' 'M'
 'M' 'U' 'U' 'U' 'A' 'M' 'M' 'M' 'A' 'M' 'M' 'M' 'M' 'M' 'M' 'M' 'M' 'M'
 'M' 'M' 'U' 'U' 'M' 'M' 'M' 'U' 'M' 'U' 'M' 'A' 'A' 'U' 'U' 'U' 'U' 'M'
 'M' 'U' 'A' 'A' 'A' 'A' 'A' 'M' 'M' 'A' 'M' 'M' 'M' 'M' 'A' 'U' 'U' 'A'
 'A' 'U' 'A' 'A' 'U' 'U' 'U' 'M' 'M' 'U' 'A' 'U' 'U' 'U' 'U' 'U' 'M' 'A'
 'U' 'A' 'M' 'A' 'A' 'A' 'A' 'A' 'A' 'A' 'U' 'A' 'A' 'A' 'M' 'U' 'M' 'M'
 'U' 'U' 'M' 'U' 'A' 'M' 'U' 'A' 'U' 'M' 'U' 'U' 'U' 'U' 'M' 'M' 'M' 'M'
 'U' 'A' 'U' 'M' 'A' 'M' 'U' 'A' 'M' 'M' 'M' 'U' 'A' 'A' 'U' 'U' 'U' 'U'
 'M' 'M' 'U' 'U' 'A' 'A' 'U' 'A' 'A' 'M' 'M' 'A' 'U' 'M' 'U' 'U' 'M' 'M']"
5101,0,122,52,70,76,0,0,"['A' 'U' 'U' 'U' 'U' 'M' 'M' 'U' 'M' 'M' 'A' 'M' 'A' 'U' 'M' 'A' 'U' 'U'
 'M' 'M' 'U' 'A' 'M' 'U' 'M' 'U' 'A' 'M' 'U' 'M' 'U' 'M' 'U' 'U' 'U' 'U'
 'M' 'U' 'M' 'U' 'U' 'A' 'A' 'U' 'U' 'U' 'M' 'M' 'A' 'U' 'A' 'M' 'U' 'U'
 'M' 'A' 'U' 'U' 'A' 'M' 'M' 'M' 'U' 'M' 'U' 'U' 'M' 'M' 'M' 'M' 'M' 'M'
 'M' 'M' 'M' 'U' 'U' 'M' 'M' 'U' 'M' 'U' 'A' 'A' 'U' 'U' 'U' 'U' 'A' 'U'
 'M' 'U' 'A' 'A' 'A' 'U' 'A' 'M' 'M' 'A' 'U' 'U' 'M' 'M' 'A' 'U' 'U' 'A'
 'A' 'U' 'A' 'A' 'U' 'U' 'U' 'U' 'M' 'U' 'A' 'U' 'A' 'A' 'M' 'U' 'M' 'A'
 'U' 'U' 'M' 'A' 'A' 'A' 'A' 'A' 'A' 'U' 'A' 'A' 'A' 'A' 'M' 'U' 'M' 'M'
 'U' 'A' 'M' 'U' 'U' 'M' 'U' 'A' 'A' 'M' 'U' 'U' 'U' 'U' 'M' 'U' 'M' 'M'
 'M' 'A' 'M' 'M' 'A' 'M' 'U' 'A' 'M' 'U' 'M' 'U' 'A' 'A' 'M' 'M' 'M' 'M'
 'M' 'M' 'U' 'U' 'A' 'A' 'U' 'A' 'A' 'M' 'M' 'A' 'U' 'M' 'U' 'U' 'M' 'M']"
5201,1,121,50,71,77,0,1,"['A' 'U' 'A' 'U' 'U' 'M' 'U' 'M' 'M' 'A' 'U' 'M' 'A' 'A' 'M' 'A' 'U' 'U'
 'A' 'U' 'U' 'A' 'A' 'U' 'M' 'U' 'U' 'M' 'U' 'M' 'U' 'U' 'U' 'U' 'U' 'U'
 'M' 'U' 'M' 'M' 'M' 'A' 'A' 'U' 'U' 'U' 'M' 'M' 'M' 'M' 'A' 'M' 'U' 'U'
 'M' 'A' 'M' 'U' 'A' 'U' 'M' 'M' 'U' 'M' 'U' 'M' 'M' 'M' 'M' 'M' 'U' 'M'
 'M' 'M' 'M' 'A' 'A' 'M' 'M' 'A' 'M' 'U' 'A' 'A' 'U' 'M' 'A' 'U' 'A' 'U'
 'M' 'U' 'U' 'U' 'A' 'U' 'U' 'M' 'U' 'U' 'U' 'M' 'U' 'M' 'A' 'U' 'U' 'U'
 'A' 'U' 'U' 'A' 'U' 'A' 'U' 'M' 'M' 'M' 'A' 'U' 'A' 'U' 'M' 'U' 'M' 'U'
 'U' 'U' 'U' 'U' 'U' 'A' 'A' 'A' 'A' 'A' 'A' 'A' 'A' 'A' 'M' 'U' 'M' 'M'
 'U' 'A' 'M' 'A' 'A' 'M' 'U' 'A' 'A' 'M' 'U' 'U' 'M' 'U' 'M' 'U' 'M' 'M'
 'M' 'U' 'M' 'M' 'A' 'M' 'U' 'A' 'U' 'U' 'M' 'M' 'A' 'A' 'M' 'M' 'M' 'M'
 'M' 'M' 'U' 'U' 'U' 'A' 'U' 'A' 'A' 'M' 'M' 'A' 'U' 'U' 'U' 'M' 'M' 'M']"
5301,2,125,47,78,73,1,0,"['A' 'U' 'U' 'U' 'U' 'M' 'U' 'U' 'M' 'A' 'U' 'U' 'A' 'U' 'M' 'A' 'A' 'U'
 'U' 'U' 'M' 'A' 'A' 'U' 'U' 'U' 'U' 'M' 'U' 'M' 'U' 'U' 'U' 'U' 'A' 'U'
 'M' 'M' 'M' 'M' 'M' 'A' 'A' 'M' 'U' 'M' 'M' 'M' 'M' 'U' 'A' 'M' 'U' 'U'
 'M' 'A' 'M' 'M' 'A' 'U' 'M' 'M' 'U' 'M' 'M' 'U' 'M' 'M' 'M' 'M' 'M' 'M'
 'M' 'M' 'M' 'A' 'U' 'M' 'M' 'A' 'U' 'U' 'A' 'A' 'M' 'M' 'A' 'U' 'A' 'U'
 'M' 'U' 'U' 'A' 'A' 'U' 'A' 'M' 'A' 'U' 'A' 'M' 'M' 'M' 'U' 'U' 'U' 'U'
 'A' 'U' 'U' 'U' 'M' 'A' 'U' 'M' 'M' 'M' 'A' 'M' 'A' 'M' 'M' 'U' 'M' 'U'
 'U' 'U' 'M' 'U' 'U' 'A' 'A' 'A' 'A' 'A' 'A' 'A' 'A' 'U' 'M' 'U' 'M' 'M'
 'M' 'A' 'M' 'A' 'U' 'M' 'U' 'A' 'A' 'M' 'U' 'U' 'M' 'M' 'U' 'U' 'M' 'M'
 'M' 'M' 'M' 'U' 'U' 'M' 'U' 'A' 'U' 'U' 'M' 'M' 'U' 'A' 'M' 'U' 'M' 'M'
 'M' 'M' 'U' 'U' 'U' 'A' 'U' 'A' 'A' 'M' 'M' 'A' 'U' 'A' 'U' 'M' 'M' 'M']"
5401,1,130,47,83,68,0,1,"['A' 'M' 'M' 'U' 'U' 'M' 'A' 'A' 'A' 'A' 'U' 'M' 'U' 'U' 'M' 'A' 'A' 'U'
 'U' 'U' 'M' 'A' 'A' 'U' 'U' 'M' 'U' 'M' 'M' 'M' 'U' 'U' 'U' 'U' 'A' 'U'
 'M' 'U' 'M' 'M' 'M' 'A' 'A' 'M' 'U' 'M' 'M' 'M' 'M' 'U' 'A' 'M' 'U' 'U'
 'M' 'A' 'M' 'U' 'A' 'U' 'M' 'M' 'U' 'M' 'M' 'M' 'U' 'M' 'M' 'M' 'M' 'M'
 'M' 'M' 'M' 'A' 'U' 'M' 'M' 'M' 'U' 'M' 'A' 'A' 'M' 'M' 'A' 'M' 'U' 'U'
 'M' 'A' 'U' 'A' 'A' 'U' 'A' 'M' 'A' 'U' 'A' 'M' 'M' 'U' 'M' 'U' 'U' 'M'
 'A' 'U' 'U' 'A' 'U' 'A' 'U' 'U' 'M' 'U' 'A' 'M' 'A' 'U' 'M' 'U' 'M' 'M'
 'M' 'U' 'M' 'U' 'U' 'U' 'A' 'A' 'A' 'A' 'A' 'A' 'A' 'U' 'M' 'U' 'M' 'M'
 'M' 'A' 'A' 'A' 'M' 'M' 'U' 'U' 'A' 'M' 'M' 'U' 'U' 'M' 'U' 'U' 'M' 'U'
 'M' 'M' 'M' 'M' 'U' 'M' 'U' 'M' 'U' 'M' 'M' 'U' 'U' 'U' 'M' 'A' 'M' 'M'
 'M' 'M' 'U' 'U' 'U' 'A' 'U' 'A' 'A' 'M' 'M' 'U' 'A' 'A' 'U' 'M' 'M' 'M']"
5501,2,130,46,84,68,0,0,"['A' 'M' 'M' 'U' 'U' 'U' 'A' 'A' 'U' 'A' 'U' 'A' 'U' 'U' 'M' 'A' 'A' 'U'
 'M' 'U' 'M' 'A' 'A' 'U' 'U' 'M' 'U' 'M' 'M' 'M' 'M' 'U' 'U' 'U' 'A' 'U'
 'U' 'M' 'M' 'M' 'M' 'U' 'A' 'M' 'U' 'M' 'M' 'M' 'M' 'U' 'A' 'U' 'U' 'M'
 'M' 'A' 'M' 'U' 'A' 'U' 'M' 'M' 'U' 'M' 'M' 'M' 'M' 'U' 'M' 'M' 'M' 'M'
 'M' 'M' 'M' 'A' 'U' 'U' 'M' 'M' 'U' 'M' 'U' 'A' 'M' 'M' 'U' 'U' 'M' 'U'
 'M' 'M' 'U' 'A' 'A' 'U' 'A' 'M' 'A' 'U' 'A' 'M' 'M' 'M' 'U' 'U' 'M' 'M'
 'A' 'U' 'U' 'A' 'U' 'A' 'U' 'U' 'M' 'U' 'A' 'U' 'M' 'U' 'M' 'U' 'M' 'M'
 'M' 'U' 'A' 'A' 'M' 'A' 'A' 'A' 'A' 'A' 'A' 'A' 'A' 'U' 'M' 'U' 'M' 'M'
 'M' 'A' 'A' 'U' 'M' 'M' 'A' 'A' 'A' 'M' 'M' 'U' 'U' 'M' 'U' 'M' 'M' 'U'
 'M' 'M' 'M' 'M' 'U' 'A' 'U' 'M' 'U' 'M' 'U' 'M' 'U' 'U' 'M' 'A' 'M' 'M'
 'M' 'M' 'U' 'M' 'U' 'A' 'U' 'A' 'U' 'M' 'M' 'U' 'A' 'A' 'U' 'M' 'M' 'U']"
5601,1,126,43,83,72,1,0,"['A' 'M' 'M' 'M' 'U' 'U' 'A' 'A' 'U' 'A' 'U' 'U' 'U' 'M' 'M' 'A' 'A' 'U'
 'M' 'U' 'M' 'A' 'A' 'U' 'U' 'M' 'U' 'M' 'M' 'M' 'M' 'U' 'U' 'A' 'A' 'U'
 'U' 'M' 'M' 'M' 'M' 'U' 'M' 'U' 'U' 'U' 'M' 'M' 'M' 'U' 'U' 'M' 'U' 'M'
 'M' 'U' 'M' 'U' 'A' 'U' 'U' 'U' 'M' 'M' 'M' 'M' 'M' 'M' 'M' 'M' 'M' 'M'
 'M' 'M' 'U' 'A' 'U' 'U' 'U' 'M' 'A' 'M' 'M' 'A' 'M' 'M' 'A' 'U' 'M' 'U'
 'M' 'M' 'M' 'U' 'U' 'U' 'A' 'M' 'U' 'U' 'U' 'M' 'M' 'M' 'U' 'U' 'M' 'M'
 'A' 'A' 'A' 'A' 'U' 'A' 'U' 'U' 'M' 'A' 'A' 'U' 'M' 'U' 'M' 'U' 'M' 'M'
 'M' 'U' 'U' 'U' 'M' 'A' 'A' 'A' 'A' 'A' 'A' 'A' 'A' 'U' 'M' 'U' 'M' 'U'
 'M' 'A' 'A' 'U' 'M' 'U' 'A' 'A' 'U' 'M' 'M' 'U' 'U' 'M' 'U' 'M' 'U' 'M'
 'U' 'M' 'M' 'U' 'U' 'A' 'M' 'M' 'U' 'M' 'M' 'U' 'U' 'U' 'M' 'A' 'M' 'M'
 'M' 'M' 'A' 'M' 'U' 'A' 'U' 'U' 'U' 'M' 'M' 'U' 'A' 'A' 'A' 'M' 'M' 'A']"
5701,3,130,47,83,68,0,0,"['A' 'M' 'M' 'M' 'U' 'U' 'A' 'A' 'U' 'M' 'U' 'U' 'U' 'U' 'M' 'A' 'A' 'U'
 'U' 'U' 'M' 'A' 'A' 'U' 'U' 'M' 'U' 'M' 'M' 'M' 'M' 'U' 'U' 'A' 'U' 'M'
 'M' 'M' 'M' 'M' 'U' 'A' 'U' 'A' 'M' 'U' 'M' 'M' 'M' 'U' 'U' 'M' 'U' 'M'
 'M' 'U' 'M' 'U' 'A' 'M' 'M' 'U' 'M' 'M' 'M' 'M' 'U' 'M' 'M' 'M' 'M' 'M'
 'M' 'M' 'M' 'U' 'U' 'A' 'A' 'U' 'A' 'M' 'M' 'A' 'U' 'M' 'A' 'U' 'A' 'U'
 'M' 'U' 'M' 'U' 'U' 'A' 'U' 'M' 'U' 'M' 'U' 'M' 'M' 'M' 'A' 'U' 'M' 'M'
 'A' 'A' 'A' 'A' 'U' 'A' 'M' 'U' 'M' 'A' 'A' 'U' 'M' 'U' 'A' 'M' 'M' 'M'
 'M' 'U' 'U' 'U' 'M' 'A' 'A' 'A' 'A' 'A' 'A' 'A' 'A' 'U' 'M' 'M' 'M' 'U'
 'M' 'A' 'A' 'U' 'M' 'U' 'A' 'U' 'U' 'M' 'M' 'U' 'A' 'M' 'M' 'M' 'A' 'U'
 'A' 'M' 'U' 'U' 'M' 'A' 'M' 'M' 'U' 'M' 'M' 'U' 'U' 'A' 'M' 'U' 'M' 'M'
 'M' 'U' 'U' 'M' 'M' 'A' 'U' 'U' 'U' 'M' 'M' 'U' 'U' 'A' 'A' 'M' 'U' 'A']"
5801,0,125,45,80,73,0,1,"['A' 'M' 'M' 'M' 'U' 'A' 'U' 'U' 'U' 'U' 'U' 'A' 'U' 'A' 'M' 'A' 'U' 'U'
 'U' 'U' 'M' 'U' 'A' 'M' 'U' 'M' 'U' 'M' 'M' 'M' 'M' 'U' 'U' 'U' 'U' 'M'
 'M' 'M' 'M' 'M' 'U' 'A' 'U' 'A' 'M' 'U' 'M' 'U' 'M' 'M' 'U' 'M' 'U' 'U'
 'U' 'M' 'M' 'U' 'U' 'M' 'M' 'U' 'M' 'M' 'M' 'M' 'U' 'M' 'M' 'M' 'M' 'M'
 'M' 'M' 'M' 'A' 'M' 'A' 'U' 'U' 'A' 'M' 'M' 'A' 'A' 'M' 'A' 'U' 'A' 'A'
 'M' 'U' 'M' 'M' 'U' 'A' 'U' 'M' 'U' 'M' 'M' 'M' 'U' 'U' 'A' 'U' 'M' 'U'
 'A' 'A' 'A' 'A' 'A' 'U' 'M' 'U' 'U' 'A' 'A' 'U' 'M' 'U' 'A' 'M' 'U' 'M'
 'M' 'U' 'U' 'U' 'M' 'A' 'A' 'A' 'A' 'A' 'A' 'A' 'A' 'U' 'M' 'M' 'M' 'U'
 'M' 'A' 'U' 'U' 'M' 'A' 'A' 'M' 'A' 'M' 'M' 'U' 'A' 'M' 'M' 'M' 'A' 'A'
 'U' 'M' 'U' 'U' 'M' 'A' 'M' 'M' 'M' 'M' 'M' 'U' 'U' 'A' 'M' 'U' 'M' 'U'
 'M' 'U' 'U' 'U' 'M' 'A' 'U' 'U' 'U' 'M' 'M' 'U' 'U' 'U' 'U' 'M' 'U' 'A']"
5901,0,130,41,89,68,0,1,"['A' 'M' 'M' 'U' 'M' 'A' 'U' 'U' 'U' 'M' 'U' 'A' 'A' 'A' 'M' 'A' 'U' 'U'
 'U' 'M' 'M' 'M' 'U' 'M' 'U' 'M' 'U' 'M' 'M' 'M' 'M' 'U' 'A' 'U' 'U' 'M'
 'M' 'M' 'M' 'M' 'U' 'A' 'M' 'A' 'M' 'M' 'M' 'M' 'U' 'M' 'U' 'M' 'U' 'U'
 'A' 'M' 'M' 'M' 'U' 'M' 'M' 'U' 'M' 'M' 'M' 'M' 'M' 'M' 'M' 'M' 'M' 'M'
 'U' 'M' 'M' 'A' 'M' 'U' 'M' 'M' 'A' 'M' 'M' 'A' 'U' 'M' 'A' 'U' 'A' 'A'
 'U' 'M' 'M' 'M' 'A' 'U' 'U' 'M' 'U' 'M' 'M' 'M' 'U' 'U' 'U' 'M' 'M' 'U'
 'U' 'A' 'U' 'U' 'A' 'U' 'M' 'U' 'M' 'A' 'A' 'A' 'M' 'U' 'U' 'M' 'U' 'M'
 'M' 'U' 'U' 'U' 'M' 'A' 'A' 'A' 'A' 'A' 'A' 'A' 'A' 'U' 'M' 'M' 'U' 'U'
 'U' 'M' 'U' 'M' 'M' 'A' 'A' 'M' 'A' 'U' 'M' 'A' 'U' 'M' 'U' 'M' 'U' 'A'
 'U' 'U' 'U' 'A' 'M' 'U' 'M' 'U' 'M' 'M' 'M' 'U' 'U' 'A' 'M' 'M' 'M' 'A'
 'M' 'U' 'U' 'U' 'M' 'A' 'M' 'M' 'U' 'M' 'M' 'M' 'U' 'A' 'U' 'U' 'U' 'A']"
6001,1,129,46,83,69,0,0,"['A' 'M' 'M' 'M' 'M' 'A' 'U' 'U' 'U' 'M' 'U' 'A' 'A' 'A' 'M' 'A' 'M' 'U'
 'U' 'M' 'M' 'U' 'U' 'U' 'U' 'M' 'U' 'U' 'M' 'M' 'M' 'U' 'U' 'U' 'A' 'U'
 'M' 'U' 'M' 'M' 'U' 'A' 'M' 'A' 'M' 'M' 'M' 'A' 'U' 'U' 'U' 'U' 'U' 'U'
 'A' 'M' 'M' 'U' 'U' 'U' 'U' 'U' 'M' 'M' 'M' 'U' 'M' 'M' 'M' 'M' 'M' 'M'
 'M' 'M' 'M' 'A' 'M' 'U' 'M' 'M' 'U' 'M' 'M' 'A' 'A' 'M' 'A' 'M' 'A' 'A'
 'U' 'M' 'M' 'M' 'A' 'A' 'U' 'M' 'U' 'U' 'U' 'M' 'U' 'U' 'M' 'M' 'M' 'U'
 'U' 'U' 'M' 'U' 'A' 'U' 'M' 'U' 'M' 'A' 'A' 'A' 'U' 'U' 'A' 'M' 'U' 'M'
 'M' 'A' 'M' 'U' 'M' 'U' 'A' 'A' 'A' 'U' 'A' 'A' 'A' 'U' 'M' 'M' 'M' 'A'
 'U' 'M' 'M' 'U' 'M' 'A' 'A' 'M' 'A' 'U' 'M' 'A' 'A' 'M' 'U' 'M' 'M' 'A'
 'U' 'U' 'A' 'A' 'M' 'M' 'U' 'U' 'A' 'M' 'M' 'U' 'M' 'U' 'M' 'U' 'M' 'A'
 'M' 'U' 'U' 'U' 'M' 'A' 'M' 'M' 'A' 'M' 'M' 'M' 'M' 'A' 'U' 'U' 'U' 'A']"
6101,2,133,42,91,65,0,1,"['A' 'M' 'M' 'M' 'M' 'A' 'M' 'M' 'U' 'M' 'M' 'M' 'A' 'U' 'M' 'A' 'M' 'U'
 'U' 'M' 'M' 'U' 'U' 'U' 'U' 'A' 'U' 'U' 'M' 'M' 'U' 'U' 'A' 'U' 'A' 'U'
 'U' 'M' 'M' 'M' 'A' 'A' 'M' 'A' 'M' 'M' 'M' 'U' 'M' 'U' 'U' 'U' 'U' 'U'
 'A' 'M' 'M' 'U' 'A' 'U' 'U' 'U' 'M' 'M' 'M' 'M' 'U' 'M' 'M' 'M' 'M' 'M'
 'M' 'M' 'M' 'U' 'U' 'U' 'M' 'M' 'U' 'M' 'M' 'A' 'A' 'M' 'A' 'M' 'A' 'U'
 'M' 'M' 'M' 'M' 'A' 'A' 'A' 'M' 'M' 'U' 'U' 'U' 'U' 'U' 'M' 'M' 'M' 'U'
 'M' 'M' 'M' 'U' 'U' 'U' 'M' 'U' 'M' 'A' 'U' 'U' 'M' 'U' 'A' 'M' 'U' 'M'
 'M' 'A' 'M' 'U' 'M' 'U' 'A' 'A' 'A' 'A' 'A' 'A' 'U' 'M' 'M' 'U' 'M' 'A'
 'U' 'M' 'M' 'U' 'M' 'A' 'A' 'U' 'M' 'U' 'M' 'A' 'U' 'M' 'U' 'M' 'U' 'A'
 'A' 'U' 'A' 'A' 'M' 'M' 'M' 'U' 'A' 'U' 'M' 'M' 'M' 'A' 'U' 'A' 'U' 'U'
 'M' 'U' 'U' 'U' 'M' 'A' 'M' 'M' 'M' 'M' 'M' 'M' 'M' 'A' 'M' 'M' 'M' 'A']"
6201,1,132,42,90,66,0,0,"['A' 'M' 'M' 'M' 'M' 'A' 'U' 'M' 'A' 'M' 'M' 'M' 'U' 'U' 'M' 'U' 'M' 'U'
 'M' 'M' 'M' 'U' 'U' 'U' 'U' 'A' 'M' 'U' 'M' 'M' 'U' 'A' 'A' 'U' 'A' 'U'
 'M' 'M' 'M' 'M' 'A' 'A' 'M' 'A' 'U' 'M' 'M' 'U' 'M' 'U' 'U' 'M' 'A' 'U'
 'A' 'U' 'M' 'A' 'U' 'U' 'A' 'U' 'M' 'U' 'M' 'M' 'U' 'M' 'M' 'M' 'M' 'M'
 'M' 'M' 'M' 'U' 'M' 'U' 'M' 'M' 'U' 'M' 'U' 'A' 'U' 'M' 'A' 'M' 'A' 'M'
 'M' 'U' 'M' 'M' 'A' 'M' 'U' 'M' 'M' 'U' 'M' 'A' 'U' 'U' 'M' 'M' 'M' 'U'
 'M' 'M' 'M' 'U' 'U' 'U' 'M' 'U' 'U' 'U' 'M' 'U' 'M' 'A' 'M' 'M' 'U' 'M'
 'U' 'A' 'M' 'U' 'M' 'A' 'A' 'A' 'A' 'A' 'A' 'A' 'A' 'M' 'M' 'U' 'U' 'A'
 'A' 'M' 'M' 'U' 'M' 'A' 'U' 'U' 'M' 'U' 'M' 'U' 'U' 'M' 'A' 'U' 'U' 'U'
 'A' 'A' 'A' 'A' 'M' 'M' 'M' 'U' 'A' 'U' 'M' 'M' 'M' 'A' 'M' 'A' 'U' 'U'
 'U' 'U' 'M' 'U' 'M' 'A' 'M' 'M' 'M' 'M' 'M' 'U' 'M' 'A' 'M' 'U' 'M' 'U']"
6301,2,128,39,89,70,0,1,"['A' 'M' 'M' 'M' 'M' 'U' 'U' 'M' 'A' 'M' 'U' 'U' 'U' 'U' 'M' 'M' 'M' 'U'
 'M' 'M' 'M' 'U' 'U' 'U' 'U' 'A' 'M' 'U' 'U' 'M' 'U' 'U' 'U' 'U' 'A' 'U'
 'M' 'M' 'M' 'M' 'A' 'A' 'M' 'M' 'U' 'M' 'U' 'M' 'M' 'U' 'U' 'M' 'A' 'U'
 'A' 'M' 'A' 'A' 'U' 'U' 'A' 'M' 'M' 'U' 'M' 'M' 'M' 'M' 'M' 'U' 'M' 'M'
 'M' 'M' 'M' 'M' 'U' 'U' 'M' 'M' 'U' 'M' 'U' 'A' 'U' 'M' 'A' 'M' 'A' 'M'
 'U' 'U' 'U' 'M' 'A' 'M' 'U' 'M' 'M' 'U' 'M' 'A' 'M' 'M' 'M' 'M' 'M' 'U'
 'U' 'M' 'M' 'U' 'U' 'A' 'M' 'M' 'U' 'U' 'M' 'U' 'M' 'A' 'M' 'M' 'A' 'M'
 'U' 'U' 'M' 'U' 'M' 'A' 'A' 'A' 'A' 'A' 'A' 'A' 'A' 'M' 'M' 'U' 'U' 'A'
 'A' 'M' 'M' 'M' 'M' 'A' 'U' 'U' 'M' 'U' 'U' 'U' 'A' 'M' 'A' 'U' 'U' 'U'
 'M' 'A' 'U' 'M' 'U' 'M' 'M' 'U' 'U' 'M' 'M' 'M' 'U' 'A' 'U' 'A' 'A' 'U'
 'A' 'M' 'M' 'U' 'M' 'A' 'M' 'M' 'U' 'M' 'M' 'U' 'A' 'U' 'M' 'M' 'U' 'U']"
6401,1,130,39,91,68,0,1,"['A' 'M' 'U' 'M' 'M' 'U' 'U' 'M' 'M' 'M' 'U' 'U' 'U' 'M' 'U' 'M' 'M' 'U'
 'U' 'M' 'M' 'U' 'U' 'U' 'M' 'A' 'M' 'U' 'A' 'M' 'U' 'U' 'M' 'U' 'A' 'U'
 'M' 'M' 'M' 'M' 'A' 'A' 'M' 'U' 'U' 'M' 'M' 'U' 'M' 'U' 'U' 'U' 'A' 'A'
 'A' 'M' 'U' 'A' 'U' 'U' 'A' 'M' 'M' 'M' 'M' 'M' 'M' 'M' 'M' 'U' 'M' 'M'
 'M' 'M' 'M' 'M' 'U' 'M' 'M' 'M' 'U' 'M' 'M' 'A' 'U' 'U' 'A' 'M' 'A' 'M'
 'A' 'U' 'M' 'M' 'A' 'M' 'A' 'M' 'M' 'U' 'M' 'A' 'M' 'U' 'M' 'M' 'M' 'U'
 'U' 'M' 'M' 'A' 'U' 'A' 'M' 'M' 'U' 'U' 'U' 'M' 'M' 'A' 'M' 'M' 'U' 'M'
 'U' 'U' 'M' 'A' 'M' 'A' 'A' 'A' 'A' 'A' 'A' 'A' 'A' 'M' 'M' 'U' 'M' 'A'
 'U' 'M' 'M' 'M' 'M' 'A' 'U' 'U' 'U' 'U' 'M' 'U' 'A' 'M' 'U' 'A' 'U' 'U'
 'M' 'U' 'U' 'M' 'U' 'M' 'M' 'U' 'U' 'M' 'U' 'M' 'U' 'A' 'M' 'A' 'A' 'U'
 'A' 'M' 'M' 'U' 'U' 'U' 'M' 'M' 'U' 'M' 'M' 'M' 'M' 'U' 'M' 'U' 'U' 'A']"
6501,0,137,45,92,61,1,0,"['A' 'M' 'M' 'M' 'U' 'M' 'U' 'M' 'M' 'M' 'U' 'U' 'U' 'M' 'U' 'M' 'U' 'U'
 'U' 'M' 'M' 'U' 'U' 'U' 'M' 'A' 'M' 'A' 'A' 'M' 'A' 'A' 'M' 'U' 'A' 'U'
 'M' 'A' 'U' 'M' 'A' 'A' 'U' 'M' 'U' 'U' 'M' 'M' 'M' 'U' 'U' 'U' 'A' 'U'
 'A' 'M' 'U' 'A' 'U' 'U' 'A' 'M' 'M' 'M' 'M' 'M' 'M' 'M' 'M' 'M' 'M' 'M'
 'M' 'U' 'M' 'M' 'M' 'M' 'M' 'M' 'U' 'M' 'M' 'A' 'A' 'M' 'A' 'U' 'A' 'M'
 'A' 'M' 'U' 'M' 'A' 'M' 'U' 'M' 'M' 'U' 'M' 'A' 'M' 'A' 'M' 'M' 'M' 'U'
 'U' 'M' 'M' 'A' 'A' 'A' 'M' 'M' 'U' 'U' 'U' 'M' 'M' 'U' 'M' 'M' 'U' 'M'
 'U' 'U' 'M' 'A' 'U' 'A' 'A' 'A' 'A' 'A' 'A' 'A' 'A' 'M' 'M' 'M' 'M' 'A'
 'U' 'M' 'M' 'M' 'U' 'A' 'U' 'M' 'U' 'M' 'M' 'U' 'U' 'M' 'U' 'A' 'M' 'M'
 'M' 'U' 'U' 'M' 'A' 'U' 'M' 'U' 'U' 'U' 'U' 'M' 'A' 'A' 'M' 'A' 'U' 'M'
 'A' 'M' 'M' 'U' 'A' 'U' 'M' 'U' 'M' 'M' 'M' 'U' 'M' 'M' 'M' 'U' 'A' 'A']"
6601,3,139,48,91,59,0,0,"['A' 'M' 'M' 'M' 'U' 'M' 'A' 'M' 'M' 'M' 'U' 'A' 'U' 'M' 'U' 'M' 'U' 'U'
 'U' 'M' 'U' 'U' 'U' 'M' 'M' 'A' 'U' 'A' 'A' 'M' 'A' 'A' 'M' 'U' 'A' 'U'
 'M' 'A' 'M' 'M' 'A' 'U' 'A' 'M' 'U' 'U' 'M' 'A' 'M' 'M' 'U' 'U' 'A' 'U'
 'M' 'M' 'U' 'A' 'M' 'M' 'A' 'M' 'M' 'U' 'U' 'M' 'M' 'M' 'U' 'M' 'M' 'M'
 'M' 'M' 'M' 'M' 'M' 'M' 'U' 'U' 'U' 'M' 'M' 'A' 'A' 'M' 'A' 'U' 'A' 'M'
 'U' 'U' 'M' 'M' 'A' 'M' 'M' 'M' 'M' 'M' 'M' 'A' 'M' 'A' 'M' 'M' 'M' 'U'
 'U' 'M' 'M' 'A' 'A' 'A' 'U' 'M' 'M' 'U' 'A' 'M' 'M' 'A' 'M' 'M' 'U' 'U'
 'U' 'M' 'M' 'A' 'U' 'A' 'A' 'A' 'A' 'A' 'A' 'U' 'A' 'M' 'M' 'M' 'A' 'A'
 'U' 'U' 'M' 'M' 'U' 'U' 'A' 'M' 'A' 'M' 'M' 'U' 'U' 'M' 'U' 'U' 'M' 'U'
 'M' 'M' 'A' 'M' 'U' 'U' 'U' 'U' 'U' 'U' 'U' 'M' 'A' 'A' 'M' 'A' 'U' 'M'
 'A' 'U' 'M' 'M' 'A' 'U' 'M' 'U' 'M' 'M' 'M' 'U' 'M' 'M' 'M' 'M' 'A' 'A']"
6701,2,134,44,90,64,0,0,"['A' 'M' 'U' 'M' 'U' 'M' 'A' 'M' 'U' 'M' 'U' 'A' 'U' 'M' 'U' 'M' 'A' 'U'
 'U' 'M' 'U' 'U' 'U' 'M' 'M' 'A' 'A' 'A' 'A' 'M' 'U' 'A' 'M' 'U' 'A' 'U'
 'M' 'U' 'M' 'M' 'A' 'U' 'A' 'M' 'U' 'A' 'M' 'A' 'U' 'M' 'U' 'U' 'U' 'A'
 'M' 'M' 'M' 'U' 'U' 'M' 'A' 'M' 'M' 'M' 'M' 'M' 'M' 'M' 'M' 'M' 'M' 'M'
 'U' 'M' 'M' 'M' 'M' 'M' 'U' 'M' 'U' 'M' 'M' 'U' 'A' 'M' 'A' 'U' 'A' 'U'
 'M' 'M' 'M' 'M' 'U' 'M' 'M' 'M' 'M' 'M' 'M' 'U' 'U' 'U' 'M' 'M' 'M' 'U'
 'U' 'M' 'M' 'A' 'U' 'A' 'U' 'M' 'M' 'U' 'A' 'M' 'M' 'A' 'M' 'U' 'U' 'U'
 'U' 'M' 'M' 'U' 'U' 'A' 'A' 'A' 'A' 'A' 'A' 'A' 'A' 'M' 'U' 'M' 'A' 'A'
 'U' 'U' 'M' 'M' 'U' 'U' 'A' 'M' 'A' 'U' 'M' 'M' 'M' 'M' 'M' 'U' 'M' 'U'
 'M' 'M' 'M' 'M' 'U' 'U' 'U' 'A' 'U' 'U' 'U' 'M' 'A' 'A' 'M' 'A' 'M' 'M'
 'A' 'U' 'M' 'U' 'M' 'U' 'A' 'A' 'U' 'M' 'M' 'U' 'M' 'M' 'U' 'M' 'A' 'A']"
6801,2,130,45,85,68,0,0,"['A' 'M' 'U' 'M' 'U' 'M' 'A' 'M' 'A' 'M' 'A' 'U' 'U' 'M' 'M' 'M' 'A' 'M'
 'U' 'M' 'U' 'U' 'U' 'U' 'M' 'A' 'A' 'M' 'A' 'U' 'U' 'A' 'M' 'M' 'A' 'U'
 'M' 'U' 'M' 'M' 'A' 'U' 'A' 'U' 'U' 'U' 'M' 'A' 'U' 'M' 'U' 'U' 'U' 'A'
 'M' 'M' 'U' 'M' 'U' 'U' 'A' 'A' 'U' 'M' 'U' 'U' 'M' 'M' 'M' 'M' 'M' 'M'
 'M' 'M' 'M' 'M' 'M' 'U' 'U' 'M' 'A' 'M' 'M' 'U' 'A' 'M' 'M' 'U' 'A' 'U'
 'M' 'M' 'M' 'M' 'U' 'M' 'M' 'U' 'M' 'M' 'M' 'U' 'U' 'U' 'M' 'M' 'M' 'M'
 'U' 'M' 'M' 'A' 'M' 'U' 'U' 'M' 'M' 'U' 'A' 'M' 'M' 'A' 'M' 'M' 'U' 'U'
 'U' 'M' 'M' 'U' 'A' 'A' 'A' 'A' 'A' 'A' 'A' 'A' 'A' 'U' 'U' 'M' 'A' 'A'
 'U' 'U' 'U' 'M' 'U' 'U' 'A' 'U' 'A' 'U' 'M' 'M' 'M' 'M' 'U' 'U' 'M' 'U'
 'M' 'U' 'M' 'M' 'U' 'A' 'U' 'U' 'U' 'M' 'A' 'M' 'A' 'A' 'M' 'A' 'M' 'M'
 'A' 'U' 'M' 'U' 'M' 'U' 'A' 'U' 'A' 'M' 'M' 'U' 'M' 'M' 'U' 'M' 'A' 'A']"
6901,3,123,43,80,75,0,0,"['A' 'M' 'U' 'M' 'U' 'M' 'A' 'M' 'A' 'M' 'U' 'U' 'U' 'M' 'M' 'U' 'U' 'M'
 'U' 'U' 'U' 'M' 'U' 'U' 'M' 'A' 'U' 'U' 'A' 'A' 'U' 'U' 'M' 'M' 'A' 'U'
 'M' 'M' 'M' 'U' 'A' 'U' 'M' 'U' 'U' 'U' 'U' 'U' 'U' 'M' 'U' 'U' 'M' 'A'
 'M' 'M' 'M' 'M' 'A' 'U' 'A' 'A' 'U' 'M' 'U' 'M' 'M' 'M' 'M' 'M' 'U' 'M'
 'M' 'M' 'M' 'U' 'M' 'U' 'U' 'M' 'A' 'M' 'M' 'U' 'A' 'M' 'M' 'A' 'A' 'U'
 'M' 'M' 'U' 'U' 'U' 'U' 'M' 'U' 'M' 'M' 'M' 'U' 'U' 'A' 'M' 'M' 'M' 'M'
 'U' 'M' 'M' 'A' 'M' 'U' 'A' 'M' 'M' 'U' 'A' 'M' 'U' 'A' 'M' 'M' 'U' 'U'
 'U' 'U' 'M' 'U' 'A' 'A' 'A' 'A' 'A' 'A' 'A' 'A' 'A' 'M' 'U' 'M' 'U' 'U'
 'U' 'U' 'U' 'M' 'U' 'U' 'A' 'U' 'A' 'U' 'M' 'U' 'M' 'M' 'U' 'U' 'M' 'U'
 'M' 'U' 'U' 'M' 'A' 'A' 'M' 'U' 'U' 'M' 'A' 'M' 'A' 'A' 'U' 'A' 'M' 'U'
 'A' 'U' 'M' 'A' 'M' 'M' 'U' 'M' 'A' 'M' 'M' 'A' 'M' 'M' 'M' 'M' 'A' 'U']"
7001,1,130,48,82,68,0,0,"['A' 'M' 'U' 'M' 'U' 'U' 'A' 'U' 'A' 'M' 'M' 'U' 'U' 'U' 'M' 'A' 'U' 'M'
 'U' 'U' 'M' 'M' 'M' 'A' 'M' 'A' 'U' 'U' 'U' 'A' 'A' 'U' 'U' 'M' 'A' 'M'
 'A' 'M' 'M' 'U' 'A' 'U' 'M' 'U' 'U' 'M' 'U' 'U' 'M' 'U' 'U' 'U' 'M' 'A'
 'M' 'U' 'U' 'M' 'A' 'A' 'U' 'A' 'U' 'M' 'U' 'M' 'M' 'U' 'M' 'M' 'M' 'M'
 'M' 'M' 'M' 'M' 'U' 'U' 'A' 'M' 'A' 'M' 'M' 'U' 'M' 'M' 'M' 'A' 'A' 'M'
 'M' 'U' 'M' 'U' 'M' 'U' 'M' 'U' 'A' 'U' 'U' 'A' 'U' 'A' 'M' 'U' 'M' 'M'
 'U' 'M' 'M' 'A' 'M' 'U' 'A' 'M' 'U' 'M' 'U' 'M' 'U' 'A' 'M' 'M' 'U' 'U'
 'A' 'M' 'M' 'M' 'A' 'A' 'A' 'A' 'A' 'A' 'A' 'A' 'A' 'M' 'U' 'M' 'U' 'A'
 'M' 'U' 'M' 'M' 'U' 'U' 'A' 'U' 'A' 'U' 'U' 'M' 'M' 'M' 'U' 'U' 'M' 'U'
 'U' 'U' 'U' 'M' 'A' 'A' 'M' 'U' 'U' 'M' 'A' 'M' 'A' 'U' 'M' 'A' 'M' 'M'
 'A' 'M' 'M' 'A' 'M' 'M' 'M' 'M' 'A' 'M' 'M' 'A' 'M' 'U' 'M' 'U' 'A' 'U']"
7101,0,132,45,87,66,1,0,"['A' 'M' 'U' 'M' 'A' 'U' 'A' 'U' 'A' 'M' 'M' 'U' 'U' 'U' 'M' 'A' 'U' 'M'
 'U' 'U' 'M' 'M' 'M' 'A' 'M' 'A' 'U' 'U' 'U' 'A' 'A' 'M' 'A' 'M' 'A' 'M'
 'U' 'U' 'M' 'U' 'A' 'U' 'M' 'U' 'U' 'M' 'M' 'A' 'M' 'U' 'U' 'U' 'M' 'A'
 'M' 'U' 'M' 'M' 'A' 'A' 'U' 'A' 'M' 'M' 'U' 'M' 'U' 'M' 'M' 'M' 'M' 'M'
 'M' 'M' 'M' 'M' 'U' 'U' 'M' 'U' 'A' 'M' 'M' 'U' 'M' 'U' 'M' 'A' 'A' 'M'
 'M' 'U' 'M' 'U' 'M' 'M' 'M' 'M' 'A' 'U' 'U' 'U' 'M' 'A' 'M' 'U' 'M' 'M'
 'U' 'M' 'M' 'A' 'M' 'U' 'A' 'M' 'U' 'M' 'U' 'U' 'U' 'A' 'M' 'U' 'U' 'U'
 'A' 'M' 'M' 'M' 'U' 'U' 'A' 'A' 'A' 'A' 'A' 'A' 'A' 'M' 'M' 'M' 'U' 'A'
 'M' 'U' 'M' 'M' 'M' 'M' 'A' 'A' 'A' 'U' 'U' 'M' 'U' 'M' 'M' 'U' 'M' 'U'
 'U' 'U' 'U' 'U' 'U' 'A' 'M' 'U' 'U' 'M' 'A' 'M' 'A' 'A' 'M' 'U' 'M' 'M'
 'A' 'M' 'M' 'A' 'M' 'M' 'M' 'M' 'A' 'M' 'U' 'U' 'M' 'U' 'M' 'M' 'A' 'U']"
7201,2,127,40,87,71,0,0,"['A' 'U' 'U' 'M' 'A' 'A' 'M' 'U' 'U' 'M' 'M' 'U' 'M' 'A' 'M' 'A' 'U' 'M'
 'M' 'M' 'M' 'M' 'M' 'A' 'M' 'U' 'U' 'U' 'U' 'A' 'U' 'M' 'U' 'M' 'U' 'U'
 'U' 'U' 'U' 'U' 'U' 'U' 'M' 'U' 'U' 'U' 'U' 'A' 'M' 'U' 'U' 'U' 'M' 'A'
 'M' 'U' 'M' 'M' 'A' 'M' 'U' 'A' 'M' 'M' 'U' 'M' 'M' 'M' 'M' 'M' 'M' 'M'
 'M' 'M' 'U' 'M' 'U' 'M' 'M' 'U' 'A' 'M' 'U' 'U' 'M' 'U' 'M' 'M' 'A' 'M'
 'M' 'U' 'M' 'U' 'M' 'M' 'M' 'M' 'U' 'M' 'M' 'A' 'M' 'A' 'M' 'U' 'M' 'M'
 'U' 'M' 'M' 'A' 'M' 'U' 'U' 'M' 'U' 'M' 'U' 'U' 'M' 'A' 'M' 'M' 'A' 'U'
 'A' 'M' 'A' 'M' 'U' 'A' 'A' 'A' 'A' 'A' 'A' 'A' 'A' 'U' 'M' 'M' 'U' 'A'
 'M' 'U' 'M' 'M' 'M' 'M' 'A' 'A' 'A' 'U' 'M' 'M' 'U' 'U' 'M' 'U' 'U' 'U'
 'U' 'U' 'U' 'U' 'A' 'U' 'M' 'U' 'U' 'U' 'A' 'M' 'U' 'A' 'M' 'M' 'M' 'M'
 'A' 'M' 'M' 'A' 'M' 'M' 'M' 'U' 'A' 'U' 'A' 'U' 'M' 'U' 'M' 'M' 'A' 'U']"
7301,1,130,39,91,68,0,0,"['A' 'U' 'U' 'M' 'U' 'A' 'M' 'A' 'U' 'M' 'M' 'U' 'M' 'A' 'M' 'A' 'M' 'M'
 'M' 'M' 'M' 'M' 'M' 'A' 'M' 'U' 'U' 'U' 'U' 'U' 'A' 'M' 'U' 'M' 'U' 'M'
 'M' 'U' 'U' 'U' 'U' 'U' 'M' 'M' 'U' 'M' 'M' 'U' 'M' 'U' 'U' 'U' 'M' 'A'
 'M' 'U' 'M' 'M' 'A' 'M' 'A' 'U' 'U' 'M' 'U' 'M' 'M' 'M' 'U' 'M' 'M' 'M'
 'M' 'M' 'M' 'M' 'U' 'M' 'M' 'U' 'U' 'M' 'A' 'U' 'M' 'U' 'M' 'M' 'A' 'M'
 'M' 'U' 'M' 'A' 'M' 'U' 'M' 'M' 'M' 'M' 'M' 'A' 'M' 'A' 'M' 'U' 'M' 'M'
 'U' 'M' 'A' 'A' 'M' 'U' 'U' 'M' 'U' 'M' 'M' 'U' 'M' 'A' 'M' 'M' 'A' 'U'
 'U' 'M' 'U' 'M' 'U' 'A' 'A' 'A' 'A' 'A' 'A' 'A' 'A' 'M' 'M' 'U' 'U' 'A'
 'U' 'U' 'M' 'U' 'M' 'M' 'U' 'A' 'A' 'U' 'M' 'M' 'M' 'U' 'M' 'U' 'M' 'U'
 'U' 'M' 'U' 'A' 'U' 'U' 'M' 'U' 'U' 'U' 'A' 'M' 'U' 'A' 'M' 'M' 'M' 'A'
 'A' 'M' 'M' 'A' 'M' 'M' 'U' 'U' 'A' 'U' 'A' 'U' 'M' 'U' 'M' 'M' 'A' 'U']"
7401,2,127,36,91,71,1,0,"['A' 'U' 'U' 'M' 'M' 'A' 'U' 'A' 'U' 'M' 'M' 'U' 'M' 'A' 'M' 'A' 'M' 'M'
 'M' 'M' 'U' 'M' 'M' 'U' 'U' 'M' 'M' 'M' 'M' 'U' 'A' 'M' 'U' 'M' 'U' 'M'
 'M' 'M' 'M' 'U' 'U' 'U' 'U' 'M' 'M' 'U' 'M' 'U' 'M' 'U' 'U' 'U' 'M' 'A'
 'M' 'U' 'M' 'M' 'U' 'M' 'A' 'U' 'U' 'M' 'U' 'M' 'M' 'M' 'M' 'M' 'M' 'U'
 'M' 'M' 'M' 'M' 'U' 'A' 'M' 'M' 'M' 'M' 'A' 'U' 'M' 'M' 'M' 'U' 'U' 'U'
 'M' 'A' 'M' 'A' 'M' 'U' 'M' 'M' 'M' 'M' 'M' 'A' 'M' 'A' 'M' 'U' 'U' 'M'
 'U' 'M' 'A' 'A' 'M' 'U' 'U' 'M' 'U' 'M' 'M' 'U' 'M' 'A' 'U' 'M' 'U' 'U'
 'U' 'M' 'U' 'M' 'U' 'A' 'A' 'A' 'A' 'A' 'A' 'A' 'U' 'M' 'M' 'U' 'U' 'A'
 'A' 'U' 'M' 'U' 'M' 'M' 'U' 'A' 'A' 'U' 'M' 'M' 'M' 'U' 'M' 'U' 'M' 'U'
 'U' 'M' 'U' 'A' 'M' 'A' 'M' 'M' 'U' 'U' 'U' 'U' 'U' 'A' 'M' 'M' 'U' 'A'
 'A' 'U' 'M' 'A' 'M' 'M' 'U' 'U' 'A' 'U' 'U' 'U' 'M' 'U' 'M' 'M' 'U' 'A']"
7501,1,121,41,80,77,0,1,"['A' 'U' 'U' 'M' 'M' 'A' 'U' 'U' 'U' 'M' 'U' 'U' 'M' 'A' 'M' 'A' 'U' 'M'
 'U' 'M' 'U' 'M' 'M' 'U' 'U' 'M' 'U' 'M' 'M' 'U' 'A' 'M' 'U' 'U' 'M' 'M'
 'M' 'M' 'M' 'U' 'A' 'U' 'U' 'U' 'M' 'M' 'M' 'U' 'M' 'U' 'U' 'U' 'U' 'A'
 'M' 'U' 'A' 'M' 'U' 'U' 'U' 'M' 'U' 'U' 'U' 'M' 'M' 'M' 'M' 'M' 'M' 'U'
 'M' 'M' 'M' 'M' 'U' 'U' 'M' 'M' 'M' 'U' 'A' 'A' 'M' 'M' 'M' 'U' 'U' 'U'
 'M' 'A' 'M' 'A' 'U' 'U' 'M' 'M' 'M' 'U' 'U' 'U' 'M' 'U' 'U' 'U' 'U' 'M'
 'U' 'M' 'A' 'A' 'M' 'U' 'M' 'M' 'U' 'U' 'M' 'U' 'M' 'A' 'U' 'M' 'M' 'U'
 'U' 'M' 'U' 'M' 'U' 'A' 'A' 'A' 'A' 'A' 'A' 'A' 'A' 'M' 'M' 'A' 'A' 'A'
 'A' 'A' 'M' 'U' 'M' 'M' 'U' 'A' 'A' 'M' 'U' 'M' 'U' 'U' 'M' 'U' 'M' 'U'
 'U' 'M' 'U' 'A' 'M' 'A' 'M' 'M' 'U' 'A' 'U' 'U' 'U' 'A' 'M' 'M' 'U' 'A'
 'A' 'U' 'U' 'A' 'M' 'M' 'A' 'A' 'A' 'A' 'U' 'M' 'M' 'M' 'M' 'M' 'U' 'U']"
7601,1,123,40,83,75,0,0,"['A' 'M' 'U' 'M' 'M' 'A' 'U' 'M' 'U' 'U' 'A' 'U' 'M' 'U' 'M' 'U' 'A' 'M'
 'M' 'U' 'U' 'M' 'M' 'U' 'M' 'M' 'U' 'M' 'M' 'U' 'A' 'M' 'U' 'U' 'M' 'M'
 'M' 'M' 'M' 'U' 'A' 'U' 'A' 'U' 'M' 'M' 'M' 'M' 'M' 'U' 'A' 'A' 'U' 'A'
 'U' 'U' 'A' 'M' 'U' 'U' 'A' 'M' 'U' 'U' 'U' 'U' 'M' 'M' 'M' 'M' 'M' 'M'
 'M' 'M' 'M' 'U' 'U' 'M' 'M' 'M' 'M' 'M' 'A' 'U' 'U' 'M' 'M' 'M' 'U' 'U'
 'M' 'U' 'M' 'A' 'U' 'U' 'M' 'M' 'M' 'U' 'U' 'U' 'U' 'A' 'U' 'U' 'U' 'U'
 'M' 'M' 'A' 'A' 'M' 'M' 'M' 'M' 'U' 'U' 'M' 'U' 'M' 'U' 'U' 'M' 'M' 'A'
 'M' 'U' 'U' 'M' 'M' 'A' 'A' 'A' 'A' 'A' 'A' 'A' 'A' 'M' 'M' 'A' 'A' 'A'
 'U' 'A' 'M' 'A' 'M' 'M' 'U' 'U' 'U' 'M' 'M' 'M' 'U' 'U' 'M' 'U' 'M' 'U'
 'U' 'U' 'U' 'U' 'M' 'U' 'U' 'M' 'U' 'A' 'U' 'M' 'U' 'A' 'M' 'M' 'U' 'A'
 'A' 'U' 'A' 'A' 'M' 'M' 'U' 'A' 'A' 'A' 'U' 'M' 'U' 'M' 'M' 'M' 'U' 'U']"
7701,1,121,40,81,77,1,0,"['A' 'U' 'M' 'U' 'M' 'U' 'U' 'M' 'M' 'U' 'A' 'U' 'U' 'U' 'U' 'M' 'A' 'M'
 'M' 'U' 'M' 'M' 'M' 'M' 'M' 'M' 'M' 'U' 'U' 'U' 'A' 'M' 'U' 'U' 'U' 'U'
 'U' 'M' 'M' 'U' 'A' 'M' 'A' 'U' 'M' 'M' 'M' 'M' 'U' 'U' 'U' 'A' 'U' 'A'
 'U' 'U' 'M' 'M' 'U' 'U' 'A' 'M' 'M' 'U' 'U' 'M' 'M' 'M' 'U' 'M' 'M' 'M'
 'M' 'M' 'M' 'U' 'A' 'M' 'M' 'M' 'M' 'U' 'A' 'U' 'M' 'M' 'M' 'M' 'U' 'U'
 'M' 'U' 'M' 'A' 'A' 'M' 'M' 'M' 'M' 'U' 'U' 'U' 'U' 'A' 'U' 'U' 'U' 'A'
 'M' 'M' 'A' 'A' 'U' 'M' 'M' 'M' 'U' 'U' 'M' 'M' 'M' 'U' 'U' 'M' 'M' 'A'
 'M' 'U' 'U' 'M' 'M' 'A' 'A' 'A' 'A' 'A' 'A' 'A' 'A' 'M' 'M' 'A' 'U' 'A'
 'A' 'A' 'M' 'A' 'M' 'M' 'U' 'U' 'U' 'M' 'U' 'M' 'U' 'U' 'U' 'U' 'M' 'U'
 'U' 'M' 'M' 'U' 'M' 'U' 'U' 'U' 'U' 'A' 'M' 'M' 'U' 'A' 'M' 'M' 'A' 'A'
 'A' 'U' 'A' 'U' 'U' 'M' 'A' 'A' 'A' 'U' 'U' 'U' 'M' 'M' 'U' 'M' 'U' 'U']"
7801,1,133,46,87,65,1,0,"['A' 'U' 'M' 'U' 'M' 'A' 'U' 'M' 'M' 'U' 'A' 'U' 'U' 'U' 'U' 'M' 'A' 'M'
 'U' 'M' 'M' 'U' 'M' 'M' 'U' 'M' 'M' 'A' 'U' 'U' 'A' 'M' 'U' 'U' 'U' 'U'
 'U' 'M' 'M' 'M' 'U' 'M' 'U' 'U' 'M' 'M' 'U' 'M' 'U' 'U' 'A' 'A' 'M' 'A'
 'U' 'U' 'M' 'M' 'U' 'U' 'U' 'M' 'M' 'U' 'M' 'M' 'M' 'M' 'M' 'M' 'M' 'M'
 'M' 'U' 'M' 'U' 'U' 'M' 'M' 'M' 'M' 'M' 'U' 'U' 'M' 'M' 'M' 'M' 'M' 'U'
 'A' 'A' 'M' 'A' 'A' 'M' 'M' 'M' 'M' 'U' 'U' 'U' 'A' 'A' 'A' 'U' 'M' 'U'
 'M' 'M' 'A' 'A' 'U' 'M' 'U' 'M' 'A' 'U' 'M' 'U' 'U' 'A' 'U' 'M' 'M' 'A'
 'M' 'M' 'U' 'M' 'M' 'A' 'A' 'A' 'A' 'A' 'A' 'A' 'A' 'M' 'M' 'A' 'U' 'A'
 'A' 'A' 'M' 'A' 'M' 'M' 'A' 'U' 'U' 'M' 'U' 'M' 'U' 'U' 'M' 'U' 'M' 'U'
 'U' 'M' 'M' 'A' 'M' 'M' 'A' 'U' 'A' 'U' 'M' 'M' 'U' 'A' 'M' 'M' 'U' 'A'
 'A' 'M' 'A' 'U' 'U' 'M' 'A' 'A' 'A' 'M' 'U' 'M' 'M' 'U' 'M' 'M' 'M' 'A']"
7901,0,128,40,88,70,0,0,"['A' 'U' 'M' 'U' 'M' 'U' 'U' 'M' 'M' 'U' 'A' 'M' 'M' 'U' 'U' 'M' 'A' 'M'
 'M' 'M' 'M' 'M' 'M' 'M' 'U' 'M' 'U' 'A' 'M' 'U' 'U' 'M' 'A' 'A' 'M' 'U'
 'U' 'M' 'U' 'U' 'U' 'M' 'U' 'M' 'M' 'M' 'U' 'M' 'U' 'U' 'A' 'A' 'U' 'U'
 'M' 'U' 'M' 'M' 'U' 'U' 'U' 'M' 'U' 'U' 'M' 'M' 'M' 'U' 'M' 'M' 'M' 'M'
 'M' 'M' 'M' 'A' 'U' 'U' 'M' 'A' 'M' 'M' 'U' 'U' 'M' 'M' 'M' 'M' 'M' 'U'
 'A' 'A' 'M' 'A' 'A' 'M' 'M' 'M' 'M' 'U' 'A' 'M' 'A' 'U' 'A' 'M' 'M' 'U'
 'M' 'U' 'A' 'A' 'U' 'M' 'U' 'U' 'A' 'U' 'M' 'U' 'U' 'A' 'U' 'M' 'M' 'A'
 'U' 'M' 'M' 'M' 'M' 'A' 'A' 'A' 'A' 'U' 'A' 'M' 'A' 'M' 'M' 'A' 'M' 'U'
 'U' 'A' 'M' 'A' 'M' 'U' 'A' 'U' 'A' 'M' 'U' 'U' 'U' 'U' 'M' 'M' 'M' 'U'
 'U' 'M' 'U' 'A' 'M' 'M' 'A' 'M' 'U' 'U' 'M' 'M' 'U' 'U' 'M' 'M' 'U' 'U'
 'A' 'U' 'U' 'U' 'M' 'M' 'A' 'U' 'A' 'M' 'A' 'M' 'M' 'U' 'M' 'U' 'M' 'A']"
8001,0,128,39,89,70,0,0,"['A' 'U' 'M' 'A' 'M' 'U' 'U' 'M' 'M' 'U' 'M' 'M' 'M' 'U' 'U' 'M' 'A' 'M'
 'M' 'M' 'M' 'M' 'M' 'M' 'U' 'M' 'A' 'A' 'U' 'U' 'U' 'U' 'A' 'U' 'U' 'A'
 'M' 'M' 'U' 'M' 'U' 'M' 'U' 'M' 'M' 'M' 'U' 'M' 'U' 'U' 'A' 'A' 'U' 'U'
 'M' 'U' 'M' 'U' 'U' 'U' 'U' 'U' 'M' 'A' 'M' 'M' 'U' 'M' 'M' 'M' 'M' 'M'
 'M' 'M' 'M' 'A' 'M' 'M' 'M' 'A' 'U' 'M' 'U' 'U' 'U' 'M' 'M' 'M' 'M' 'U'
 'A' 'U' 'M' 'A' 'A' 'M' 'M' 'U' 'M' 'U' 'A' 'M' 'A' 'M' 'U' 'M' 'M' 'U'
 'M' 'U' 'A' 'A' 'U' 'U' 'U' 'A' 'A' 'M' 'M' 'A' 'M' 'U' 'A' 'M' 'U' 'U'
 'U' 'M' 'M' 'M' 'M' 'A' 'A' 'A' 'A' 'M' 'U' 'U' 'A' 'M' 'M' 'A' 'M' 'M'
 'U' 'A' 'M' 'U' 'M' 'M' 'U' 'M' 'U' 'M' 'U' 'U' 'U' 'U' 'M' 'M' 'M' 'U'
 'U' 'M' 'U' 'U' 'M' 'U' 'A' 'M' 'U' 'A' 'M' 'M' 'A' 'U' 'M' 'M' 'A' 'U'
 'A' 'U' 'U' 'U' 'U' 'M' 'U' 'A' 'A' 'M' 'A' 'M' 'M' 'M' 'M' 'U' 'M' 'A']"
8101,0,125,37,88,73,1,0,"['A' 'U' 'M' 'A' 'M' 'A' 'U' 'M' 'U' 'A' 'M' 'M' 'M' 'U' 'U' 'U' 'A' 'M'
 'M' 'M' 'M' 'M' 'M' 'M' 'M' 'M' 'U' 'A' 'U' 'U' 'A' 'A' 'A' 'U' 'U' 'A'
 'U' 'U' 'U' 'U' 'U' 'M' 'M' 'M' 'M' 'M' 'U' 'M' 'U' 'U' 'U' 'A' 'U' 'U'
 'M' 'A' 'M' 'M' 'U' 'U' 'U' 'U' 'M' 'A' 'M' 'M' 'M' 'M' 'M' 'U' 'M' 'M'
 'M' 'M' 'M' 'A' 'M' 'M' 'M' 'A' 'U' 'M' 'M' 'U' 'U' 'M' 'M' 'M' 'M' 'U'
 'A' 'U' 'M' 'A' 'A' 'M' 'M' 'U' 'U' 'U' 'U' 'M' 'U' 'M' 'U' 'M' 'M' 'U'
 'M' 'U' 'A' 'U' 'U' 'U' 'U' 'A' 'A' 'M' 'M' 'U' 'M' 'M' 'A' 'M' 'U' 'U'
 'A' 'M' 'M' 'U' 'M' 'U' 'A' 'A' 'U' 'M' 'M' 'U' 'A' 'M' 'M' 'M' 'M' 'M'
 'U' 'A' 'U' 'U' 'M' 'M' 'U' 'M' 'M' 'U' 'U' 'U' 'U' 'U' 'M' 'M' 'M' 'U'
 'U' 'M' 'A' 'U' 'M' 'U' 'A' 'M' 'U' 'A' 'U' 'M' 'A' 'M' 'M' 'M' 'A' 'M'
 'U' 'U' 'U' 'M' 'U' 'M' 'U' 'A' 'A' 'M' 'U' 'M' 'M' 'M' 'U' 'A' 'A' 'A']"
8201,2,125,41,84,73,1,0,"['A' 'U' 'M' 'A' 'M' 'A' 'U' 'M' 'U' 'U' 'U' 'U' 'U' 'U' 'A' 'U' 'U' 'M'
 'M' 'M' 'M' 'M' 'M' 'M' 'M' 'U' 'U' 'A' 'M' 'M' 'A' 'U' 'A' 'U' 'U' 'A'
 'M' 'M' 'U' 'U' 'A' 'M' 'M' 'M' 'M' 'M' 'A' 'M' 'U' 'M' 'M' 'A' 'M' 'U'
 'U' 'A' 'M' 'M' 'U' 'U' 'U' 'U' 'U' 'A' 'M' 'M' 'M' 'M' 'M' 'M' 'U' 'M'
 'M' 'M' 'M' 'A' 'M' 'M' 'M' 'A' 'U' 'U' 'M' 'M' 'U' 'U' 'M' 'M' 'M' 'A'
 'A' 'A' 'M' 'A' 'A' 'M' 'U' 'U' 'M' 'U' 'U' 'M' 'U' 'A' 'U' 'M' 'M' 'U'
 'M' 'U' 'U' 'U' 'A' 'U' 'U' 'A' 'A' 'M' 'M' 'U' 'U' 'M' 'A' 'M' 'M' 'M'
 'A' 'M' 'U' 'A' 'M' 'A' 'A' 'A' 'A' 'A' 'A' 'A' 'A' 'M' 'M' 'M' 'U' 'M'
 'U' 'U' 'U' 'U' 'U' 'M' 'U' 'M' 'M' 'U' 'U' 'U' 'U' 'U' 'M' 'M' 'U' 'U'
 'U' 'U' 'U' 'M' 'M' 'U' 'A' 'M' 'M' 'A' 'U' 'M' 'A' 'U' 'U' 'M' 'U' 'M'
 'U' 'M' 'U' 'M' 'U' 'M' 'U' 'A' 'M' 'M' 'U' 'M' 'M' 'M' 'M' 'A' 'A' 'U']"
8301,1,130,38,92,68,1,0,"['A' 'U' 'M' 'A' 'M' 'U' 'M' 'M' 'U' 'A' 'U' 'M' 'U' 'U' 'A' 'U' 'U' 'M'
 'M' 'M' 'M' 'M' 'M' 'M' 'M' 'A' 'U' 'M' 'M' 'M' 'U' 'U' 'A' 'M' 'U' 'U'
 'M' 'U' 'U' 'U' 'A' 'M' 'M' 'M' 'M' 'M' 'A' 'M' 'U' 'M' 'M' 'A' 'M' 'U'
 'U' 'A' 'M' 'M' 'U' 'U' 'U' 'U' 'U' 'A' 'M' 'M' 'M' 'M' 'M' 'M' 'U' 'M'
 'M' 'M' 'M' 'A' 'M' 'M' 'M' 'A' 'U' 'U' 'U' 'M' 'U' 'A' 'M' 'M' 'M' 'A'
 'A' 'M' 'M' 'U' 'U' 'M' 'U' 'U' 'M' 'U' 'A' 'M' 'U' 'A' 'U' 'M' 'M' 'U'
 'M' 'M' 'U' 'U' 'U' 'M' 'M' 'A' 'A' 'M' 'M' 'M' 'M' 'M' 'A' 'M' 'M' 'M'
 'A' 'M' 'A' 'A' 'M' 'A' 'A' 'A' 'A' 'A' 'U' 'A' 'A' 'M' 'M' 'M' 'U' 'M'
 'U' 'U' 'M' 'U' 'U' 'M' 'U' 'M' 'M' 'U' 'U' 'M' 'U' 'A' 'U' 'U' 'U' 'U'
 'U' 'U' 'U' 'M' 'U' 'M' 'A' 'M' 'M' 'A' 'A' 'M' 'A' 'U' 'M' 'M' 'U' 'M'
 'U' 'M' 'U' 'U' 'U' 'U' 'U' 'U' 'M' 'M' 'M' 'M' 'M' 'M' 'M' 'A' 'A' 'U']"
8401,1,127,40,87,71,0,0,"['A' 'A' 'M' 'U' 'M' 'U' 'M' 'U' 'U' 'A' 'U' 'M' 'U' 'U' 'A' 'U' 'U' 'M'
 'M' 'M' 'M' 'M' 'U' 'M' 'M' 'A' 'A' 'U' 'M' 'M' 'U' 'U' 'U' 'U' 'U' 'U'
 'M' 'U' 'A' 'U' 'A' 'M' 'M' 'U' 'M' 'U' 'U' 'M' 'U' 'M' 'U' 'A' 'M' 'A'
 'U' 'A' 'M' 'U' 'M' 'U' 'M' 'U' 'U' 'A' 'M' 'U' 'M' 'M' 'M' 'M' 'M' 'M'
 'M' 'M' 'M' 'U' 'M' 'M' 'M' 'M' 'U' 'U' 'U' 'M' 'U' 'A' 'M' 'M' 'M' 'A'
 'U' 'M' 'M' 'U' 'M' 'M' 'U' 'U' 'M' 'U' 'U' 'M' 'U' 'A' 'U' 'M' 'U' 'U'
 'M' 'M' 'U' 'M' 'U' 'M' 'M' 'A' 'A' 'M' 'M' 'M' 'M' 'M' 'A' 'M' 'M' 'M'
 'U' 'M' 'A' 'A' 'M' 'A' 'A' 'A' 'A' 'A' 'A' 'A' 'A' 'M' 'M' 'M' 'M' 'M'
 'M' 'U' 'M' 'U' 'U' 'M' 'U' 'M' 'M' 'U' 'U' 'M' 'M' 'A' 'U' 'U' 'A' 'A'
 'U' 'U' 'U' 'M' 'M' 'M' 'A' 'M' 'U' 'A' 'A' 'U' 'A' 'A' 'U' 'M' 'U' 'M'
 'U' 'M' 'U' 'U' 'U' 'A' 'U' 'A' 'M' 'M' 'M' 'A' 'M' 'U' 'M' 'U' 'A' 'U']"
8501,0,134,39,95,64,0,1,"['A' 'A' 'M' 'A' 'M' 'U' 'M' 'M' 'U' 'A' 'U' 'M' 'M' 'U' 'A' 'U' 'U' 'M'
 'M' 'M' 'M' 'M' 'M' 'M' 'M' 'A' 'U' 'U' 'M' 'M' 'U' 'M' 'U' 'A' 'U' 'U'
 'M' 'U' 'A' 'U' 'U' 'M' 'M' 'U' 'M' 'U' 'U' 'M' 'A' 'M' 'U' 'A' 'M' 'A'
 'A' 'M' 'M' 'U' 'U' 'M' 'M' 'U' 'U' 'A' 'M' 'M' 'M' 'M' 'U' 'M' 'M' 'M'
 'M' 'M' 'M' 'M' 'U' 'M' 'M' 'U' 'M' 'U' 'U' 'M' 'U' 'A' 'U' 'M' 'M' 'A'
 'U' 'M' 'M' 'M' 'M' 'M' 'U' 'U' 'M' 'U' 'U' 'M' 'M' 'A' 'M' 'M' 'M' 'U'
 'M' 'M' 'U' 'U' 'U' 'M' 'M' 'A' 'A' 'M' 'M' 'M' 'M' 'M' 'A' 'M' 'U' 'M'
 'M' 'M' 'A' 'A' 'U' 'A' 'A' 'A' 'A' 'A' 'A' 'A' 'A' 'U' 'M' 'M' 'U' 'U'
 'M' 'U' 'M' 'M' 'U' 'M' 'U' 'U' 'M' 'U' 'M' 'M' 'M' 'A' 'U' 'U' 'U' 'A'
 'M' 'U' 'U' 'M' 'M' 'A' 'A' 'M' 'M' 'U' 'A' 'U' 'U' 'A' 'A' 'M' 'M' 'M'
 'U' 'M' 'U' 'U' 'U' 'A' 'M' 'A' 'M' 'U' 'M' 'U' 'M' 'M' 'M' 'U' 'A' 'M']"
8601,2,132,38,94,66,0,0,"['A' 'M' 'M' 'A' 'M' 'U' 'A' 'M' 'A' 'A' 'U' 'A' 'M' 'A' 'U' 'U' 'U' 'M'
 'U' 'U' 'U' 'M' 'M' 'M' 'M' 'U' 'M' 'U' 'M' 'M' 'U' 'M' 'U' 'U' 'M' 'M'
 'M' 'U' 'A' 'U' 'U' 'U' 'M' 'U' 'M' 'A' 'U' 'M' 'A' 'M' 'U' 'A' 'M' 'A'
 'A' 'M' 'U' 'U' 'U' 'M' 'M' 'U' 'U' 'U' 'M' 'M' 'M' 'M' 'U' 'M' 'M' 'M'
 'M' 'M' 'M' 'M' 'U' 'M' 'M' 'M' 'M' 'U' 'U' 'M' 'U' 'A' 'U' 'M' 'M' 'A'
 'U' 'M' 'M' 'M' 'M' 'U' 'A' 'U' 'M' 'U' 'M' 'M' 'M' 'A' 'M' 'M' 'U' 'M'
 'M' 'M' 'M' 'U' 'A' 'M' 'M' 'A' 'A' 'M' 'M' 'M' 'M' 'M' 'U' 'M' 'U' 'M'
 'M' 'M' 'U' 'U' 'U' 'A' 'A' 'A' 'A' 'A' 'A' 'A' 'A' 'U' 'M' 'M' 'U' 'U'
 'M' 'U' 'M' 'U' 'M' 'M' 'U' 'U' 'M' 'A' 'M' 'M' 'U' 'U' 'A' 'U' 'U' 'A'
 'M' 'U' 'U' 'M' 'M' 'A' 'A' 'M' 'M' 'U' 'A' 'M' 'U' 'U' 'A' 'M' 'M' 'M'
 'U' 'M' 'U' 'U' 'U' 'A' 'M' 'A' 'M' 'U' 'M' 'M' 'M' 'M' 'M' 'U' 'A' 'U']"
8701,1,127,35,92,71,0,1,"['A' 'M' 'M' 'A' 'M' 'M' 'A' 'M' 'A' 'A' 'U' 'A' 'M' 'U' 'U' 'M' 'U' 'M'
 'U' 'M' 'U' 'U' 'U' 'M' 'M' 'U' 'M' 'U' 'M' 'U' 'A' 'M' 'A' 'U' 'M' 'U'
 'M' 'U' 'A' 'M' 'U' 'M' 'A' 'U' 'M' 'A' 'U' 'M' 'U' 'U' 'A' 'U' 'M' 'U'
 'A' 'M' 'U' 'U' 'M' 'M' 'M' 'U' 'U' 'U' 'M' 'M' 'M' 'M' 'M' 'U' 'M' 'M'
 'M' 'M' 'M' 'M' 'U' 'U' 'M' 'M' 'M' 'U' 'U' 'M' 'U' 'A' 'M' 'M' 'M' 'U'
 'U' 'M' 'M' 'U' 'M' 'U' 'A' 'U' 'M' 'U' 'M' 'M' 'M' 'A' 'M' 'M' 'A' 'M'
 'M' 'U' 'M' 'U' 'A' 'M' 'U' 'U' 'M' 'M' 'M' 'M' 'M' 'M' 'U' 'U' 'U' 'M'
 'M' 'A' 'U' 'U' 'M' 'A' 'A' 'A' 'A' 'A' 'U' 'A' 'A' 'A' 'U' 'M' 'U' 'U'
 'M' 'U' 'M' 'U' 'M' 'M' 'U' 'U' 'M' 'A' 'M' 'M' 'U' 'M' 'A' 'M' 'M' 'M'
 'M' 'M' 'U' 'M' 'M' 'U' 'A' 'M' 'U' 'U' 'A' 'M' 'U' 'U' 'U' 'M' 'U' 'M'
 'U' 'M' 'U' 'U' 'U' 'A' 'U' 'A' 'M' 'A' 'U' 'M' 'M' 'M' 'M' 'U' 'A' 'M']"
8801,0,126,32,94,72,1,0,"['A' 'M' 'M' 'U' 'M' 'M' 'U' 'M' 'A' 'M' 'U' 'U' 'M' 'U' 'U' 'U' 'U' 'U'
 'U' 'M' 'U' 'M' 'U' 'M' 'M' 'U' 'M' 'U' 'M' 'U' 'A' 'M' 'A' 'U' 'M' 'U'
 'M' 'M' 'A' 'M' 'U' 'M' 'A' 'M' 'M' 'A' 'U' 'U' 'M' 'U' 'U' 'U' 'M' 'U'
 'A' 'M' 'A' 'M' 'M' 'M' 'U' 'M' 'U' 'U' 'U' 'M' 'U' 'M' 'M' 'M' 'M' 'M'
 'M' 'M' 'M' 'M' 'M' 'A' 'M' 'M' 'U' 'U' 'M' 'M' 'U' 'A' 'M' 'M' 'M' 'U'
 'M' 'M' 'U' 'U' 'M' 'M' 'A' 'M' 'M' 'U' 'M' 'M' 'M' 'A' 'M' 'M' 'A' 'M'
 'U' 'M' 'U' 'U' 'A' 'M' 'U' 'U' 'M' 'M' 'M' 'M' 'U' 'M' 'U' 'U' 'U' 'M'
 'U' 'U' 'U' 'U' 'M' 'A' 'A' 'A' 'A' 'A' 'A' 'A' 'A' 'A' 'U' 'M' 'U' 'M'
 'M' 'A' 'M' 'U' 'U' 'M' 'M' 'U' 'M' 'U' 'M' 'M' 'A' 'M' 'A' 'M' 'M' 'M'
 'M' 'U' 'U' 'U' 'M' 'A' 'U' 'M' 'U' 'M' 'M' 'M' 'U' 'U' 'U' 'M' 'M' 'A'
 'U' 'M' 'M' 'M' 'A' 'U' 'U' 'A' 'U' 'A' 'U' 'M' 'M' 'U' 'M' 'U' 'U' 'U']"
8901,2,133,38,95,65,0,0,"['A' 'M' 'M' 'A' 'M' 'M' 'U' 'M' 'A' 'M' 'M' 'U' 'M' 'U' 'U' 'U' 'U' 'U'
 'U' 'M' 'U' 'M' 'U' 'M' 'M' 'A' 'M' 'U' 'M' 'U' 'A' 'M' 'A' 'A' 'M' 'A'
 'M' 'M' 'A' 'M' 'U' 'M' 'A' 'M' 'M' 'A' 'U' 'M' 'M' 'U' 'U' 'U' 'M' 'U'
 'A' 'M' 'U' 'M' 'U' 'M' 'U' 'M' 'U' 'U' 'U' 'M' 'M' 'M' 'M' 'M' 'M' 'U'
 'M' 'M' 'M' 'U' 'M' 'U' 'M' 'M' 'U' 'U' 'M' 'M' 'M' 'U' 'M' 'M' 'U' 'U'
 'M' 'M' 'U' 'A' 'M' 'M' 'A' 'M' 'M' 'U' 'M' 'U' 'M' 'A' 'U' 'M' 'U' 'M'
 'U' 'M' 'M' 'A' 'A' 'M' 'A' 'U' 'U' 'U' 'M' 'M' 'M' 'M' 'U' 'U' 'U' 'M'
 'U' 'M' 'M' 'U' 'M' 'A' 'A' 'A' 'A' 'A' 'A' 'A' 'A' 'U' 'U' 'M' 'M' 'M'
 'M' 'A' 'M' 'A' 'A' 'U' 'M' 'M' 'M' 'M' 'M' 'M' 'A' 'M' 'A' 'M' 'U' 'M'
 'M' 'U' 'U' 'U' 'M' 'A' 'U' 'M' 'U' 'U' 'M' 'A' 'U' 'M' 'U' 'M' 'U' 'A'
 'U' 'M' 'M' 'M' 'A' 'U' 'M' 'A' 'U' 'A' 'M' 'M' 'M' 'M' 'U' 'U' 'A' 'U']"
9001,3,134,43,91,64,0,0,"['A' 'M' 'M' 'U' 'M' 'M' 'M' 'M' 'A' 'M' 'M' 'U' 'M' 'A' 'A' 'U' 'M' 'M'
 'U' 'M' 'U' 'M' 'U' 'M' 'M' 'A' 'M' 'U' 'U' 'M' 'U' 'M' 'A' 'A' 'M' 'U'
 'M' 'M' 'A' 'M' 'A' 'M' 'U' 'M' 'U' 'U' 'M' 'U' 'M' 'A' 'U' 'M' 'M' 'U'
 'A' 'U' 'M' 'M' 'U' 'M' 'U' 'M' 'M' 'U' 'M' 'M' 'M' 'M' 'M' 'M' 'M' 'M'
 'M' 'M' 'U' 'U' 'M' 'U' 'M' 'U' 'M' 'U' 'M' 'M' 'U' 'U' 'M' 'M' 'U' 'U'
 'M' 'A' 'U' 'A' 'M' 'M' 'A' 'A' 'U' 'U' 'U' 'U' 'U' 'A' 'U' 'M' 'A' 'M'
 'U' 'M' 'U' 'A' 'A' 'M' 'A' 'U' 'M' 'M' 'M' 'M' 'M' 'U' 'M' 'U' 'U' 'M'
 'U' 'M' 'M' 'U' 'U' 'A' 'A' 'A' 'A' 'A' 'A' 'A' 'A' 'U' 'U' 'M' 'M' 'M'
 'M' 'A' 'M' 'U' 'A' 'A' 'M' 'U' 'M' 'M' 'M' 'U' 'A' 'M' 'A' 'M' 'U' 'M'
 'M' 'A' 'M' 'U' 'M' 'A' 'U' 'M' 'U' 'U' 'M' 'A' 'A' 'M' 'U' 'M' 'A' 'A'
 'U' 'M' 'M' 'U' 'U' 'U' 'M' 'A' 'U' 'A' 'M' 'M' 'U' 'M' 'U' 'U' 'A' 'A']"
9101,1,131,44,87,67,0,1,"['A' 'M' 'M' 'U' 'M' 'M' 'M' 'M' 'A' 'M' 'M' 'M' 'M' 'A' 'A' 'M' 'M' 'M'
 'M' 'U' 'U' 'U' 'M' 'M' 'M' 'A' 'M' 'U' 'U' 'M' 'U' 'U' 'A' 'A' 'A' 'M'
 'M' 'M' 'A' 'M' 'A' 'M' 'U' 'U' 'A' 'A' 'M' 'U' 'M' 'U' 'U' 'M' 'M' 'U'
 'A' 'M' 'M' 'U' 'M' 'M' 'U' 'M' 'U' 'U' 'M' 'M' 'M' 'U' 'M' 'M' 'M' 'M'
 'M' 'M' 'M' 'U' 'M' 'U' 'M' 'U' 'U' 'U' 'M' 'M' 'U' 'U' 'M' 'U' 'U' 'U'
 'M' 'A' 'U' 'A' 'M' 'U' 'A' 'U' 'U' 'U' 'U' 'U' 'U' 'A' 'U' 'M' 'A' 'M'
 'U' 'U' 'U' 'A' 'A' 'M' 'U' 'M' 'A' 'M' 'M' 'M' 'M' 'M' 'M' 'U' 'U' 'M'
 'U' 'M' 'M' 'U' 'M' 'A' 'A' 'A' 'A' 'A' 'A' 'A' 'A' 'U' 'U' 'M' 'M' 'M'
 'M' 'A' 'M' 'U' 'A' 'A' 'M' 'U' 'M' 'M' 'M' 'U' 'A' 'M' 'A' 'M' 'U' 'M'
 'M' 'U' 'M' 'U' 'U' 'A' 'U' 'M' 'U' 'M' 'M' 'A' 'A' 'U' 'U' 'M' 'A' 'A'
 'U' 'M' 'M' 'A' 'U' 'U' 'M' 'A' 'U' 'A' 'U' 'M' 'U' 'M' 'U' 'U' 'A' 'A']"
9201,0,122,46,76,76,0,0,"['A' 'M' 'U' 'U' 'U' 'M' 'M' 'U' 'U' 'M' 'M' 'M' 'U' 'A' 'U' 'M' 'M' 'M'
 'M' 'U' 'U' 'U' 'M' 'U' 'U' 'A' 'M' 'A' 'U' 'U' 'M' 'U' 'A' 'A' 'A' 'M'
 'M' 'U' 'A' 'M' 'A' 'M' 'M' 'U' 'A' 'U' 'M' 'U' 'M' 'U' 'U' 'M' 'M' 'M'
 'U' 'M' 'M' 'A' 'U' 'M' 'U' 'U' 'U' 'U' 'M' 'M' 'M' 'M' 'U' 'M' 'M' 'M'
 'M' 'M' 'M' 'U' 'M' 'A' 'U' 'U' 'A' 'M' 'U' 'M' 'A' 'U' 'M' 'U' 'U' 'U'
 'M' 'U' 'U' 'A' 'M' 'U' 'A' 'U' 'U' 'U' 'U' 'U' 'M' 'A' 'U' 'M' 'A' 'U'
 'U' 'U' 'A' 'A' 'U' 'M' 'A' 'M' 'A' 'M' 'M' 'M' 'M' 'M' 'M' 'U' 'U' 'U'
 'U' 'M' 'M' 'U' 'M' 'A' 'A' 'A' 'A' 'A' 'A' 'A' 'A' 'U' 'U' 'M' 'M' 'U'
 'M' 'A' 'M' 'U' 'A' 'A' 'M' 'A' 'U' 'M' 'M' 'U' 'U' 'M' 'A' 'M' 'U' 'M'
 'M' 'A' 'U' 'U' 'M' 'A' 'U' 'M' 'U' 'M' 'M' 'A' 'A' 'U' 'U' 'M' 'A' 'U'
 'U' 'M' 'M' 'A' 'U' 'U' 'M' 'A' 'U' 'A' 'U' 'M' 'A' 'U' 'M' 'U' 'A' 'A']"
9301,1,120,45,75,78,0,1,"['A' 'U' 'U' 'U' 'U' 'M' 'M' 'U' 'U' 'M' 'U' 'M' 'U' 'A' 'U' 'M' 'U' 'U'
 'M' 'U' 'U' 'U' 'M' 'U' 'M' 'A' 'U' 'A' 'U' 'U' 'M' 'M' 'A' 'A' 'A' 'U'
 'A' 'U' 'A' 'M' 'A' 'M' 'M' 'U' 'A' 'U' 'M' 'U' 'U' 'M' 'U' 'M' 'M' 'M'
 'M' 'M' 'M' 'A' 'U' 'M' 'U' 'U' 'U' 'U' 'M' 'M' 'M' 'U' 'M' 'M' 'M' 'M'
 'M' 'M' 'M' 'U' 'M' 'A' 'M' 'U' 'A' 'M' 'U' 'U' 'A' 'U' 'M' 'U' 'U' 'A'
 'M' 'U' 'U' 'A' 'U' 'M' 'A' 'U' 'U' 'M' 'M' 'U' 'M' 'A' 'M' 'M' 'U' 'M'
 'U' 'M' 'A' 'A' 'U' 'M' 'A' 'M' 'U' 'M' 'M' 'U' 'M' 'M' 'U' 'M' 'U' 'M'
 'M' 'M' 'M' 'A' 'U' 'A' 'A' 'A' 'A' 'A' 'A' 'A' 'A' 'U' 'U' 'M' 'M' 'M'
 'M' 'A' 'U' 'U' 'A' 'U' 'M' 'A' 'U' 'M' 'M' 'U' 'U' 'M' 'A' 'M' 'A' 'M'
 'M' 'U' 'U' 'U' 'U' 'A' 'U' 'U' 'U' 'M' 'M' 'A' 'A' 'U' 'M' 'U' 'A' 'U'
 'U' 'U' 'M' 'A' 'M' 'U' 'M' 'A' 'U' 'A' 'U' 'M' 'A' 'U' 'M' 'U' 'A' 'U']"
9401,1,121,46,75,77,0,0,"['A' 'U' 'U' 'U' 'U' 'M' 'M' 'U' 'A' 'M' 'A' 'M' 'U' 'A' 'U' 'U' 'U' 'A'
 'M' 'U' 'U' 'U' 'M' 'U' 'M' 'A' 'U' 'U' 'U' 'A' 'U' 'M' 'A' 'A' 'U' 'U'
 'A' 'U' 'U' 'M' 'A' 'U' 'U' 'A' 'A' 'U' 'M' 'M' 'M' 'M' 'U' 'M' 'M' 'M'
 'M' 'M' 'M' 'A' 'U' 'M' 'U' 'U' 'M' 'A' 'M' 'M' 'M' 'M' 'M' 'M' 'M' 'M'
 'M' 'M' 'U' 'U' 'M' 'A' 'U' 'U' 'A' 'M' 'U' 'U' 'A' 'U' 'M' 'U' 'M' 'A'
 'M' 'U' 'U' 'A' 'M' 'M' 'A' 'U' 'U' 'M' 'U' 'U' 'M' 'A' 'M' 'M' 'U' 'M'
 'A' 'M' 'A' 'U' 'U' 'M' 'A' 'M' 'M' 'M' 'M' 'U' 'U' 'U' 'M' 'M' 'U' 'U'
 'M' 'M' 'M' 'A' 'U' 'A' 'A' 'U' 'A' 'A' 'A' 'A' 'A' 'M' 'U' 'M' 'M' 'M'
 'M' 'A' 'U' 'M' 'A' 'U' 'M' 'A' 'U' 'M' 'M' 'U' 'U' 'M' 'A' 'M' 'A' 'M'
 'M' 'U' 'U' 'U' 'M' 'U' 'U' 'A' 'M' 'M' 'U' 'U' 'A' 'U' 'U' 'U' 'A' 'U'
 'U' 'U' 'M' 'A' 'M' 'U' 'U' 'U' 'U' 'A' 'A' 'M' 'A' 'M' 'U' 'M' 'A' 'U']"
9501,1,112,31,81,86,1,0,"['A' 'U' 'U' 'U' 'U' 'M' 'M' 'M' 'A' 'M' 'U' 'U' 'U' 'A' 'U' 'U' 'A' 'M'
 'U' 'U' 'U' 'U' 'M' 'U' 'M' 'A' 'U' 'U' 'M' 'U' 'U' 'M' 'A' 'U' 'U' 'U'
 'A' 'U' 'A' 'U' 'U' 'U' 'U' 'U' 'A' 'U' 'M' 'M' 'M' 'M' 'U' 'M' 'M' 'M'
 'M' 'M' 'M' 'U' 'U' 'M' 'U' 'U' 'M' 'A' 'M' 'M' 'U' 'M' 'M' 'M' 'M' 'M'
 'M' 'M' 'M' 'U' 'M' 'A' 'U' 'U' 'A' 'M' 'M' 'U' 'A' 'U' 'U' 'M' 'M' 'A'
 'U' 'U' 'U' 'U' 'M' 'M' 'A' 'M' 'U' 'M' 'U' 'M' 'M' 'A' 'M' 'M' 'U' 'M'
 'U' 'M' 'U' 'U' 'M' 'M' 'A' 'M' 'M' 'M' 'M' 'U' 'M' 'M' 'M' 'U' 'M' 'A'
 'M' 'U' 'M' 'U' 'U' 'A' 'A' 'A' 'A' 'A' 'A' 'A' 'A' 'M' 'U' 'M' 'M' 'M'
 'M' 'U' 'U' 'M' 'U' 'M' 'U' 'A' 'U' 'M' 'U' 'U' 'U' 'M' 'A' 'M' 'A' 'M'
 'M' 'M' 'M' 'U' 'U' 'M' 'U' 'U' 'M' 'M' 'U' 'U' 'A' 'U' 'U' 'U' 'U' 'U'
 'U' 'U' 'M' 'U' 'U' 'U' 'U' 'M' 'M' 'U' 'U' 'U' 'A' 'M' 'U' 'M' 'M' 'U']"
9601,4,121,30,91,77,0,0,"['A' 'U' 'U' 'M' 'M' 'M' 'M' 'M' 'A' 'M' 'U' 'U' 'U' 'A' 'U' 'U' 'A' 'M'
 'U' 'M' 'M' 'U' 'M' 'U' 'M' 'A' 'M' 'U' 'M' 'M' 'U' 'U' 'A' 'U' 'M' 'U'
 'A' 'U' 'A' 'M' 'U' 'M' 'U' 'U' 'A' 'M' 'M' 'M' 'U' 'M' 'U' 'M' 'M' 'M'
 'M' 'M' 'M' 'U' 'U' 'M' 'M' 'U' 'M' 'U' 'M' 'M' 'U' 'M' 'M' 'M' 'M' 'M'
 'M' 'M' 'M' 'M' 'U' 'A' 'U' 'U' 'A' 'M' 'M' 'U' 'A' 'U' 'U' 'U' 'M' 'A'
 'U' 'M' 'U' 'U' 'M' 'M' 'A' 'M' 'M' 'M' 'U' 'M' 'U' 'M' 'M' 'U' 'U' 'M'
 'U' 'M' 'M' 'U' 'M' 'M' 'A' 'M' 'M' 'M' 'U' 'U' 'M' 'M' 'M' 'U' 'M' 'A'
 'M' 'U' 'M' 'A' 'U' 'A' 'A' 'A' 'A' 'A' 'A' 'A' 'A' 'U' 'U' 'M' 'U' 'M'
 'M' 'U' 'U' 'U' 'U' 'M' 'U' 'U' 'U' 'U' 'U' 'M' 'U' 'M' 'A' 'M' 'A' 'M'
 'M' 'M' 'M' 'M' 'M' 'M' 'M' 'U' 'M' 'U' 'U' 'M' 'A' 'U' 'U' 'U' 'U' 'U'
 'M' 'U' 'M' 'M' 'U' 'U' 'U' 'M' 'M' 'U' 'U' 'U' 'A' 'U' 'A' 'M' 'M' 'U']"
9701,1,127,32,95,71,0,0,"['A' 'A' 'M' 'M' 'M' 'M' 'M' 'M' 'A' 'M' 'U' 'U' 'M' 'U' 'U' 'U' 'U' 'U'
 'U' 'M' 'M' 'M' 'M' 'U' 'M' 'A' 'M' 'U' 'M' 'M' 'U' 'M' 'A' 'U' 'M' 'U'
 'A' 'U' 'A' 'M' 'M' 'M' 'U' 'U' 'A' 'M' 'M' 'M' 'U' 'M' 'U' 'U' 'M' 'M'
 'U' 'M' 'M' 'M' 'A' 'M' 'M' 'M' 'M' 'U' 'M' 'M' 'M' 'U' 'M' 'M' 'M' 'M'
 'M' 'M' 'M' 'M' 'A' 'A' 'M' 'U' 'U' 'M' 'M' 'U' 'A' 'U' 'U' 'U' 'U' 'A'
 'U' 'U' 'U' 'M' 'M' 'M' 'A' 'M' 'M' 'M' 'U' 'M' 'U' 'M' 'M' 'U' 'U' 'M'
 'U' 'M' 'M' 'M' 'M' 'M' 'U' 'M' 'M' 'M' 'U' 'A' 'M' 'U' 'M' 'U' 'M' 'A'
 'M' 'U' 'M' 'U' 'U' 'A' 'A' 'A' 'U' 'A' 'A' 'A' 'A' 'U' 'U' 'M' 'U' 'M'
 'M' 'M' 'U' 'U' 'U' 'U' 'M' 'U' 'U' 'M' 'A' 'M' 'A' 'M' 'A' 'M' 'A' 'M'
 'U' 'M' 'M' 'A' 'M' 'M' 'U' 'M' 'M' 'U' 'A' 'M' 'A' 'U' 'M' 'U' 'U' 'M'
 'U' 'U' 'M' 'U' 'M' 'U' 'U' 'U' 'M' 'U' 'U' 'U' 'A' 'U' 'A' 'M' 'M' 'U']"
9801,2,128,35,93,70,0,0,"['A' 'A' 'M' 'M' 'M' 'M' 'M' 'U' 'A' 'M' 'U' 'U' 'M' 'A' 'U' 'U' 'U' 'M'
 'A' 'U' 'M' 'M' 'M' 'U' 'M' 'M' 'M' 'U' 'M' 'M' 'U' 'M' 'U' 'U' 'M' 'M'
 'A' 'M' 'M' 'M' 'M' 'M' 'M' 'U' 'A' 'M' 'M' 'M' 'U' 'M' 'U' 'U' 'U' 'U'
 'U' 'M' 'M' 'M' 'A' 'M' 'M' 'M' 'M' 'U' 'U' 'U' 'M' 'M' 'M' 'M' 'M' 'M'
 'M' 'M' 'M' 'U' 'U' 'A' 'U' 'U' 'M' 'U' 'U' 'U' 'A' 'U' 'U' 'U' 'U' 'A'
 'U' 'U' 'U' 'M' 'U' 'M' 'A' 'M' 'M' 'M' 'U' 'M' 'U' 'U' 'M' 'M' 'A' 'M'
 'U' 'U' 'M' 'M' 'U' 'M' 'U' 'U' 'M' 'M' 'A' 'A' 'M' 'U' 'M' 'M' 'M' 'A'
 'M' 'U' 'M' 'M' 'U' 'A' 'A' 'A' 'A' 'A' 'A' 'A' 'A' 'U' 'M' 'M' 'U' 'M'
 'M' 'M' 'M' 'A' 'U' 'U' 'M' 'U' 'A' 'M' 'A' 'M' 'A' 'M' 'A' 'M' 'A' 'M'
 'U' 'M' 'M' 'U' 'M' 'M' 'U' 'M' 'M' 'U' 'A' 'M' 'U' 'U' 'U' 'U' 'A' 'M'
 'U' 'U' 'M' 'U' 'M' 'U' 'A' 'U' 'M' 'M' 'U' 'M' 'A' 'A' 'U' 'M' 'U' 'U']"
9901,1,128,40,88,70,1,0,"['A' 'U' 'M' 'U' 'M' 'M' 'M' 'U' 'U' 'M' 'A' 'U' 'M' 'A' 'U' 'M' 'U' 'M'
 'A' 'U' 'M' 'U' 'M' 'U' 'U' 'M' 'M' 'U' 'M' 'M' 'A' 'U' 'U' 'M' 'M' 'M'
 'A' 'U' 'M' 'M' 'M' 'M' 'M' 'M' 'A' 'U' 'M' 'M' 'U' 'M' 'U' 'U' 'U' 'U'
 'U' 'M' 'M' 'M' 'A' 'M' 'M' 'M' 'M' 'A' 'U' 'M' 'M' 'M' 'M' 'M' 'M' 'U'
 'M' 'M' 'M' 'U' 'U' 'A' 'U' 'U' 'M' 'U' 'U' 'U' 'A' 'U' 'U' 'U' 'U' 'A'
 'U' 'U' 'A' 'M' 'U' 'M' 'A' 'M' 'M' 'M' 'U' 'U' 'U' 'U' 'M' 'M' 'A' 'M'
 'U' 'U' 'M' 'A' 'U' 'M' 'U' 'M' 'A' 'M' 'A' 'A' 'M' 'U' 'U' 'M' 'M' 'A'
 'M' 'U' 'M' 'M' 'A' 'A' 'A' 'A' 'A' 'A' 'A' 'A' 'A' 'U' 'M' 'M' 'U' 'M'
 'U' 'M' 'M' 'A' 'M' 'M' 'M' 'U' 'U' 'M' 'A' 'M' 'A' 'M' 'A' 'M' 'A' 'M'
 'M' 'M' 'M' 'U' 'M' 'M' 'U' 'M' 'U' 'U' 'A' 'M' 'U' 'U' 'U' 'U' 'A' 'M'
 'U' 'A' 'U' 'U' 'M' 'U' 'A' 'U' 'M' 'M' 'M' 'M' 'A' 'U' 'A' 'M' 'U' 'U']"
10001,1,120,38,82,78,0,0,"['A' 'M' 'M' 'U' 'M' 'M' 'M' 'U' 'U' 'M' 'A' 'U' 'M' 'A' 'U' 'M' 'U' 'U'
 'A' 'U' 'U' 'U' 'M' 'U' 'M' 'M' 'M' 'U' 'M' 'M' 'A' 'U' 'A' 'M' 'U' 'M'
 'A' 'U' 'M' 'M' 'M' 'M' 'U' 'M' 'A' 'M' 'M' 'M' 'U' 'M' 'U' 'U' 'U' 'U'
 'U' 'M' 'M' 'U' 'A' 'M' 'U' 'M' 'U' 'A' 'M' 'U' 'M' 'M' 'M' 'M' 'M' 'M'
 'M' 'M' 'M' 'U' 'U' 'A' 'U' 'A' 'M' 'M' 'A' 'U' 'A' 'M' 'M' 'U' 'U' 'A'
 'U' 'U' 'A' 'M' 'M' 'M' 'U' 'M' 'U' 'M' 'U' 'U' 'U' 'U' 'M' 'M' 'A' 'M'
 'M' 'U' 'M' 'A' 'U' 'M' 'U' 'U' 'U' 'M' 'A' 'A' 'U' 'U' 'U' 'U' 'M' 'A'
 'M' 'U' 'U' 'M' 'A' 'U' 'A' 'A' 'A' 'A' 'A' 'A' 'U' 'M' 'M' 'U' 'U' 'U'
 'U' 'M' 'U' 'A' 'M' 'M' 'M' 'U' 'U' 'M' 'A' 'A' 'U' 'M' 'A' 'M' 'M' 'U'
 'M' 'U' 'M' 'U' 'M' 'M' 'U' 'M' 'U' 'U' 'A' 'M' 'U' 'U' 'U' 'U' 'U' 'M'
 'U' 'A' 'U' 'A' 'M' 'A' 'A' 'M' 'M' 'M' 'M' 'M' 'A' 'U' 'U' 'M' 'U' 'U']"
10101,1,121,41,80,77,0,0,"['A' 'U' 'M' 'U' 'M' 'U' 'M' 'U' 'U' 'U' 'A' 'U' 'M' 'U' 'U' 'M' 'U' 'U'
 'M' 'U' 'M' 'U' 'M' 'A' 'M' 'M' 'U' 'U' 'M' 'U' 'U' 'M' 'A' 'U' 'U' 'M'
 'A' 'M' 'M' 'M' 'M' 'M' 'U' 'M' 'A' 'M' 'M' 'M' 'U' 'M' 'U' 'U' 'A' 'U'
 'A' 'M' 'M' 'A' 'A' 'M' 'U' 'M' 'U' 'A' 'M' 'M' 'M' 'M' 'U' 'M' 'M' 'M'
 'M' 'M' 'M' 'U' 'U' 'U' 'A' 'U' 'M' 'M' 'U' 'U' 'A' 'M' 'A' 'U' 'U' 'A'
 'U' 'U' 'A' 'M' 'M' 'M' 'U' 'M' 'A' 'M' 'A' 'U' 'U' 'U' 'M' 'M' 'A' 'M'
 'M' 'U' 'M' 'U' 'A' 'M' 'U' 'U' 'U' 'M' 'U' 'A' 'U' 'U' 'M' 'U' 'M' 'A'
 'M' 'M' 'U' 'M' 'A' 'A' 'A' 'A' 'A' 'A' 'A' 'A' 'A' 'M' 'U' 'U' 'U' 'M'
 'M' 'M' 'U' 'A' 'U' 'M' 'M' 'U' 'U' 'M' 'A' 'A' 'U' 'M' 'A' 'U' 'M' 'U'
 'M' 'U' 'M' 'M' 'M' 'M' 'U' 'M' 'U' 'U' 'A' 'M' 'U' 'U' 'U' 'U' 'U' 'M'
 'U' 'A' 'U' 'A' 'U' 'A' 'U' 'M' 'M' 'M' 'M' 'M' 'A' 'U' 'U' 'M' 'A' 'U']"
10201,1,118,39,79,80,1,0,"['A' 'U' 'U' 'U' 'M' 'U' 'M' 'U' 'U' 'M' 'A' 'U' 'M' 'U' 'A' 'M' 'U' 'U'
 'M' 'M' 'U' 'U' 'M' 'A' 'M' 'M' 'U' 'U' 'M' 'M' 'A' 'M' 'U' 'A' 'U' 'U'
 'A' 'M' 'M' 'M' 'M' 'M' 'A' 'M' 'U' 'M' 'M' 'M' 'M' 'M' 'A' 'U' 'A' 'A'
 'U' 'M' 'M' 'A' 'A' 'U' 'U' 'M' 'U' 'U' 'M' 'M' 'M' 'M' 'M' 'M' 'M' 'M'
 'M' 'M' 'U' 'U' 'U' 'U' 'A' 'U' 'U' 'M' 'M' 'U' 'U' 'M' 'A' 'U' 'U' 'A'
 'M' 'M' 'U' 'M' 'M' 'M' 'U' 'U' 'A' 'M' 'A' 'U' 'U' 'A' 'M' 'M' 'A' 'M'
 'U' 'U' 'M' 'U' 'A' 'U' 'U' 'U' 'M' 'M' 'U' 'U' 'U' 'U' 'M' 'U' 'M' 'A'
 'M' 'M' 'U' 'U' 'A' 'A' 'A' 'A' 'A' 'A' 'A' 'A' 'A' 'M' 'U' 'U' 'U' 'U'
 'M' 'M' 'U' 'U' 'U' 'M' 'M' 'U' 'U' 'M' 'U' 'A' 'U' 'M' 'A' 'M' 'U' 'A'
 'M' 'U' 'U' 'M' 'U' 'M' 'U' 'M' 'U' 'U' 'A' 'M' 'U' 'M' 'U' 'U' 'U' 'M'
 'U' 'A' 'M' 'U' 'U' 'A' 'U' 'M' 'M' 'M' 'M' 'M' 'A' 'U' 'M' 'M' 'A' 'U']"
10301,3,124,42,82,74,0,1,"['A' 'M' 'U' 'M' 'M' 'U' 'M' 'U' 'U' 'M' 'U' 'U' 'M' 'U' 'A' 'M' 'M' 'U'
 'M' 'M' 'U' 'A' 'M' 'A' 'U' 'M' 'U' 'M' 'U' 'M' 'U' 'U' 'U' 'U' 'U' 'M'
 'A' 'M' 'U' 'M' 'M' 'M' 'A' 'M' 'U' 'U' 'U' 'M' 'U' 'M' 'U' 'U' 'A' 'U'
 'U' 'M' 'M' 'A' 'A' 'U' 'U' 'M' 'M' 'U' 'M' 'M' 'M' 'M' 'M' 'U' 'M' 'M'
 'M' 'M' 'M' 'U' 'U' 'U' 'A' 'U' 'A' 'M' 'M' 'U' 'M' 'M' 'A' 'M' 'U' 'A'
 'M' 'M' 'U' 'M' 'U' 'M' 'U' 'U' 'A' 'M' 'A' 'U' 'M' 'U' 'M' 'M' 'A' 'M'
 'U' 'M' 'M' 'U' 'A' 'U' 'U' 'A' 'M' 'M' 'A' 'U' 'U' 'U' 'M' 'U' 'M' 'A'
 'M' 'M' 'U' 'U' 'A' 'A' 'A' 'A' 'A' 'U' 'A' 'A' 'A' 'M' 'A' 'U' 'U' 'U'
 'M' 'M' 'M' 'U' 'M' 'M' 'M' 'A' 'U' 'U' 'U' 'A' 'M' 'M' 'A' 'M' 'A' 'A'
 'M' 'U' 'U' 'M' 'A' 'M' 'A' 'M' 'U' 'U' 'A' 'M' 'U' 'U' 'A' 'M' 'M' 'M'
 'M' 'U' 'M' 'U' 'U' 'A' 'A' 'M' 'M' 'U' 'M' 'U' 'A' 'U' 'M' 'U' 'A' 'U']"
10401,0,127,41,86,71,1,0,"['A' 'M' 'M' 'U' 'M' 'U' 'M' 'A' 'U' 'M' 'U' 'U' 'M' 'U' 'A' 'U' 'M' 'M'
 'M' 'M' 'A' 'A' 'M' 'A' 'U' 'M' 'U' 'M' 'U' 'M' 'M' 'U' 'A' 'M' 'M' 'M'
 'U' 'U' 'M' 'M' 'U' 'U' 'A' 'M' 'U' 'M' 'U' 'M' 'U' 'M' 'A' 'M' 'A' 'U'
 'U' 'U' 'M' 'A' 'A' 'M' 'U' 'M' 'M' 'U' 'M' 'M' 'M' 'M' 'M' 'M' 'U' 'M'
 'M' 'M' 'M' 'U' 'M' 'U' 'A' 'U' 'A' 'U' 'M' 'M' 'M' 'M' 'A' 'M' 'U' 'A'
 'M' 'M' 'U' 'M' 'U' 'M' 'U' 'U' 'A' 'M' 'U' 'U' 'U' 'U' 'M' 'M' 'A' 'M'
 'U' 'M' 'M' 'U' 'U' 'U' 'M' 'A' 'M' 'U' 'U' 'U' 'M' 'U' 'M' 'U' 'M' 'A'
 'U' 'M' 'A' 'U' 'A' 'A' 'A' 'A' 'A' 'A' 'A' 'A' 'U' 'M' 'A' 'A' 'M' 'U'
 'M' 'M' 'M' 'U' 'M' 'M' 'M' 'A' 'U' 'U' 'U' 'A' 'M' 'M' 'A' 'U' 'A' 'U'
 'M' 'U' 'U' 'M' 'A' 'U' 'U' 'M' 'U' 'M' 'A' 'U' 'U' 'U' 'U' 'M' 'M' 'M'
 'M' 'A' 'M' 'U' 'U' 'U' 'A' 'M' 'U' 'M' 'M' 'U' 'A' 'M' 'M' 'U' 'M' 'A']"
10501,1,123,34,89,75,1,0,"['A' 'M' 'M' 'U' 'M' 'U' 'U' 'A' 'U' 'M' 'U' 'A' 'M' 'U' 'A' 'M' 'M' 'M'
 'U' 'M' 'U' 'U' 'M' 'A' 'U' 'M' 'U' 'U' 'U' 'M' 'U' 'U' 'A' 'M' 'M' 'U'
 'U' 'U' 'M' 'U' 'U' 'U' 'A' 'U' 'U' 'M' 'U' 'M' 'U' 'M' 'A' 'M' 'A' 'M'
 'U' 'U' 'M' 'U' 'A' 'M' 'U' 'M' 'M' 'U' 'M' 'M' 'M' 'M' 'M' 'M' 'U' 'M'
 'M' 'M' 'M' 'U' 'M' 'U' 'A' 'U' 'A' 'U' 'M' 'U' 'M' 'M' 'A' 'M' 'U' 'A'
 'M' 'M' 'U' 'M' 'U' 'M' 'U' 'A' 'U' 'M' 'U' 'U' 'U' 'U' 'M' 'M' 'M' 'M'
 'U' 'M' 'M' 'U' 'U' 'U' 'M' 'A' 'U' 'M' 'U' 'U' 'U' 'M' 'M' 'U' 'M' 'A'
 'U' 'M' 'U' 'A' 'M' 'A' 'A' 'A' 'A' 'A' 'A' 'A' 'A' 'M' 'A' 'U' 'M' 'M'
 'M' 'M' 'M' 'U' 'M' 'M' 'M' 'U' 'U' 'M' 'M' 'U' 'M' 'M' 'M' 'U' 'A' 'U'
 'M' 'U' 'U' 'U' 'A' 'M' 'A' 'A' 'A' 'M' 'M' 'U' 'U' 'U' 'U' 'M' 'U' 'M'
 'M' 'A' 'M' 'M' 'U' 'M' 'U' 'M' 'U' 'M' 'M' 'M' 'U' 'M' 'M' 'M' 'M' 'A']"
10601,0,122,37,85,76,0,1,"['A' 'M' 'M' 'U' 'M' 'U' 'U' 'A' 'U' 'U' 'U' 'A' 'M' 'U' 'A' 'M' 'U' 'M'
 'U' 'M' 'U' 'M' 'M' 'A' 'M' 'M' 'U' 'U' 'A' 'U' 'U' 'U' 'A' 'M' 'M' 'U'
 'M' 'A' 'M' 'M' 'A' 'U' 'U' 'U' 'U' 'U' 'U' 'M' 'U' 'M' 'A' 'U' 'A' 'M'
 'U' 'M' 'M' 'A' 'A' 'M' 'A' 'M' 'M' 'U' 'M' 'M' 'M' 'M' 'M' 'M' 'M' 'M'
 'M' 'U' 'M' 'U' 'M' 'U' 'A' 'M' 'A' 'A' 'M' 'U' 'M' 'M' 'A' 'M' 'U' 'A'
 'M' 'M' 'U' 'M' 'U' 'M' 'U' 'A' 'U' 'M' 'U' 'M' 'U' 'U' 'U' 'M' 'M' 'M'
 'U' 'M' 'U' 'U' 'U' 'U' 'M' 'A' 'U' 'M' 'U' 'U' 'M' 'M' 'U' 'U' 'M' 'U'
 'U' 'M' 'U' 'A' 'M' 'A' 'U' 'A' 'A' 'A' 'U' 'A' 'A' 'M' 'A' 'U' 'M' 'M'
 'M' 'M' 'A' 'U' 'M' 'M' 'M' 'U' 'U' 'M' 'M' 'U' 'U' 'M' 'U' 'M' 'U' 'M'
 'M' 'U' 'U' 'U' 'A' 'M' 'A' 'A' 'A' 'M' 'M' 'A' 'U' 'U' 'U' 'M' 'U' 'M'
 'M' 'U' 'M' 'M' 'A' 'M' 'U' 'U' 'U' 'M' 'M' 'M' 'U' 'M' 'U' 'M' 'U' 'A']"
10701,2,131,40,91,67,0,0,"['A' 'M' 'M' 'U' 'M' 'M' 'U' 'A' 'A' 'U' 'M' 'A' 'M' 'A' 'A' 'M' 'U' 'U'
 'U' 'M' 'U' 'M' 'M' 'U' 'M' 'M' 'A' 'U' 'U' 'U' 'U' 'U' 'U' 'M' 'U' 'U'
 'M' 'A' 'M' 'M' 'A' 'U' 'U' 'U' 'U' 'M' 'U' 'M' 'M' 'M' 'A' 'U' 'A' 'M'
 'M' 'U' 'M' 'U' 'U' 'M' 'A' 'M' 'M' 'U' 'M' 'M' 'M' 'M' 'M' 'M' 'U' 'M'
 'M' 'M' 'M' 'M' 'M' 'U' 'A' 'M' 'A' 'A' 'M' 'A' 'M' 'M' 'U' 'M' 'U' 'A'
 'M' 'M' 'U' 'U' 'A' 'M' 'U' 'U' 'M' 'M' 'U' 'M' 'U' 'U' 'U' 'M' 'M' 'M'
 'U' 'M' 'M' 'U' 'M' 'U' 'U' 'U' 'U' 'M' 'U' 'U' 'M' 'M' 'A' 'A' 'M' 'M'
 'U' 'M' 'U' 'U' 'M' 'A' 'A' 'A' 'A' 'A' 'A' 'A' 'A' 'U' 'A' 'U' 'M' 'M'
 'M' 'U' 'A' 'U' 'U' 'M' 'M' 'U' 'M' 'M' 'M' 'U' 'M' 'M' 'M' 'M' 'M' 'M'
 'M' 'U' 'U' 'U' 'A' 'M' 'A' 'U' 'A' 'A' 'U' 'A' 'A' 'U' 'M' 'U' 'M' 'M'
 'U' 'A' 'U' 'M' 'A' 'M' 'M' 'M' 'A' 'U' 'M' 'M' 'U' 'M' 'M' 'M' 'M' 'A']"
10801,2,129,37,92,69,1,0,"['A' 'M' 'M' 'A' 'M' 'U' 'M' 'A' 'U' 'U' 'M' 'A' 'M' 'A' 'A' 'M' 'M' 'M'
 'M' 'M' 'U' 'M' 'M' 'U' 'M' 'U' 'A' 'M' 'U' 'U' 'M' 'A' 'U' 'M' 'U' 'M'
 'M' 'U' 'M' 'M' 'M' 'U' 'U' 'M' 'U' 'M' 'U' 'U' 'M' 'M' 'A' 'M' 'U' 'M'
 'U' 'U' 'M' 'M' 'U' 'M' 'A' 'M' 'U' 'U' 'M' 'M' 'U' 'M' 'M' 'M' 'M' 'M'
 'M' 'M' 'M' 'M' 'M' 'U' 'A' 'M' 'U' 'A' 'M' 'A' 'M' 'M' 'U' 'M' 'U' 'A'
 'M' 'U' 'U' 'U' 'A' 'U' 'U' 'U' 'M' 'M' 'A' 'U' 'U' 'U' 'U' 'M' 'M' 'M'
 'U' 'M' 'M' 'U' 'U' 'M' 'U' 'U' 'U' 'M' 'U' 'M' 'M' 'M' 'A' 'A' 'M' 'M'
 'U' 'M' 'U' 'U' 'M' 'A' 'A' 'A' 'A' 'A' 'A' 'A' 'A' 'U' 'A' 'A' 'M' 'M'
 'M' 'M' 'A' 'U' 'M' 'M' 'U' 'U' 'M' 'M' 'M' 'U' 'M' 'M' 'M' 'M' 'M' 'U'
 'M' 'U' 'U' 'U' 'A' 'M' 'A' 'U' 'A' 'U' 'A' 'A' 'A' 'U' 'U' 'U' 'M' 'M'
 'U' 'M' 'A' 'U' 'A' 'M' 'U' 'U' 'U' 'U' 'M' 'M' 'U' 'M' 'M' 'M' 'M' 'U']"
10901,1,137,46,91,61,1,0,"['A' 'M' 'M' 'A' 'M' 'U' 'U' 'A' 'A' 'U' 'M' 'A' 'M' 'A' 'A' 'M' 'M' 'A'
 'M' 'M' 'M' 'M' 'M' 'U' 'M' 'U' 'A' 'M' 'U' 'M' 'U' 'A' 'U' 'M' 'U' 'M'
 'U' 'A' 'M' 'M' 'M' 'M' 'U' 'M' 'M' 'M' 'U' 'U' 'M' 'M' 'A' 'M' 'U' 'M'
 'A' 'U' 'M' 'U' 'U' 'M' 'U' 'M' 'U' 'U' 'M' 'M' 'U' 'M' 'M' 'M' 'M' 'M'
 'M' 'M' 'M' 'M' 'M' 'U' 'A' 'M' 'U' 'A' 'M' 'A' 'M' 'M' 'U' 'A' 'M' 'A'
 'U' 'U' 'U' 'A' 'A' 'M' 'M' 'U' 'M' 'M' 'A' 'U' 'U' 'U' 'U' 'M' 'M' 'M'
 'U' 'M' 'M' 'U' 'A' 'M' 'M' 'M' 'U' 'M' 'M' 'U' 'M' 'M' 'A' 'A' 'M' 'M'
 'U' 'U' 'A' 'U' 'M' 'A' 'A' 'A' 'A' 'A' 'A' 'A' 'A' 'U' 'U' 'A' 'M' 'M'
 'U' 'M' 'A' 'A' 'M' 'M' 'A' 'U' 'M' 'M' 'M' 'M' 'M' 'M' 'M' 'M' 'M' 'U'
 'U' 'U' 'U' 'A' 'A' 'M' 'A' 'M' 'A' 'A' 'U' 'U' 'A' 'M' 'U' 'U' 'M' 'M'
 'U' 'U' 'A' 'U' 'A' 'U' 'U' 'U' 'A' 'U' 'U' 'M' 'U' 'M' 'M' 'M' 'M' 'U']"
11001,1,133,48,85,65,0,0,"['A' 'M' 'M' 'A' 'M' 'U' 'U' 'A' 'U' 'A' 'M' 'A' 'M' 'U' 'U' 'M' 'M' 'A'
 'M' 'M' 'M' 'M' 'M' 'A' 'M' 'U' 'U' 'M' 'U' 'A' 'U' 'A' 'A' 'U' 'U' 'M'
 'U' 'A' 'M' 'M' 'M' 'U' 'M' 'M' 'M' 'U' 'M' 'U' 'U' 'U' 'U' 'M' 'U' 'M'
 'A' 'M' 'U' 'U' 'M' 'M' 'A' 'M' 'M' 'U' 'M' 'M' 'M' 'M' 'M' 'U' 'M' 'M'
 'M' 'M' 'M' 'M' 'M' 'M' 'A' 'M' 'M' 'U' 'U' 'A' 'M' 'M' 'U' 'U' 'U' 'A'
 'U' 'U' 'U' 'A' 'A' 'M' 'M' 'U' 'M' 'U' 'A' 'U' 'U' 'A' 'M' 'M' 'M' 'U'
 'U' 'M' 'U' 'A' 'A' 'M' 'M' 'M' 'M' 'M' 'M' 'A' 'M' 'M' 'U' 'A' 'U' 'M'
 'U' 'U' 'A' 'U' 'M' 'A' 'A' 'A' 'A' 'A' 'A' 'A' 'A' 'U' 'M' 'A' 'M' 'U'
 'U' 'M' 'A' 'A' 'M' 'U' 'A' 'M' 'M' 'M' 'M' 'M' 'M' 'M' 'U' 'M' 'M' 'U'
 'U' 'U' 'U' 'U' 'A' 'M' 'U' 'M' 'A' 'A' 'A' 'M' 'A' 'M' 'U' 'U' 'M' 'M'
 'U' 'U' 'A' 'U' 'A' 'U' 'A' 'A' 'A' 'U' 'A' 'U' 'U' 'M' 'M' 'M' 'U' 'U']"
11101,3,125,43,82,73,0,0,"['A' 'M' 'M' 'A' 'M' 'U' 'U' 'U' 'U' 'A' 'M' 'A' 'M' 'M' 'U' 'U' 'M' 'A'
 'M' 'M' 'M' 'U' 'U' 'A' 'M' 'A' 'U' 'M' 'U' 'A' 'U' 'A' 'A' 'U' 'U' 'M'
 'U' 'M' 'M' 'M' 'U' 'M' 'U' 'M' 'M' 'U' 'M' 'U' 'U' 'U' 'U' 'U' 'U' 'M'
 'A' 'M' 'A' 'U' 'M' 'M' 'U' 'U' 'M' 'U' 'A' 'M' 'M' 'M' 'M' 'M' 'M' 'M'
 'U' 'M' 'M' 'M' 'M' 'M' 'A' 'U' 'M' 'U' 'U' 'A' 'M' 'U' 'U' 'U' 'M' 'A'
 'U' 'M' 'M' 'A' 'A' 'M' 'M' 'A' 'M' 'U' 'U' 'U' 'U' 'U' 'M' 'M' 'M' 'U'
 'U' 'M' 'U' 'A' 'U' 'M' 'M' 'M' 'M' 'M' 'M' 'A' 'M' 'M' 'U' 'A' 'U' 'M'
 'A' 'U' 'U' 'M' 'M' 'A' 'A' 'A' 'A' 'A' 'A' 'A' 'A' 'M' 'M' 'A' 'M' 'U'
 'U' 'M' 'A' 'U' 'M' 'A' 'A' 'M' 'M' 'M' 'M' 'M' 'M' 'M' 'M' 'U' 'M' 'U'
 'U' 'U' 'U' 'U' 'A' 'M' 'U' 'M' 'U' 'U' 'A' 'M' 'U' 'M' 'U' 'U' 'M' 'M'
 'U' 'U' 'U' 'U' 'U' 'U' 'A' 'A' 'A' 'U' 'A' 'U' 'U' 'U' 'M' 'M' 'A' 'A']"
11201,0,120,43,77,78,1,0,"['A' 'M' 'U' 'M' 'M' 'U' 'U' 'U' 'U' 'U' 'M' 'A' 'M' 'M' 'U' 'U' 'M' 'A'
 'U' 'M' 'M' 'U' 'U' 'A' 'M' 'A' 'M' 'M' 'U' 'A' 'U' 'A' 'U' 'A' 'U' 'M'
 'U' 'M' 'M' 'M' 'U' 'M' 'U' 'M' 'A' 'U' 'M' 'U' 'U' 'A' 'U' 'U' 'U' 'M'
 'A' 'U' 'A' 'U' 'M' 'U' 'U' 'U' 'U' 'U' 'A' 'M' 'M' 'M' 'U' 'M' 'M' 'M'
 'M' 'M' 'M' 'M' 'M' 'U' 'U' 'A' 'M' 'M' 'U' 'U' 'M' 'U' 'U' 'U' 'U' 'A'
 'U' 'M' 'M' 'A' 'A' 'U' 'M' 'A' 'M' 'A' 'U' 'U' 'U' 'U' 'M' 'M' 'M' 'U'
 'U' 'M' 'M' 'A' 'U' 'M' 'M' 'M' 'M' 'U' 'U' 'A' 'M' 'M' 'U' 'A' 'U' 'M'
 'A' 'U' 'M' 'M' 'M' 'A' 'A' 'A' 'U' 'A' 'A' 'A' 'A' 'M' 'M' 'A' 'A' 'U'
 'M' 'M' 'A' 'U' 'M' 'M' 'A' 'M' 'M' 'M' 'M' 'M' 'U' 'M' 'M' 'U' 'M' 'U'
 'U' 'A' 'U' 'M' 'A' 'M' 'U' 'U' 'U' 'U' 'U' 'M' 'U' 'A' 'U' 'M' 'M' 'M'
 'U' 'U' 'M' 'A' 'U' 'U' 'U' 'A' 'A' 'U' 'U' 'U' 'U' 'A' 'M' 'M' 'A' 'A']"
11301,0,119,46,73,79,0,1,"['A' 'M' 'A' 'M' 'M' 'U' 'U' 'M' 'U' 'U' 'M' 'A' 'M' 'M' 'U' 'U' 'M' 'A'
 'U' 'U' 'U' 'U' 'M' 'A' 'M' 'U' 'M' 'M' 'M' 'M' 'U' 'U' 'A' 'A' 'U' 'M'
 'M' 'M' 'U' 'M' 'A' 'M' 'A' 'M' 'A' 'U' 'M' 'U' 'U' 'A' 'A' 'U' 'M' 'M'
 'U' 'U' 'U' 'U' 'M' 'M' 'U' 'U' 'M' 'U' 'A' 'M' 'M' 'M' 'M' 'U' 'M' 'M'
 'M' 'M' 'M' 'M' 'M' 'U' 'U' 'A' 'M' 'A' 'A' 'U' 'U' 'U' 'U' 'U' 'A' 'A'
 'U' 'M' 'U' 'A' 'A' 'U' 'U' 'A' 'M' 'A' 'U' 'U' 'U' 'U' 'M' 'M' 'U' 'M'
 'U' 'M' 'U' 'A' 'M' 'U' 'U' 'M' 'M' 'A' 'U' 'A' 'U' 'M' 'U' 'A' 'U' 'M'
 'A' 'U' 'M' 'M' 'M' 'A' 'U' 'A' 'A' 'A' 'A' 'A' 'A' 'M' 'M' 'A' 'U' 'U'
 'M' 'U' 'A' 'U' 'A' 'M' 'A' 'M' 'M' 'M' 'U' 'M' 'U' 'M' 'M' 'M' 'M' 'A'
 'M' 'A' 'U' 'M' 'A' 'U' 'U' 'U' 'U' 'U' 'U' 'U' 'U' 'A' 'U' 'M' 'M' 'M'
 'U' 'U' 'U' 'M' 'M' 'U' 'U' 'A' 'A' 'U' 'U' 'U' 'U' 'U' 'M' 'M' 'A' 'A']"
11401,1,121,46,75,77,0,0,"['A' 'M' 'U' 'M' 'M' 'U' 'U' 'M' 'U' 'U' 'M' 'U' 'M' 'M' 'M' 'U' 'M' 'U'
 'U' 'U' 'U' 'U' 'M' 'A' 'M' 'A' 'M' 'M' 'M' 'U' 'U' 'M' 'U' 'A' 'U' 'M'
 'M' 'M' 'U' 'U' 'A' 'M' 'A' 'M' 'A' 'U' 'M' 'U' 'U' 'A' 'A' 'M' 'M' 'M'
 'U' 'A' 'U' 'U' 'M' 'M' 'M' 'M' 'U' 'U' 'U' 'M' 'M' 'U' 'M' 'M' 'M' 'M'
 'M' 'M' 'M' 'M' 'M' 'U' 'U' 'A' 'M' 'A' 'A' 'U' 'U' 'A' 'U' 'U' 'A' 'A'
 'U' 'M' 'U' 'A' 'A' 'U' 'M' 'A' 'M' 'A' 'U' 'U' 'U' 'U' 'M' 'U' 'U' 'M'
 'U' 'M' 'U' 'A' 'M' 'U' 'U' 'M' 'M' 'A' 'U' 'A' 'M' 'M' 'U' 'A' 'U' 'U'
 'A' 'U' 'U' 'M' 'U' 'A' 'A' 'A' 'A' 'A' 'A' 'A' 'A' 'U' 'M' 'A' 'U' 'U'
 'U' 'U' 'A' 'U' 'A' 'M' 'A' 'M' 'M' 'M' 'U' 'U' 'U' 'M' 'M' 'M' 'M' 'A'
 'M' 'A' 'M' 'M' 'U' 'A' 'U' 'A' 'U' 'M' 'M' 'U' 'A' 'A' 'U' 'M' 'M' 'M'
 'M' 'U' 'U' 'M' 'M' 'A' 'M' 'U' 'A' 'U' 'U' 'U' 'U' 'M' 'U' 'M' 'U' 'A']"
11501,2,120,46,74,78,0,0,"['A' 'M' 'U' 'U' 'M' 'U' 'M' 'U' 'U' 'U' 'M' 'U' 'M' 'M' 'M' 'M' 'M' 'M'
 'U' 'U' 'U' 'U' 'M' 'A' 'M' 'A' 'M' 'M' 'M' 'A' 'U' 'A' 'U' 'A' 'U' 'M'
 'M' 'U' 'M' 'U' 'A' 'M' 'A' 'M' 'A' 'U' 'M' 'U' 'U' 'A' 'A' 'M' 'M' 'M'
 'M' 'A' 'U' 'A' 'M' 'M' 'M' 'M' 'U' 'U' 'U' 'M' 'M' 'M' 'M' 'M' 'M' 'M'
 'M' 'U' 'M' 'M' 'M' 'U' 'U' 'A' 'M' 'U' 'U' 'U' 'U' 'U' 'U' 'M' 'A' 'A'
 'U' 'U' 'U' 'A' 'A' 'U' 'M' 'U' 'M' 'A' 'U' 'U' 'U' 'U' 'U' 'U' 'U' 'M'
 'M' 'M' 'A' 'A' 'M' 'U' 'A' 'M' 'M' 'A' 'U' 'A' 'M' 'M' 'U' 'A' 'M' 'U'
 'A' 'U' 'U' 'M' 'U' 'A' 'A' 'A' 'A' 'A' 'A' 'A' 'A' 'A' 'M' 'U' 'U' 'M'
 'U' 'M' 'U' 'U' 'A' 'M' 'U' 'U' 'U' 'M' 'U' 'U' 'A' 'M' 'M' 'M' 'U' 'A'
 'U' 'A' 'M' 'U' 'U' 'A' 'U' 'A' 'U' 'U' 'U' 'M' 'A' 'A' 'U' 'M' 'U' 'M'
 'M' 'U' 'U' 'M' 'M' 'A' 'U' 'M' 'A' 'U' 'M' 'M' 'U' 'M' 'U' 'M' 'U' 'A']"
11601,1,118,41,77,80,0,1,"['A' 'M' 'U' 'U' 'M' 'U' 'M' 'U' 'M' 'U' 'M' 'M' 'U' 'M' 'M' 'M' 'M' 'M'
 'M' 'A' 'U' 'A' 'M' 'A' 'M' 'A' 'M' 'M' 'U' 'A' 'U' 'U' 'U' 'U' 'M' 'U'
 'M' 'U' 'M' 'M' 'A' 'U' 'A' 'M' 'A' 'U' 'M' 'U' 'U' 'A' 'A' 'M' 'M' 'M'
 'M' 'A' 'U' 'A' 'M' 'M' 'U' 'M' 'M' 'U' 'U' 'M' 'M' 'M' 'M' 'M' 'M' 'U'
 'M' 'M' 'M' 'U' 'M' 'U' 'U' 'A' 'U' 'U' 'U' 'U' 'U' 'U' 'U' 'M' 'U' 'A'
 'U' 'U' 'A' 'A' 'A' 'U' 'U' 'U' 'M' 'U' 'U' 'M' 'U' 'U' 'U' 'U' 'U' 'M'
 'M' 'M' 'A' 'A' 'M' 'U' 'U' 'M' 'M' 'A' 'U' 'A' 'M' 'U' 'U' 'A' 'M' 'U'
 'U' 'U' 'M' 'M' 'U' 'A' 'A' 'A' 'U' 'A' 'A' 'A' 'A' 'A' 'M' 'M' 'U' 'M'
 'U' 'M' 'U' 'U' 'A' 'M' 'U' 'U' 'U' 'M' 'U' 'U' 'A' 'M' 'M' 'M' 'M' 'A'
 'U' 'A' 'M' 'U' 'U' 'A' 'U' 'A' 'U' 'M' 'U' 'M' 'A' 'U' 'U' 'U' 'U' 'M'
 'M' 'U' 'U' 'M' 'M' 'A' 'U' 'M' 'U' 'A' 'M' 'M' 'M' 'M' 'U' 'M' 'M' 'A']"
11701,1,116,37,79,82,1,0,"['A' 'M' 'U' 'U' 'M' 'U' 'M' 'U' 'M' 'U' 'M' 'M' 'M' 'M' 'U' 'M' 'M' 'M'
 'M' 'A' 'U' 'U' 'U' 'A' 'M' 'U' 'M' 'M' 'U' 'A' 'U' 'U' 'U' 'U' 'M' 'A'
 'A' 'M' 'M' 'U' 'A' 'U' 'A' 'U' 'A' 'U' 'M' 'U' 'U' 'A' 'U' 'M' 'M' 'M'
 'M' 'U' 'U' 'A' 'M' 'M' 'M' 'M' 'M' 'U' 'M' 'M' 'M' 'M' 'U' 'M' 'M' 'M'
 'M' 'M' 'M' 'U' 'M' 'U' 'U' 'A' 'U' 'U' 'M' 'U' 'U' 'U' 'M' 'M' 'A' 'A'
 'U' 'U' 'A' 'A' 'A' 'M' 'U' 'M' 'M' 'U' 'U' 'M' 'U' 'U' 'U' 'U' 'U' 'U'
 'M' 'U' 'U' 'U' 'U' 'U' 'U' 'U' 'M' 'M' 'M' 'A' 'M' 'U' 'U' 'U' 'M' 'U'
 'A' 'U' 'U' 'A' 'U' 'A' 'A' 'A' 'A' 'A' 'A' 'A' 'A' 'A' 'M' 'M' 'U' 'M'
 'M' 'M' 'M' 'U' 'A' 'U' 'U' 'U' 'U' 'M' 'U' 'A' 'A' 'M' 'U' 'M' 'U' 'A'
 'M' 'U' 'M' 'U' 'M' 'A' 'U' 'A' 'U' 'M' 'U' 'M' 'M' 'U' 'U' 'U' 'U' 'M'
 'M' 'U' 'M' 'U' 'M' 'A' 'U' 'M' 'M' 'U' 'M' 'M' 'M' 'M' 'U' 'M' 'M' 'A']"
11801,1,128,46,82,70,1,0,"['A' 'M' 'U' 'A' 'M' 'U' 'M' 'M' 'M' 'U' 'M' 'M' 'M' 'M' 'U' 'A' 'U' 'M'
 'U' 'U' 'U' 'U' 'U' 'A' 'M' 'A' 'U' 'M' 'U' 'A' 'U' 'A' 'M' 'U' 'M' 'A'
 'A' 'M' 'M' 'U' 'A' 'U' 'A' 'U' 'A' 'M' 'U' 'U' 'U' 'U' 'U' 'M' 'M' 'M'
 'U' 'U' 'A' 'A' 'M' 'M' 'M' 'M' 'M' 'U' 'M' 'M' 'M' 'M' 'U' 'M' 'M' 'M'
 'M' 'M' 'M' 'U' 'M' 'A' 'M' 'A' 'A' 'U' 'M' 'U' 'A' 'U' 'M' 'M' 'A' 'A'
 'U' 'M' 'A' 'A' 'A' 'U' 'U' 'M' 'M' 'U' 'U' 'A' 'U' 'U' 'A' 'M' 'U' 'U'
 'M' 'U' 'M' 'U' 'U' 'U' 'A' 'U' 'M' 'M' 'M' 'A' 'M' 'U' 'U' 'U' 'M' 'U'
 'A' 'U' 'U' 'U' 'M' 'A' 'A' 'A' 'A' 'A' 'A' 'A' 'A' 'A' 'M' 'M' 'U' 'M'
 'M' 'M' 'M' 'U' 'U' 'A' 'M' 'M' 'M' 'M' 'U' 'U' 'A' 'M' 'A' 'U' 'U' 'A'
 'M' 'U' 'U' 'U' 'M' 'U' 'U' 'A' 'U' 'M' 'M' 'M' 'M' 'A' 'A' 'U' 'U' 'U'
 'M' 'M' 'M' 'U' 'M' 'A' 'M' 'M' 'M' 'U' 'M' 'M' 'M' 'M' 'U' 'M' 'M' 'A']"
11901,3,128,50,78,70,1,0,"['A' 'M' 'A' 'U' 'M' 'U' 'M' 'U' 'U' 'U' 'U' 'M' 'M' 'M' 'A' 'A' 'A' 'M'
 'U' 'A' 'A' 'U' 'U' 'A' 'M' 'U' 'U' 'M' 'U' 'A' 'M' 'U' 'M' 'M' 'M' 'A'
 'A' 'U' 'M' 'M' 'A' 'U' 'A' 'U' 'A' 'M' 'U' 'A' 'U' 'U' 'M' 'M' 'U' 'M'
 'A' 'U' 'A' 'U' 'M' 'M' 'M' 'M' 'M' 'U' 'M' 'M' 'U' 'M' 'M' 'M' 'M' 'M'
 'M' 'M' 'M' 'U' 'M' 'U' 'U' 'A' 'U' 'M' 'M' 'A' 'U' 'U' 'M' 'U' 'U' 'U'
 'U' 'M' 'A' 'A' 'A' 'A' 'A' 'M' 'M' 'U' 'U' 'A' 'U' 'M' 'A' 'M' 'U' 'U'
 'U' 'M' 'M' 'M' 'U' 'M' 'A' 'U' 'M' 'M' 'U' 'U' 'U' 'U' 'U' 'U' 'M' 'M'
 'A' 'U' 'A' 'M' 'M' 'A' 'A' 'A' 'A' 'A' 'A' 'A' 'A' 'A' 'M' 'M' 'U' 'U'
 'M' 'M' 'M' 'U' 'U' 'A' 'M' 'M' 'M' 'M' 'A' 'U' 'A' 'M' 'A' 'U' 'U' 'A'
 'U' 'A' 'U' 'M' 'M' 'A' 'U' 'U' 'U' 'U' 'M' 'M' 'M' 'A' 'A' 'U' 'U' 'U'
 'U' 'M' 'U' 'U' 'M' 'A' 'U' 'M' 'M' 'U' 'M' 'M' 'M' 'M' 'A' 'M' 'M' 'A']"
12001,1,122,45,77,76,0,0,"['A' 'M' 'A' 'U' 'M' 'U' 'M' 'U' 'M' 'M' 'U' 'M' 'M' 'U' 'A' 'M' 'A' 'U'
 'U' 'A' 'U' 'U' 'U' 'U' 'U' 'M' 'M' 'M' 'M' 'A' 'M' 'U' 'M' 'M' 'M' 'A'
 'A' 'U' 'M' 'U' 'U' 'A' 'U' 'M' 'A' 'M' 'U' 'A' 'U' 'U' 'M' 'M' 'U' 'M'
 'A' 'U' 'U' 'U' 'M' 'U' 'M' 'M' 'M' 'U' 'M' 'M' 'M' 'U' 'M' 'M' 'M' 'M'
 'M' 'M' 'M' 'U' 'M' 'U' 'U' 'A' 'U' 'M' 'M' 'A' 'U' 'A' 'M' 'U' 'U' 'A'
 'U' 'A' 'A' 'A' 'A' 'A' 'A' 'M' 'M' 'A' 'U' 'A' 'U' 'U' 'A' 'M' 'U' 'U'
 'A' 'M' 'M' 'M' 'U' 'M' 'A' 'U' 'M' 'M' 'U' 'U' 'U' 'U' 'U' 'U' 'M' 'M'
 'A' 'U' 'U' 'U' 'U' 'A' 'A' 'A' 'U' 'A' 'A' 'A' 'A' 'U' 'M' 'M' 'U' 'U'
 'M' 'U' 'M' 'U' 'U' 'A' 'M' 'M' 'M' 'M' 'A' 'M' 'A' 'M' 'A' 'A' 'U' 'A'
 'U' 'A' 'U' 'M' 'M' 'A' 'M' 'U' 'A' 'U' 'M' 'M' 'M' 'A' 'U' 'U' 'U' 'U'
 'U' 'M' 'U' 'U' 'M' 'U' 'M' 'U' 'M' 'M' 'M' 'M' 'U' 'M' 'U' 'M' 'M' 'U']"
12101,1,125,48,77,73,0,1,"['A' 'M' 'A' 'U' 'M' 'U' 'U' 'U' 'U' 'U' 'U' 'M' 'M' 'U' 'A' 'U' 'U' 'M'
 'U' 'U' 'U' 'M' 'U' 'U' 'U' 'M' 'M' 'U' 'M' 'A' 'U' 'U' 'M' 'M' 'M' 'A'
 'A' 'U' 'M' 'U' 'M' 'A' 'U' 'U' 'U' 'M' 'U' 'A' 'U' 'U' 'M' 'M' 'M' 'M'
 'A' 'U' 'U' 'U' 'M' 'M' 'M' 'M' 'M' 'U' 'M' 'U' 'M' 'M' 'M' 'M' 'M' 'M'
 'M' 'M' 'M' 'U' 'M' 'U' 'A' 'A' 'U' 'M' 'U' 'A' 'U' 'A' 'U' 'U' 'M' 'A'
 'M' 'A' 'A' 'A' 'A' 'A' 'U' 'U' 'M' 'U' 'U' 'U' 'U' 'U' 'A' 'M' 'A' 'M'
 'M' 'M' 'M' 'M' 'U' 'M' 'A' 'U' 'M' 'M' 'U' 'M' 'M' 'U' 'A' 'M' 'M' 'M'
 'A' 'A' 'A' 'U' 'U' 'A' 'A' 'A' 'A' 'A' 'A' 'A' 'A' 'U' 'M' 'M' 'A' 'U'
 'M' 'U' 'M' 'M' 'U' 'A' 'M' 'M' 'A' 'U' 'A' 'M' 'A' 'M' 'A' 'A' 'U' 'A'
 'U' 'U' 'U' 'M' 'M' 'A' 'M' 'U' 'A' 'U' 'M' 'M' 'M' 'A' 'U' 'U' 'U' 'A'
 'M' 'M' 'M' 'U' 'M' 'U' 'M' 'A' 'M' 'M' 'M' 'U' 'U' 'A' 'U' 'M' 'U' 'U']"
12201,1,113,48,65,85,0,0,"['A' 'M' 'A' 'U' 'U' 'U' 'U' 'U' 'A' 'U' 'A' 'M' 'M' 'U' 'U' 'U' 'U' 'M'
 'M' 'U' 'A' 'M' 'M' 'U' 'U' 'M' 'M' 'U' 'M' 'A' 'U' 'U' 'U' 'U' 'M' 'A'
 'U' 'U' 'U' 'U' 'M' 'A' 'U' 'U' 'U' 'U' 'U' 'A' 'U' 'U' 'U' 'M' 'M' 'M'
 'A' 'U' 'A' 'U' 'M' 'U' 'M' 'M' 'M' 'U' 'M' 'M' 'M' 'U' 'M' 'M' 'M' 'M'
 'M' 'M' 'M' 'A' 'U' 'U' 'A' 'U' 'U' 'M' 'U' 'A' 'U' 'U' 'A' 'U' 'M' 'A'
 'M' 'A' 'A' 'A' 'U' 'A' 'U' 'U' 'M' 'U' 'M' 'U' 'U' 'U' 'A' 'M' 'A' 'M'
 'U' 'M' 'M' 'U' 'U' 'M' 'A' 'A' 'M' 'M' 'U' 'U' 'M' 'U' 'M' 'M' 'M' 'M'
 'A' 'U' 'A' 'M' 'U' 'A' 'A' 'A' 'A' 'A' 'A' 'A' 'A' 'U' 'U' 'M' 'A' 'U'
 'M' 'U' 'M' 'M' 'U' 'U' 'M' 'U' 'U' 'U' 'A' 'M' 'A' 'M' 'U' 'A' 'U' 'A'
 'U' 'A' 'U' 'U' 'U' 'A' 'M' 'A' 'A' 'M' 'U' 'M' 'M' 'A' 'A' 'U' 'A' 'A'
 'M' 'M' 'M' 'U' 'U' 'U' 'M' 'U' 'U' 'M' 'M' 'U' 'U' 'A' 'U' 'M' 'U' 'U']"
12301,1,119,50,69,79,0,1,"['A' 'M' 'U' 'U' 'A' 'A' 'U' 'U' 'A' 'M' 'A' 'U' 'M' 'U' 'U' 'U' 'U' 'M'
 'M' 'U' 'U' 'M' 'M' 'U' 'U' 'U' 'M' 'U' 'M' 'U' 'U' 'M' 'U' 'M' 'M' 'A'
 'U' 'U' 'M' 'U' 'U' 'A' 'A' 'U' 'U' 'M' 'A' 'A' 'A' 'U' 'U' 'A' 'M' 'M'
 'U' 'U' 'A' 'U' 'M' 'U' 'U' 'M' 'M' 'M' 'M' 'M' 'U' 'M' 'M' 'M' 'M' 'M'
 'M' 'M' 'M' 'A' 'U' 'U' 'A' 'U' 'U' 'M' 'U' 'A' 'U' 'M' 'M' 'U' 'M' 'A'
 'M' 'A' 'A' 'A' 'U' 'U' 'U' 'M' 'M' 'U' 'U' 'M' 'U' 'U' 'A' 'M' 'A' 'M'
 'U' 'M' 'M' 'U' 'U' 'M' 'A' 'A' 'U' 'A' 'A' 'U' 'M' 'M' 'M' 'M' 'M' 'M'
 'A' 'M' 'U' 'M' 'A' 'U' 'A' 'A' 'A' 'A' 'A' 'A' 'A' 'U' 'U' 'M' 'A' 'A'
 'U' 'U' 'M' 'U' 'U' 'U' 'M' 'U' 'A' 'U' 'A' 'M' 'A' 'M' 'U' 'A' 'M' 'U'
 'U' 'A' 'U' 'A' 'U' 'U' 'M' 'A' 'U' 'M' 'U' 'M' 'M' 'A' 'A' 'U' 'A' 'A'
 'M' 'M' 'M' 'U' 'U' 'U' 'M' 'A' 'M' 'M' 'M' 'U' 'U' 'A' 'U' 'M' 'U' 'U']"
12401,2,126,52,74,72,1,0,"['A' 'M' 'U' 'M' 'A' 'A' 'U' 'U' 'A' 'U' 'A' 'U' 'M' 'U' 'M' 'U' 'M' 'M'
 'U' 'M' 'U' 'M' 'M' 'U' 'M' 'U' 'M' 'A' 'M' 'A' 'U' 'M' 'U' 'U' 'M' 'U'
 'U' 'U' 'M' 'U' 'U' 'A' 'A' 'U' 'M' 'M' 'A' 'A' 'U' 'M' 'U' 'A' 'M' 'M'
 'U' 'M' 'A' 'U' 'M' 'U' 'U' 'M' 'M' 'M' 'M' 'M' 'M' 'M' 'M' 'M' 'M' 'M'
 'U' 'M' 'M' 'A' 'U' 'M' 'A' 'U' 'U' 'U' 'U' 'A' 'U' 'U' 'M' 'A' 'M' 'A'
 'M' 'A' 'A' 'U' 'U' 'M' 'A' 'M' 'M' 'A' 'U' 'M' 'U' 'U' 'M' 'M' 'A' 'M'
 'U' 'M' 'M' 'U' 'U' 'M' 'A' 'U' 'U' 'A' 'A' 'U' 'M' 'M' 'M' 'M' 'U' 'M'
 'A' 'M' 'U' 'U' 'A' 'A' 'A' 'A' 'A' 'A' 'A' 'A' 'A' 'U' 'U' 'M' 'M' 'U'
 'A' 'U' 'U' 'M' 'U' 'U' 'M' 'M' 'A' 'A' 'U' 'M' 'A' 'M' 'U' 'A' 'A' 'M'
 'A' 'A' 'U' 'A' 'U' 'U' 'M' 'A' 'U' 'U' 'M' 'M' 'M' 'A' 'A' 'U' 'A' 'A'
 'M' 'M' 'U' 'U' 'U' 'M' 'M' 'A' 'M' 'U' 'U' 'M' 'U' 'A' 'U' 'U' 'U' 'M']"
12501,1,117,46,71,81,1,0,"['A' 'U' 'U' 'M' 'A' 'A' 'A' 'U' 'A' 'U' 'U' 'M' 'M' 'U' 'M' 'U' 'M' 'U'
 'U' 'M' 'U' 'M' 'M' 'U' 'U' 'U' 'U' 'U' 'M' 'A' 'M' 'U' 'U' 'U' 'U' 'M'
 'U' 'U' 'M' 'M' 'U' 'A' 'A' 'U' 'U' 'M' 'U' 'A' 'U' 'M' 'A' 'A' 'M' 'M'
 'U' 'M' 'A' 'U' 'U' 'U' 'U' 'M' 'M' 'M' 'U' 'M' 'M' 'M' 'M' 'M' 'M' 'M'
 'M' 'M' 'U' 'A' 'U' 'M' 'A' 'U' 'U' 'M' 'A' 'A' 'U' 'U' 'U' 'U' 'M' 'A'
 'M' 'A' 'A' 'A' 'U' 'M' 'A' 'M' 'U' 'A' 'U' 'M' 'U' 'U' 'M' 'M' 'A' 'M'
 'A' 'M' 'M' 'U' 'A' 'M' 'A' 'U' 'M' 'U' 'A' 'U' 'M' 'M' 'U' 'M' 'U' 'M'
 'A' 'M' 'M' 'M' 'U' 'A' 'A' 'U' 'A' 'A' 'A' 'A' 'A' 'M' 'U' 'M' 'M' 'A'
 'A' 'U' 'U' 'M' 'U' 'U' 'M' 'M' 'U' 'A' 'M' 'M' 'A' 'M' 'U' 'U' 'U' 'M'
 'U' 'U' 'U' 'A' 'U' 'M' 'U' 'A' 'M' 'U' 'U' 'M' 'M' 'A' 'U' 'U' 'A' 'A'
 'M' 'M' 'U' 'U' 'U' 'M' 'U' 'A' 'M' 'U' 'U' 'M' 'U' 'A' 'U' 'U' 'U' 'M']"
12601,2,126,52,74,72,1,0,"['A' 'U' 'U' 'U' 'A' 'A' 'U' 'U' 'A' 'U' 'U' 'M' 'M' 'U' 'M' 'U' 'M' 'A'
 'U' 'M' 'U' 'M' 'M' 'M' 'M' 'U' 'U' 'U' 'U' 'A' 'M' 'A' 'U' 'A' 'U' 'U'
 'U' 'A' 'M' 'M' 'M' 'A' 'A' 'U' 'U' 'M' 'U' 'A' 'U' 'M' 'U' 'A' 'M' 'M'
 'U' 'U' 'A' 'U' 'M' 'U' 'U' 'M' 'M' 'M' 'U' 'M' 'M' 'M' 'M' 'M' 'U' 'M'
 'M' 'M' 'M' 'A' 'U' 'U' 'A' 'U' 'M' 'M' 'U' 'M' 'U' 'U' 'U' 'U' 'M' 'A'
 'M' 'A' 'A' 'A' 'U' 'U' 'A' 'M' 'U' 'A' 'U' 'U' 'M' 'U' 'M' 'M' 'A' 'M'
 'A' 'M' 'M' 'M' 'A' 'M' 'A' 'M' 'M' 'U' 'A' 'U' 'M' 'U' 'M' 'U' 'A' 'M'
 'A' 'M' 'U' 'M' 'A' 'A' 'A' 'A' 'A' 'A' 'A' 'A' 'A' 'A' 'U' 'M' 'M' 'A'
 'U' 'M' 'M' 'M' 'M' 'M' 'M' 'M' 'A' 'A' 'M' 'U' 'U' 'M' 'U' 'U' 'M' 'M'
 'U' 'U' 'U' 'A' 'U' 'M' 'U' 'A' 'M' 'A' 'U' 'M' 'A' 'A' 'U' 'A' 'U' 'A'
 'M' 'M' 'U' 'M' 'U' 'M' 'U' 'A' 'M' 'U' 'A' 'M' 'U' 'A' 'U' 'U' 'U' 'M']"
12701,2,128,48,80,70,0,1,"['A' 'U' 'M' 'A' 'A' 'U' 'A' 'U' 'A' 'U' 'U' 'A' 'U' 'U' 'M' 'U' 'M' 'A'
 'U' 'U' 'M' 'U' 'M' 'M' 'M' 'M' 'U' 'A' 'U' 'A' 'M' 'A' 'U' 'A' 'U' 'U'
 'U' 'A' 'U' 'M' 'M' 'A' 'A' 'U' 'M' 'M' 'M' 'A' 'M' 'U' 'A' 'U' 'M' 'M'
 'U' 'M' 'U' 'U' 'M' 'U' 'U' 'M' 'M' 'U' 'U' 'M' 'M' 'M' 'U' 'M' 'M' 'M'
 'M' 'M' 'M' 'U' 'U' 'U' 'A' 'U' 'U' 'M' 'A' 'M' 'U' 'U' 'U' 'M' 'M' 'U'
 'M' 'A' 'A' 'U' 'U' 'M' 'A' 'U' 'U' 'U' 'M' 'U' 'M' 'U' 'M' 'M' 'A' 'M'
 'A' 'M' 'M' 'M' 'A' 'M' 'A' 'M' 'U' 'U' 'U' 'U' 'M' 'U' 'U' 'M' 'A' 'M'
 'A' 'M' 'U' 'M' 'U' 'A' 'A' 'A' 'A' 'A' 'A' 'A' 'A' 'A' 'U' 'M' 'M' 'A'
 'U' 'M' 'M' 'M' 'M' 'M' 'M' 'M' 'A' 'A' 'M' 'U' 'M' 'M' 'U' 'U' 'U' 'M'
 'U' 'A' 'U' 'A' 'M' 'M' 'U' 'U' 'M' 'A' 'U' 'M' 'A' 'A' 'M' 'A' 'M' 'A'
 'M' 'M' 'U' 'M' 'U' 'M' 'M' 'U' 'M' 'M' 'A' 'M' 'M' 'A' 'U' 'U' 'M' 'U']"
12801,0,129,49,80,69,1,0,"['A' 'U' 'M' 'A' 'A' 'M' 'A' 'U' 'A' 'U' 'A' 'U' 'U' 'U' 'M' 'U' 'M' 'U'
 'U' 'U' 'M' 'U' 'M' 'M' 'M' 'M' 'U' 'A' 'U' 'A' 'M' 'A' 'A' 'U' 'U' 'U'
 'M' 'A' 'A' 'M' 'M' 'A' 'A' 'U' 'M' 'M' 'M' 'A' 'M' 'A' 'A' 'U' 'M' 'M'
 'U' 'M' 'U' 'U' 'M' 'U' 'U' 'U' 'M' 'U' 'U' 'M' 'M' 'M' 'M' 'U' 'M' 'M'
 'M' 'M' 'M' 'U' 'U' 'M' 'A' 'M' 'U' 'U' 'U' 'M' 'U' 'U' 'U' 'M' 'M' 'U'
 'M' 'U' 'A' 'U' 'U' 'M' 'A' 'U' 'U' 'U' 'M' 'U' 'U' 'U' 'M' 'M' 'A' 'M'
 'A' 'M' 'M' 'M' 'A' 'M' 'A' 'M' 'U' 'U' 'U' 'A' 'M' 'U' 'U' 'M' 'A' 'M'
 'A' 'M' 'U' 'M' 'U' 'A' 'A' 'A' 'A' 'A' 'A' 'A' 'A' 'U' 'A' 'U' 'U' 'A'
 'M' 'M' 'M' 'A' 'M' 'M' 'M' 'M' 'A' 'A' 'M' 'U' 'M' 'U' 'M' 'U' 'A' 'M'
 'M' 'M' 'U' 'A' 'M' 'M' 'A' 'U' 'M' 'U' 'U' 'M' 'A' 'U' 'M' 'U' 'M' 'A'
 'M' 'M' 'U' 'M' 'U' 'M' 'M' 'U' 'M' 'M' 'A' 'A' 'M' 'A' 'U' 'U' 'M' 'A']"
12901,2,136,52,84,62,1,0,"['A' 'M' 'U' 'A' 'A' 'U' 'A' 'M' 'A' 'U' 'A' 'U' 'U' 'M' 'U' 'U' 'M' 'U'
 'A' 'A' 'M' 'U' 'M' 'M' 'M' 'M' 'U' 'A' 'U' 'A' 'M' 'A' 'A' 'M' 'M' 'U'
 'U' 'A' 'A' 'M' 'M' 'A' 'A' 'A' 'U' 'M' 'M' 'A' 'M' 'A' 'A' 'U' 'M' 'M'
 'U' 'M' 'U' 'A' 'M' 'M' 'U' 'U' 'M' 'U' 'U' 'M' 'M' 'M' 'M' 'M' 'M' 'M'
 'U' 'M' 'M' 'U' 'M' 'M' 'A' 'M' 'M' 'U' 'U' 'M' 'U' 'U' 'M' 'M' 'U' 'M'
 'M' 'M' 'U' 'U' 'U' 'M' 'A' 'U' 'A' 'U' 'M' 'M' 'U' 'M' 'U' 'M' 'M' 'M'
 'A' 'M' 'U' 'U' 'A' 'U' 'A' 'M' 'U' 'M' 'U' 'A' 'M' 'U' 'U' 'M' 'A' 'M'
 'A' 'M' 'U' 'M' 'M' 'A' 'A' 'A' 'A' 'A' 'A' 'A' 'A' 'A' 'A' 'U' 'U' 'U'
 'M' 'M' 'M' 'U' 'U' 'M' 'U' 'M' 'A' 'A' 'M' 'A' 'M' 'U' 'M' 'U' 'A' 'M'
 'M' 'M' 'A' 'A' 'M' 'M' 'M' 'U' 'M' 'U' 'U' 'U' 'A' 'A' 'M' 'U' 'M' 'A'
 'M' 'M' 'U' 'M' 'U' 'M' 'M' 'U' 'M' 'U' 'U' 'U' 'M' 'A' 'A' 'M' 'M' 'A']"
13001,0,142,61,81,56,0,0,"['A' 'M' 'U' 'A' 'A' 'U' 'A' 'M' 'A' 'U' 'U' 'U' 'U' 'M' 'U' 'U' 'M' 'U'
 'A' 'A' 'M' 'U' 'M' 'M' 'M' 'M' 'M' 'A' 'A' 'A' 'M' 'A' 'A' 'M' 'U' 'U'
 'U' 'A' 'A' 'M' 'M' 'A' 'A' 'A' 'A' 'M' 'M' 'A' 'M' 'A' 'A' 'M' 'M' 'M'
 'U' 'M' 'M' 'A' 'M' 'M' 'A' 'U' 'M' 'M' 'U' 'M' 'U' 'M' 'M' 'M' 'M' 'M'
 'M' 'M' 'M' 'U' 'M' 'M' 'A' 'M' 'M' 'U' 'U' 'U' 'U' 'A' 'M' 'U' 'U' 'M'
 'M' 'U' 'U' 'U' 'A' 'M' 'A' 'M' 'A' 'M' 'M' 'M' 'U' 'M' 'M' 'M' 'M' 'M'
 'A' 'U' 'U' 'U' 'A' 'M' 'A' 'M' 'U' 'U' 'U' 'A' 'M' 'A' 'U' 'M' 'A' 'U'
 'A' 'U' 'A' 'M' 'M' 'A' 'A' 'A' 'A' 'A' 'A' 'U' 'A' 'A' 'A' 'U' 'A' 'A'
 'M' 'U' 'M' 'U' 'A' 'M' 'A' 'M' 'U' 'A' 'M' 'A' 'M' 'A' 'M' 'U' 'U' 'M'
 'U' 'U' 'A' 'A' 'M' 'M' 'M' 'U' 'M' 'M' 'U' 'U' 'A' 'A' 'M' 'U' 'U' 'A'
 'M' 'M' 'A' 'M' 'U' 'M' 'M' 'U' 'M' 'U' 'U' 'U' 'M' 'A' 'A' 'M' 'M' 'A']"
13101,0,128,59,69,70,0,1,"['A' 'U' 'U' 'U' 'A' 'M' 'A' 'M' 'A' 'U' 'M' 'M' 'U' 'M' 'U' 'M' 'U' 'U'
 'A' 'A' 'M' 'M' 'M' 'M' 'M' 'M' 'M' 'A' 'A' 'A' 'M' 'A' 'A' 'A' 'U' 'U'
 'A' 'U' 'A' 'M' 'M' 'A' 'A' 'A' 'U' 'M' 'M' 'A' 'M' 'A' 'A' 'M' 'M' 'U'
 'M' 'M' 'U' 'A' 'M' 'M' 'A' 'A' 'M' 'U' 'U' 'M' 'M' 'M' 'M' 'M' 'U' 'M'
 'M' 'M' 'M' 'M' 'M' 'M' 'A' 'M' 'M' 'U' 'U' 'A' 'U' 'A' 'M' 'U' 'U' 'M'
 'U' 'U' 'M' 'U' 'A' 'M' 'U' 'U' 'U' 'U' 'M' 'M' 'U' 'M' 'U' 'U' 'U' 'M'
 'U' 'U' 'U' 'U' 'U' 'M' 'A' 'M' 'U' 'U' 'A' 'A' 'M' 'A' 'A' 'U' 'A' 'M'
 'A' 'M' 'A' 'M' 'U' 'A' 'A' 'A' 'U' 'A' 'A' 'A' 'A' 'A' 'A' 'U' 'U' 'A'
 'M' 'U' 'M' 'U' 'A' 'U' 'A' 'M' 'A' 'A' 'M' 'U' 'M' 'A' 'M' 'U' 'M' 'M'
 'U' 'U' 'U' 'A' 'U' 'M' 'M' 'U' 'M' 'M' 'A' 'U' 'A' 'U' 'U' 'U' 'U' 'A'
 'U' 'A' 'U' 'U' 'U' 'U' 'M' 'U' 'A' 'U' 'U' 'U' 'M' 'A' 'A' 'M' 'U' 'A']"
13201,0,139,61,78,59,1,0,"['A' 'M' 'M' 'U' 'A' 'M' 'A' 'U' 'A' 'U' 'M' 'M' 'A' 'M' 'A' 'M' 'A' 'A'
 'A' 'A' 'M' 'M' 'M' 'U' 'U' 'U' 'M' 'A' 'A' 'A' 'M' 'A' 'A' 'A' 'U' 'U'
 'A' 'U' 'A' 'M' 'M' 'M' 'A' 'A' 'U' 'M' 'M' 'A' 'M' 'A' 'A' 'M' 'M' 'A'
 'M' 'M' 'M' 'U' 'M' 'M' 'A' 'A' 'M' 'M' 'U' 'M' 'M' 'M' 'M' 'M' 'M' 'M'
 'M' 'U' 'M' 'M' 'M' 'M' 'U' 'M' 'M' 'M' 'U' 'A' 'A' 'A' 'M' 'U' 'M' 'M'
 'U' 'A' 'M' 'U' 'A' 'M' 'U' 'M' 'U' 'M' 'M' 'M' 'U' 'M' 'U' 'U' 'U' 'M'
 'M' 'M' 'U' 'U' 'M' 'M' 'A' 'M' 'A' 'U' 'A' 'U' 'M' 'A' 'A' 'M' 'A' 'M'
 'U' 'U' 'U' 'M' 'U' 'A' 'A' 'A' 'A' 'A' 'A' 'A' 'A' 'A' 'U' 'A' 'U' 'A'
 'M' 'M' 'M' 'U' 'A' 'U' 'U' 'M' 'A' 'A' 'M' 'U' 'U' 'U' 'M' 'M' 'M' 'M'
 'U' 'U' 'U' 'A' 'U' 'U' 'M' 'U' 'U' 'M' 'A' 'U' 'A' 'U' 'U' 'U' 'U' 'A'
 'U' 'A' 'U' 'A' 'A' 'U' 'M' 'U' 'U' 'M' 'U' 'A' 'M' 'U' 'A' 'M' 'M' 'A']"
13301,4,135,57,78,63,1,0,"['A' 'M' 'U' 'U' 'A' 'M' 'A' 'U' 'A' 'U' 'M' 'M' 'A' 'M' 'A' 'M' 'A' 'U'
 'A' 'A' 'M' 'M' 'M' 'U' 'U' 'U' 'M' 'A' 'A' 'A' 'M' 'U' 'A' 'U' 'M' 'U'
 'U' 'U' 'A' 'M' 'M' 'M' 'A' 'A' 'A' 'U' 'M' 'A' 'U' 'U' 'A' 'M' 'M' 'A'
 'M' 'M' 'M' 'M' 'M' 'M' 'A' 'A' 'U' 'M' 'U' 'M' 'M' 'M' 'M' 'U' 'M' 'M'
 'M' 'M' 'M' 'M' 'M' 'M' 'U' 'M' 'M' 'M' 'U' 'U' 'A' 'A' 'M' 'A' 'M' 'M'
 'U' 'A' 'M' 'M' 'U' 'M' 'U' 'M' 'U' 'U' 'M' 'M' 'M' 'M' 'U' 'A' 'U' 'M'
 'M' 'M' 'U' 'U' 'M' 'U' 'A' 'M' 'A' 'A' 'U' 'M' 'U' 'A' 'A' 'M' 'A' 'M'
 'M' 'U' 'U' 'M' 'U' 'A' 'A' 'A' 'A' 'A' 'A' 'A' 'A' 'U' 'U' 'A' 'A' 'A'
 'M' 'M' 'M' 'U' 'A' 'U' 'U' 'M' 'A' 'U' 'U' 'U' 'U' 'M' 'A' 'M' 'M' 'M'
 'U' 'A' 'U' 'A' 'U' 'U' 'M' 'U' 'U' 'M' 'A' 'U' 'A' 'U' 'A' 'M' 'U' 'A'
 'U' 'U' 'M' 'U' 'A' 'U' 'M' 'U' 'M' 'M' 'U' 'A' 'M' 'U' 'A' 'U' 'M' 'A']"
13401,0,128,52,76,70,0,0,"['A' 'M' 'A' 'U' 'A' 'M' 'A' 'M' 'U' 'M' 'M' 'U' 'A' 'M' 'U' 'M' 'A' 'U'
 'A' 'A' 'M' 'M' 'U' 'U' 'U' 'U' 'M' 'A' 'A' 'A' 'M' 'A' 'U' 'U' 'M' 'U'
 'U' 'U' 'A' 'M' 'U' 'M' 'U' 'A' 'A' 'U' 'A' 'U' 'U' 'M' 'A' 'M' 'M' 'A'
 'M' 'U' 'M' 'M' 'U' 'M' 'A' 'A' 'U' 'M' 'U' 'M' 'M' 'M' 'M' 'M' 'M' 'M'
 'M' 'U' 'M' 'M' 'M' 'M' 'M' 'M' 'U' 'M' 'A' 'U' 'A' 'A' 'M' 'A' 'M' 'M'
 'M' 'U' 'M' 'M' 'U' 'U' 'M' 'U' 'U' 'U' 'U' 'M' 'M' 'M' 'U' 'U' 'U' 'U'
 'U' 'U' 'U' 'U' 'U' 'U' 'A' 'M' 'A' 'M' 'U' 'M' 'U' 'A' 'A' 'M' 'A' 'M'
 'M' 'A' 'M' 'M' 'M' 'A' 'A' 'A' 'A' 'A' 'A' 'A' 'A' 'U' 'U' 'A' 'A' 'A'
 'M' 'M' 'M' 'U' 'U' 'U' 'M' 'M' 'A' 'U' 'U' 'U' 'M' 'M' 'U' 'M' 'M' 'M'
 'U' 'U' 'U' 'U' 'U' 'M' 'M' 'U' 'U' 'M' 'A' 'U' 'A' 'M' 'A' 'M' 'U' 'A'
 'U' 'U' 'M' 'A' 'A' 'U' 'U' 'U' 'M' 'M' 'U' 'A' 'M' 'A' 'A' 'U' 'M' 'A']"
13501,0,125,47,78,73,0,0,"['A' 'M' 'U' 'U' 'A' 'M' 'U' 'M' 'U' 'M' 'M' 'A' 'A' 'M' 'U' 'M' 'A' 'U'
 'U' 'A' 'M' 'M' 'U' 'M' 'U' 'M' 'M' 'U' 'U' 'U' 'M' 'A' 'U' 'U' 'M' 'U'
 'U' 'U' 'A' 'M' 'A' 'U' 'U' 'A' 'U' 'A' 'A' 'M' 'U' 'M' 'A' 'M' 'M' 'A'
 'M' 'M' 'M' 'M' 'A' 'M' 'A' 'A' 'U' 'U' 'A' 'M' 'U' 'M' 'M' 'M' 'M' 'M'
 'M' 'M' 'M' 'M' 'U' 'M' 'M' 'M' 'U' 'M' 'A' 'U' 'A' 'A' 'M' 'A' 'M' 'M'
 'M' 'U' 'M' 'M' 'M' 'U' 'M' 'U' 'U' 'U' 'U' 'U' 'M' 'U' 'U' 'U' 'U' 'U'
 'U' 'A' 'U' 'U' 'A' 'U' 'A' 'M' 'A' 'M' 'U' 'M' 'M' 'A' 'A' 'M' 'A' 'M'
 'M' 'A' 'M' 'M' 'M' 'M' 'A' 'U' 'A' 'A' 'U' 'A' 'A' 'U' 'U' 'A' 'A' 'U'
 'M' 'U' 'M' 'U' 'U' 'U' 'U' 'U' 'A' 'M' 'U' 'U' 'M' 'M' 'U' 'U' 'M' 'M'
 'U' 'U' 'M' 'U' 'U' 'M' 'M' 'U' 'U' 'M' 'A' 'U' 'U' 'M' 'A' 'M' 'M' 'A'
 'U' 'M' 'M' 'A' 'U' 'A' 'U' 'U' 'M' 'M' 'U' 'A' 'U' 'A' 'A' 'M' 'M' 'A']"
13601,2,123,44,79,75,0,1,"['A' 'M' 'U' 'U' 'A' 'M' 'A' 'M' 'U' 'M' 'M' 'U' 'U' 'U' 'U' 'U' 'A' 'U'
 'U' 'A' 'M' 'M' 'U' 'U' 'U' 'M' 'M' 'U' 'U' 'M' 'M' 'A' 'U' 'U' 'U' 'A'
 'U' 'U' 'A' 'M' 'A' 'A' 'U' 'U' 'M' 'A' 'U' 'M' 'U' 'M' 'U' 'U' 'M' 'U'
 'M' 'M' 'M' 'M' 'U' 'M' 'A' 'M' 'U' 'A' 'U' 'M' 'M' 'M' 'M' 'M' 'M' 'M'
 'M' 'U' 'M' 'U' 'U' 'M' 'M' 'M' 'U' 'M' 'A' 'M' 'U' 'A' 'M' 'U' 'M' 'M'
 'U' 'U' 'M' 'U' 'M' 'A' 'M' 'U' 'U' 'U' 'M' 'M' 'M' 'M' 'U' 'U' 'U' 'U'
 'A' 'U' 'U' 'M' 'A' 'U' 'A' 'M' 'U' 'M' 'U' 'U' 'M' 'A' 'A' 'M' 'A' 'M'
 'M' 'A' 'U' 'M' 'M' 'A' 'A' 'A' 'A' 'A' 'A' 'A' 'A' 'U' 'M' 'A' 'A' 'U'
 'U' 'M' 'M' 'U' 'U' 'A' 'A' 'U' 'A' 'M' 'U' 'U' 'U' 'M' 'M' 'M' 'M' 'U'
 'U' 'U' 'M' 'M' 'U' 'M' 'M' 'U' 'U' 'M' 'A' 'U' 'U' 'M' 'A' 'M' 'M' 'A'
 'U' 'M' 'M' 'A' 'U' 'U' 'M' 'M' 'M' 'M' 'U' 'U' 'A' 'A' 'A' 'M' 'M' 'A']"
13701,0,114,40,74,84,1,0,"['A' 'M' 'M' 'U' 'U' 'M' 'A' 'U' 'U' 'M' 'M' 'U' 'U' 'U' 'A' 'M' 'A' 'U'
 'U' 'A' 'M' 'M' 'U' 'A' 'U' 'M' 'M' 'U' 'U' 'M' 'M' 'A' 'U' 'M' 'U' 'A'
 'U' 'U' 'A' 'M' 'U' 'A' 'U' 'M' 'U' 'A' 'M' 'M' 'A' 'M' 'U' 'U' 'M' 'U'
 'M' 'M' 'M' 'M' 'U' 'M' 'U' 'U' 'U' 'A' 'M' 'M' 'M' 'U' 'M' 'M' 'M' 'M'
 'M' 'M' 'M' 'U' 'U' 'U' 'U' 'U' 'U' 'M' 'A' 'U' 'U' 'A' 'M' 'U' 'U' 'U'
 'A' 'A' 'M' 'U' 'M' 'A' 'M' 'U' 'U' 'U' 'M' 'M' 'M' 'M' 'U' 'M' 'U' 'U'
 'A' 'U' 'U' 'M' 'U' 'U' 'A' 'M' 'U' 'M' 'U' 'U' 'M' 'A' 'U' 'M' 'U' 'M'
 'M' 'A' 'U' 'M' 'U' 'A' 'A' 'A' 'A' 'A' 'U' 'A' 'A' 'U' 'M' 'U' 'U' 'U'
 'U' 'M' 'M' 'M' 'A' 'U' 'A' 'U' 'A' 'M' 'A' 'U' 'U' 'M' 'M' 'M' 'U' 'U'
 'U' 'A' 'M' 'M' 'A' 'M' 'U' 'U' 'U' 'M' 'A' 'U' 'U' 'M' 'A' 'M' 'M' 'A'
 'U' 'U' 'U' 'U' 'U' 'U' 'M' 'U' 'M' 'M' 'M' 'U' 'A' 'A' 'M' 'M' 'M' 'U']"
13801,1,115,38,77,83,0,0,"['A' 'M' 'M' 'U' 'U' 'M' 'U' 'U' 'U' 'U' 'U' 'U' 'M' 'U' 'U' 'M' 'A' 'U'
 'M' 'U' 'M' 'M' 'U' 'A' 'U' 'M' 'M' 'U' 'U' 'U' 'M' 'A' 'M' 'M' 'M' 'U'
 'M' 'M' 'A' 'U' 'M' 'U' 'M' 'M' 'M' 'A' 'M' 'M' 'A' 'M' 'U' 'A' 'M' 'U'
 'U' 'M' 'M' 'U' 'A' 'M' 'A' 'U' 'U' 'U' 'M' 'M' 'M' 'M' 'M' 'U' 'M' 'M'
 'M' 'M' 'M' 'A' 'U' 'U' 'U' 'U' 'U' 'M' 'A' 'U' 'U' 'A' 'M' 'M' 'U' 'U'
 'A' 'U' 'M' 'M' 'M' 'A' 'M' 'U' 'U' 'U' 'M' 'A' 'M' 'M' 'U' 'M' 'U' 'U'
 'A' 'M' 'U' 'M' 'U' 'M' 'A' 'M' 'U' 'M' 'U' 'U' 'M' 'A' 'U' 'M' 'U' 'M'
 'M' 'A' 'U' 'M' 'M' 'A' 'A' 'A' 'A' 'A' 'A' 'U' 'A' 'A' 'M' 'U' 'U' 'U'
 'U' 'M' 'M' 'M' 'A' 'U' 'A' 'U' 'U' 'M' 'A' 'U' 'U' 'U' 'M' 'M' 'U' 'U'
 'U' 'A' 'M' 'M' 'A' 'M' 'U' 'U' 'A' 'M' 'U' 'U' 'U' 'U' 'A' 'M' 'M' 'A'
 'U' 'U' 'A' 'U' 'U' 'M' 'M' 'U' 'U' 'U' 'M' 'U' 'A' 'U' 'M' 'U' 'U' 'M']"
13901,2,117,40,77,81,0,1,"['A' 'M' 'M' 'M' 'U' 'M' 'U' 'U' 'M' 'U' 'U' 'M' 'M' 'U' 'M' 'M' 'U' 'U'
 'M' 'A' 'U' 'M' 'M' 'A' 'U' 'U' 'U' 'U' 'U' 'M' 'M' 'U' 'U' 'M' 'M' 'U'
 'M' 'M' 'A' 'U' 'M' 'M' 'M' 'M' 'M' 'A' 'M' 'M' 'A' 'M' 'U' 'A' 'U' 'M'
 'U' 'U' 'M' 'U' 'A' 'M' 'A' 'M' 'U' 'U' 'M' 'M' 'M' 'M' 'M' 'U' 'M' 'M'
 'M' 'M' 'M' 'A' 'U' 'U' 'U' 'A' 'U' 'M' 'A' 'U' 'U' 'U' 'M' 'M' 'M' 'U'
 'A' 'U' 'M' 'M' 'U' 'A' 'M' 'U' 'U' 'U' 'M' 'U' 'M' 'M' 'U' 'U' 'A' 'U'
 'U' 'M' 'M' 'M' 'U' 'U' 'A' 'M' 'U' 'U' 'U' 'U' 'M' 'A' 'U' 'M' 'U' 'M'
 'M' 'U' 'U' 'U' 'M' 'A' 'A' 'A' 'U' 'A' 'A' 'A' 'A' 'A' 'M' 'A' 'U' 'M'
 'U' 'M' 'U' 'U' 'U' 'U' 'A' 'U' 'A' 'M' 'A' 'U' 'U' 'M' 'M' 'M' 'M' 'U'
 'A' 'A' 'M' 'M' 'A' 'M' 'U' 'U' 'A' 'U' 'U' 'U' 'M' 'U' 'A' 'M' 'M' 'A'
 'U' 'A' 'U' 'U' 'A' 'U' 'M' 'U' 'U' 'U' 'U' 'A' 'A' 'A' 'M' 'M' 'U' 'M']"
14001,0,111,41,70,87,1,0,"['A' 'M' 'M' 'M' 'U' 'U' 'U' 'U' 'U' 'M' 'U' 'U' 'M' 'A' 'U' 'M' 'M' 'U'
 'U' 'A' 'U' 'M' 'M' 'A' 'U' 'U' 'A' 'U' 'U' 'M' 'M' 'U' 'U' 'M' 'M' 'U'
 'M' 'M' 'M' 'U' 'M' 'U' 'U' 'M' 'M' 'A' 'U' 'M' 'A' 'U' 'U' 'A' 'M' 'M'
 'U' 'U' 'M' 'U' 'A' 'M' 'A' 'M' 'U' 'U' 'M' 'M' 'M' 'M' 'M' 'M' 'M' 'U'
 'M' 'M' 'M' 'U' 'U' 'A' 'U' 'U' 'U' 'M' 'A' 'U' 'U' 'U' 'M' 'M' 'M' 'U'
 'U' 'U' 'M' 'M' 'A' 'U' 'M' 'U' 'U' 'U' 'M' 'U' 'U' 'M' 'U' 'U' 'A' 'U'
 'U' 'M' 'U' 'M' 'U' 'U' 'U' 'M' 'U' 'U' 'M' 'U' 'M' 'A' 'U' 'M' 'U' 'M'
 'M' 'U' 'A' 'A' 'M' 'A' 'A' 'A' 'A' 'A' 'A' 'A' 'A' 'U' 'U' 'A' 'U' 'U'
 'U' 'M' 'U' 'U' 'U' 'U' 'A' 'U' 'A' 'M' 'A' 'U' 'M' 'M' 'M' 'M' 'U' 'A'
 'A' 'A' 'M' 'U' 'A' 'M' 'A' 'U' 'U' 'U' 'U' 'M' 'M' 'U' 'U' 'U' 'M' 'U'
 'U' 'A' 'U' 'M' 'A' 'U' 'M' 'A' 'U' 'A' 'U' 'A' 'A' 'A' 'M' 'M' 'M' 'M']"
14101,0,127,44,83,71,0,0,"['A' 'U' 'M' 'U' 'M' 'U' 'U' 'U' 'U' 'M' 'U' 'U' 'M' 'U' 'U' 'M' 'U' 'U'
 'U' 'A' 'M' 'U' 'M' 'A' 'U' 'U' 'A' 'U' 'U' 'M' 'M' 'U' 'U' 'M' 'M' 'M'
 'M' 'M' 'M' 'M' 'M' 'M' 'U' 'M' 'M' 'A' 'A' 'M' 'U' 'U' 'M' 'A' 'M' 'M'
 'M' 'M' 'M' 'U' 'A' 'M' 'A' 'M' 'U' 'U' 'M' 'M' 'M' 'U' 'M' 'M' 'M' 'M'
 'M' 'M' 'M' 'A' 'U' 'A' 'U' 'U' 'U' 'M' 'A' 'U' 'U' 'M' 'M' 'A' 'M' 'M'
 'A' 'M' 'M' 'M' 'A' 'U' 'M' 'U' 'U' 'U' 'M' 'U' 'U' 'M' 'U' 'U' 'A' 'U'
 'U' 'M' 'U' 'M' 'U' 'U' 'U' 'M' 'U' 'U' 'M' 'U' 'M' 'A' 'M' 'M' 'U' 'M'
 'M' 'M' 'A' 'A' 'M' 'A' 'A' 'A' 'U' 'A' 'A' 'A' 'A' 'U' 'A' 'A' 'A' 'U'
 'U' 'M' 'A' 'U' 'U' 'U' 'A' 'M' 'A' 'M' 'A' 'U' 'M' 'M' 'M' 'M' 'U' 'A'
 'A' 'A' 'M' 'U' 'A' 'M' 'A' 'U' 'U' 'U' 'M' 'M' 'M' 'U' 'U' 'U' 'M' 'M'
 'A' 'A' 'U' 'M' 'A' 'U' 'M' 'U' 'M' 'A' 'U' 'A' 'A' 'M' 'M' 'M' 'M' 'M']"
14201,4,129,52,77,69,0,1,"['A' 'U' 'A' 'U' 'M' 'U' 'U' 'U' 'U' 'M' 'A' 'A' 'M' 'A' 'U' 'U' 'U' 'A'
 'U' 'U' 'M' 'U' 'M' 'U' 'U' 'U' 'A' 'U' 'U' 'U' 'M' 'U' 'U' 'M' 'M' 'M'
 'U' 'U' 'M' 'M' 'M' 'U' 'U' 'M' 'M' 'A' 'A' 'M' 'U' 'M' 'M' 'A' 'M' 'M'
 'M' 'M' 'M' 'M' 'A' 'M' 'A' 'A' 'A' 'U' 'M' 'M' 'M' 'M' 'U' 'M' 'M' 'M'
 'M' 'M' 'M' 'A' 'U' 'A' 'U' 'M' 'U' 'U' 'U' 'A' 'M' 'M' 'M' 'A' 'M' 'A'
 'A' 'M' 'M' 'M' 'A' 'U' 'M' 'U' 'U' 'U' 'U' 'M' 'U' 'M' 'U' 'A' 'A' 'M'
 'U' 'U' 'U' 'M' 'U' 'M' 'U' 'M' 'M' 'U' 'M' 'U' 'M' 'U' 'M' 'M' 'M' 'M'
 'M' 'M' 'A' 'U' 'M' 'A' 'A' 'A' 'A' 'A' 'A' 'A' 'A' 'M' 'A' 'A' 'A' 'A'
 'U' 'U' 'A' 'U' 'A' 'U' 'A' 'M' 'A' 'U' 'A' 'M' 'M' 'M' 'M' 'M' 'U' 'A'
 'U' 'U' 'M' 'U' 'A' 'U' 'A' 'U' 'U' 'U' 'M' 'U' 'U' 'A' 'A' 'U' 'M' 'M'
 'U' 'A' 'U' 'M' 'A' 'A' 'U' 'U' 'M' 'A' 'U' 'A' 'A' 'M' 'M' 'M' 'M' 'M']"
14301,2,125,50,75,73,0,0,"['A' 'U' 'A' 'U' 'M' 'U' 'U' 'A' 'U' 'U' 'A' 'A' 'M' 'A' 'U' 'U' 'U' 'A'
 'A' 'U' 'M' 'M' 'M' 'U' 'U' 'U' 'A' 'M' 'A' 'U' 'M' 'U' 'U' 'M' 'M' 'M'
 'U' 'U' 'M' 'M' 'M' 'U' 'M' 'M' 'A' 'A' 'U' 'M' 'U' 'U' 'M' 'A' 'M' 'M'
 'M' 'M' 'M' 'M' 'A' 'M' 'U' 'U' 'A' 'U' 'U' 'M' 'M' 'M' 'M' 'M' 'M' 'M'
 'M' 'M' 'U' 'U' 'U' 'A' 'M' 'M' 'U' 'U' 'U' 'A' 'M' 'M' 'M' 'A' 'M' 'A'
 'A' 'M' 'M' 'M' 'U' 'U' 'M' 'M' 'M' 'M' 'U' 'U' 'U' 'M' 'U' 'U' 'U' 'M'
 'U' 'A' 'A' 'M' 'U' 'M' 'U' 'M' 'M' 'U' 'U' 'U' 'U' 'A' 'M' 'M' 'M' 'M'
 'M' 'M' 'A' 'A' 'U' 'A' 'A' 'A' 'A' 'A' 'A' 'A' 'A' 'M' 'A' 'A' 'A' 'U'
 'U' 'A' 'A' 'U' 'U' 'U' 'A' 'M' 'A' 'U' 'A' 'M' 'U' 'M' 'M' 'U' 'U' 'A'
 'U' 'U' 'M' 'U' 'A' 'U' 'A' 'M' 'U' 'U' 'M' 'A' 'U' 'A' 'U' 'U' 'M' 'U'
 'M' 'U' 'U' 'M' 'A' 'A' 'U' 'U' 'M' 'A' 'M' 'A' 'U' 'M' 'U' 'M' 'M' 'M']"
14401,3,121,52,69,77,0,0,"['A' 'U' 'A' 'M' 'M' 'U' 'U' 'A' 'U' 'U' 'U' 'A' 'M' 'A' 'U' 'U' 'U' 'U'
 'A' 'M' 'M' 'M' 'M' 'U' 'M' 'U' 'A' 'M' 'A' 'U' 'M' 'U' 'U' 'M' 'U' 'M'
 'U' 'A' 'M' 'M' 'M' 'A' 'U' 'U' 'A' 'A' 'U' 'M' 'M' 'U' 'M' 'A' 'M' 'M'
 'M' 'M' 'M' 'M' 'A' 'M' 'U' 'U' 'A' 'U' 'U' 'M' 'M' 'M' 'M' 'M' 'M' 'M'
 'U' 'M' 'M' 'U' 'U' 'A' 'M' 'A' 'U' 'U' 'M' 'A' 'M' 'M' 'U' 'A' 'M' 'U'
 'A' 'M' 'U' 'M' 'U' 'M' 'M' 'U' 'M' 'M' 'A' 'U' 'A' 'U' 'A' 'U' 'U' 'M'
 'U' 'A' 'A' 'U' 'U' 'M' 'M' 'M' 'U' 'U' 'U' 'M' 'U' 'U' 'U' 'U' 'M' 'M'
 'M' 'M' 'U' 'A' 'U' 'A' 'A' 'A' 'A' 'A' 'A' 'A' 'A' 'M' 'A' 'A' 'A' 'U'
 'A' 'A' 'U' 'U' 'U' 'A' 'A' 'M' 'A' 'U' 'A' 'U' 'U' 'U' 'M' 'U' 'U' 'A'
 'M' 'U' 'U' 'A' 'A' 'M' 'A' 'M' 'A' 'U' 'M' 'A' 'U' 'A' 'U' 'U' 'M' 'U'
 'M' 'M' 'U' 'M' 'M' 'A' 'U' 'U' 'U' 'U' 'U' 'A' 'U' 'M' 'U' 'M' 'U' 'M']"
14501,2,118,50,68,80,0,0,"['A' 'U' 'A' 'M' 'U' 'U' 'M' 'U' 'A' 'U' 'U' 'U' 'M' 'A' 'U' 'U' 'A' 'U'
 'A' 'M' 'M' 'M' 'U' 'U' 'M' 'U' 'A' 'U' 'U' 'U' 'M' 'U' 'U' 'M' 'M' 'M'
 'U' 'A' 'M' 'U' 'M' 'A' 'U' 'M' 'A' 'A' 'U' 'U' 'M' 'U' 'M' 'M' 'M' 'U'
 'M' 'M' 'U' 'M' 'A' 'M' 'A' 'U' 'U' 'U' 'U' 'M' 'M' 'M' 'M' 'U' 'M' 'M'
 'M' 'M' 'M' 'U' 'U' 'A' 'M' 'U' 'U' 'U' 'M' 'A' 'M' 'M' 'U' 'A' 'U' 'A'
 'A' 'M' 'U' 'M' 'U' 'M' 'M' 'U' 'M' 'M' 'A' 'U' 'A' 'U' 'A' 'U' 'U' 'M'
 'M' 'A' 'A' 'U' 'U' 'M' 'M' 'M' 'M' 'U' 'U' 'M' 'U' 'U' 'U' 'U' 'M' 'M'
 'U' 'M' 'M' 'U' 'U' 'A' 'A' 'A' 'A' 'A' 'A' 'A' 'A' 'M' 'U' 'A' 'A' 'U'
 'A' 'A' 'U' 'U' 'U' 'A' 'A' 'M' 'A' 'U' 'A' 'M' 'U' 'U' 'M' 'U' 'A' 'A'
 'U' 'M' 'U' 'A' 'U' 'M' 'A' 'M' 'A' 'M' 'M' 'A' 'A' 'U' 'U' 'U' 'U' 'U'
 'U' 'M' 'U' 'M' 'M' 'A' 'U' 'U' 'M' 'U' 'A' 'U' 'U' 'M' 'A' 'M' 'A' 'M']"
14601,1,129,54,75,69,1,0,"['A' 'U' 'U' 'M' 'A' 'M' 'U' 'U' 'A' 'U' 'A' 'U' 'M' 'A' 'A' 'U' 'U' 'U'
 'U' 'M' 'M' 'M' 'U' 'U' 'M' 'U' 'A' 'U' 'A' 'U' 'M' 'M' 'A' 'M' 'M' 'M'
 'U' 'A' 'M' 'U' 'M' 'A' 'A' 'M' 'A' 'A' 'A' 'U' 'M' 'U' 'M' 'M' 'M' 'U'
 'M' 'M' 'U' 'M' 'A' 'M' 'A' 'M' 'U' 'U' 'A' 'M' 'M' 'M' 'U' 'M' 'M' 'M'
 'M' 'M' 'M' 'U' 'U' 'A' 'M' 'M' 'U' 'M' 'M' 'U' 'M' 'M' 'U' 'A' 'M' 'A'
 'A' 'M' 'U' 'M' 'M' 'M' 'M' 'M' 'M' 'M' 'A' 'U' 'U' 'U' 'U' 'U' 'A' 'U'
 'M' 'A' 'A' 'U' 'U' 'M' 'M' 'M' 'M' 'U' 'U' 'M' 'U' 'A' 'U' 'M' 'U' 'U'
 'U' 'M' 'M' 'U' 'U' 'A' 'A' 'A' 'A' 'A' 'A' 'A' 'A' 'M' 'M' 'A' 'A' 'U'
 'U' 'A' 'M' 'U' 'U' 'A' 'A' 'M' 'A' 'A' 'U' 'M' 'A' 'U' 'M' 'U' 'A' 'A'
 'U' 'M' 'A' 'U' 'U' 'M' 'U' 'U' 'A' 'M' 'M' 'A' 'A' 'A' 'U' 'U' 'U' 'U'
 'U' 'M' 'U' 'M' 'M' 'A' 'U' 'U' 'M' 'M' 'A' 'U' 'U' 'M' 'A' 'M' 'A' 'M']"
14701,3,121,47,74,77,1,0,"['A' 'U' 'U' 'M' 'A' 'M' 'U' 'U' 'A' 'U' 'U' 'A' 'M' 'U' 'M' 'U' 'M' 'U'
 'U' 'M' 'M' 'M' 'U' 'U' 'M' 'U' 'A' 'U' 'U' 'M' 'M' 'U' 'A' 'M' 'U' 'M'
 'U' 'U' 'M' 'U' 'M' 'A' 'A' 'M' 'A' 'A' 'A' 'U' 'U' 'M' 'M' 'M' 'M' 'U'
 'M' 'A' 'U' 'M' 'U' 'M' 'A' 'U' 'U' 'U' 'U' 'M' 'M' 'M' 'M' 'U' 'M' 'M'
 'M' 'M' 'M' 'U' 'U' 'A' 'M' 'U' 'A' 'M' 'M' 'U' 'U' 'M' 'A' 'M' 'U' 'A'
 'A' 'M' 'U' 'M' 'U' 'M' 'M' 'M' 'M' 'M' 'A' 'A' 'U' 'U' 'U' 'U' 'A' 'U'
 'M' 'A' 'U' 'U' 'A' 'M' 'M' 'M' 'M' 'M' 'U' 'M' 'M' 'A' 'U' 'M' 'U' 'U'
 'M' 'U' 'U' 'U' 'U' 'A' 'A' 'A' 'A' 'A' 'A' 'A' 'A' 'M' 'M' 'A' 'U' 'U'
 'U' 'A' 'M' 'U' 'M' 'A' 'A' 'M' 'U' 'U' 'U' 'M' 'A' 'U' 'M' 'U' 'U' 'A'
 'U' 'M' 'U' 'M' 'U' 'M' 'M' 'U' 'A' 'U' 'M' 'U' 'A' 'A' 'U' 'U' 'U' 'M'
 'A' 'U' 'U' 'M' 'M' 'A' 'U' 'M' 'U' 'M' 'A' 'U' 'A' 'M' 'A' 'M' 'A' 'M']"
14801,1,120,43,77,78,1,0,"['A' 'U' 'U' 'M' 'A' 'M' 'U' 'U' 'A' 'U' 'U' 'A' 'U' 'U' 'M' 'U' 'M' 'A'
 'M' 'M' 'M' 'M' 'U' 'U' 'U' 'U' 'A' 'U' 'U' 'M' 'M' 'U' 'A' 'U' 'U' 'M'
 'U' 'U' 'M' 'U' 'M' 'U' 'U' 'M' 'A' 'M' 'U' 'M' 'U' 'M' 'M' 'U' 'M' 'A'
 'M' 'U' 'U' 'M' 'U' 'M' 'A' 'M' 'U' 'U' 'U' 'M' 'M' 'U' 'M' 'M' 'M' 'M'
 'M' 'M' 'M' 'U' 'U' 'A' 'M' 'U' 'U' 'M' 'M' 'U' 'M' 'M' 'U' 'M' 'U' 'A'
 'A' 'U' 'U' 'U' 'A' 'M' 'M' 'M' 'M' 'U' 'A' 'A' 'U' 'U' 'U' 'M' 'A' 'M'
 'M' 'A' 'U' 'U' 'A' 'M' 'M' 'M' 'M' 'M' 'A' 'M' 'M' 'U' 'U' 'M' 'U' 'M'
 'M' 'A' 'U' 'U' 'U' 'A' 'A' 'A' 'A' 'A' 'A' 'A' 'A' 'M' 'M' 'A' 'U' 'U'
 'U' 'U' 'M' 'U' 'M' 'A' 'U' 'U' 'U' 'U' 'U' 'M' 'A' 'U' 'U' 'U' 'U' 'A'
 'A' 'U' 'U' 'U' 'U' 'M' 'M' 'M' 'A' 'M' 'M' 'U' 'A' 'A' 'U' 'M' 'M' 'M'
 'M' 'U' 'U' 'M' 'M' 'A' 'U' 'M' 'M' 'M' 'A' 'A' 'A' 'M' 'A' 'M' 'A' 'M']"
14901,2,120,45,75,78,1,0,"['A' 'U' 'A' 'M' 'A' 'M' 'U' 'A' 'A' 'A' 'U' 'U' 'U' 'U' 'M' 'U' 'M' 'U'
 'U' 'M' 'M' 'M' 'M' 'U' 'A' 'U' 'A' 'U' 'U' 'M' 'U' 'U' 'A' 'U' 'U' 'M'
 'M' 'U' 'M' 'U' 'U' 'U' 'M' 'M' 'A' 'U' 'A' 'M' 'U' 'M' 'M' 'M' 'M' 'U'
 'M' 'M' 'U' 'M' 'U' 'M' 'A' 'M' 'U' 'U' 'A' 'U' 'M' 'M' 'M' 'M' 'M' 'M'
 'M' 'M' 'M' 'U' 'U' 'A' 'M' 'U' 'U' 'M' 'M' 'U' 'M' 'U' 'U' 'M' 'A' 'U'
 'A' 'A' 'M' 'U' 'M' 'M' 'M' 'M' 'M' 'U' 'A' 'U' 'A' 'M' 'U' 'M' 'A' 'U'
 'U' 'U' 'U' 'U' 'A' 'M' 'U' 'M' 'M' 'M' 'U' 'U' 'U' 'U' 'U' 'M' 'U' 'M'
 'M' 'A' 'U' 'U' 'A' 'A' 'A' 'A' 'A' 'A' 'A' 'A' 'A' 'M' 'M' 'U' 'U' 'A'
 'A' 'U' 'M' 'M' 'M' 'A' 'U' 'M' 'U' 'U' 'U' 'M' 'A' 'A' 'U' 'U' 'U' 'A'
 'U' 'A' 'M' 'U' 'U' 'U' 'U' 'M' 'U' 'M' 'M' 'M' 'A' 'U' 'A' 'M' 'M' 'M'
 'M' 'U' 'U' 'M' 'M' 'A' 'U' 'M' 'M' 'U' 'U' 'A' 'A' 'M' 'A' 'U' 'A' 'M']"
15001,2,123,43,80,75,0,0,"['A' 'U' 'U' 'M' 'A' 'M' 'U' 'A' 'A' 'U' 'U' 'U' 'U' 'M' 'M' 'U' 'A' 'U'
 'U' 'U' 'M' 'M' 'M' 'U' 'A' 'U' 'A' 'U' 'U' 'M' 'U' 'U' 'U' 'U' 'A' 'M'
 'M' 'U' 'M' 'U' 'M' 'U' 'M' 'M' 'U' 'U' 'A' 'M' 'U' 'U' 'M' 'M' 'M' 'U'
 'M' 'M' 'M' 'M' 'U' 'M' 'U' 'M' 'U' 'U' 'A' 'M' 'M' 'M' 'M' 'M' 'M' 'M'
 'M' 'U' 'M' 'M' 'A' 'A' 'M' 'U' 'U' 'M' 'M' 'M' 'M' 'U' 'M' 'M' 'U' 'U'
 'A' 'A' 'M' 'U' 'M' 'M' 'M' 'M' 'M' 'A' 'A' 'U' 'U' 'M' 'U' 'U' 'A' 'U'
 'U' 'U' 'U' 'U' 'U' 'M' 'U' 'M' 'U' 'M' 'U' 'M' 'U' 'U' 'A' 'M' 'U' 'M'
 'M' 'A' 'M' 'A' 'A' 'U' 'A' 'A' 'A' 'A' 'A' 'A' 'A' 'M' 'M' 'U' 'M' 'A'
 'A' 'A' 'U' 'M' 'M' 'A' 'U' 'M' 'M' 'U' 'U' 'M' 'A' 'A' 'U' 'U' 'U' 'A'
 'U' 'A' 'M' 'A' 'M' 'M' 'U' 'M' 'U' 'M' 'M' 'M' 'A' 'U' 'A' 'M' 'M' 'M'
 'M' 'U' 'U' 'M' 'M' 'A' 'U' 'U' 'M' 'U' 'U' 'A' 'M' 'U' 'A' 'A' 'U' 'M']"
15101,1,123,44,79,75,0,0,"['A' 'U' 'U' 'U' 'A' 'U' 'U' 'A' 'A' 'U' 'U' 'A' 'U' 'U' 'M' 'M' 'A' 'M'
 'A' 'U' 'M' 'M' 'M' 'U' 'A' 'M' 'A' 'U' 'U' 'M' 'U' 'U' 'A' 'M' 'A' 'U'
 'M' 'U' 'M' 'U' 'M' 'U' 'M' 'M' 'U' 'A' 'A' 'M' 'U' 'U' 'M' 'M' 'M' 'M'
 'M' 'M' 'M' 'U' 'U' 'M' 'U' 'M' 'U' 'U' 'A' 'M' 'M' 'M' 'M' 'U' 'M' 'M'
 'M' 'M' 'M' 'M' 'M' 'A' 'M' 'U' 'U' 'U' 'M' 'M' 'A' 'U' 'M' 'M' 'U' 'U'
 'A' 'A' 'M' 'U' 'M' 'U' 'M' 'M' 'M' 'A' 'A' 'U' 'U' 'M' 'U' 'U' 'A' 'A'
 'U' 'U' 'U' 'U' 'M' 'U' 'U' 'M' 'M' 'M' 'U' 'M' 'U' 'U' 'A' 'M' 'U' 'U'
 'M' 'A' 'M' 'A' 'A' 'A' 'A' 'A' 'U' 'A' 'A' 'A' 'A' 'M' 'M' 'U' 'A' 'A'
 'A' 'A' 'A' 'M' 'M' 'U' 'U' 'M' 'U' 'U' 'U' 'M' 'U' 'A' 'M' 'U' 'U' 'A'
 'M' 'A' 'M' 'U' 'M' 'M' 'U' 'M' 'M' 'U' 'M' 'M' 'A' 'U' 'U' 'U' 'U' 'M'
 'M' 'A' 'U' 'M' 'U' 'U' 'M' 'M' 'M' 'M' 'U' 'A' 'M' 'U' 'U' 'U' 'M' 'M']"
15201,2,120,49,71,78,0,1,"['A' 'U' 'U' 'U' 'A' 'U' 'U' 'A' 'A' 'U' 'U' 'A' 'A' 'A' 'M' 'M' 'U' 'M'
 'A' 'M' 'M' 'M' 'M' 'M' 'A' 'M' 'A' 'U' 'U' 'M' 'U' 'U' 'U' 'U' 'A' 'U'
 'U' 'U' 'M' 'U' 'M' 'U' 'U' 'U' 'A' 'U' 'U' 'U' 'U' 'U' 'M' 'M' 'M' 'U'
 'U' 'M' 'U' 'U' 'U' 'M' 'U' 'M' 'U' 'U' 'A' 'M' 'M' 'M' 'M' 'M' 'M' 'M'
 'U' 'M' 'M' 'M' 'M' 'A' 'M' 'U' 'U' 'A' 'M' 'M' 'U' 'U' 'M' 'M' 'U' 'U'
 'A' 'A' 'U' 'M' 'M' 'U' 'M' 'M' 'M' 'A' 'A' 'A' 'U' 'M' 'U' 'U' 'A' 'A'
 'U' 'U' 'A' 'U' 'U' 'U' 'M' 'M' 'M' 'M' 'U' 'U' 'U' 'M' 'A' 'U' 'U' 'U'
 'M' 'A' 'M' 'A' 'A' 'A' 'A' 'A' 'A' 'A' 'A' 'U' 'A' 'M' 'U' 'U' 'A' 'A'
 'A' 'U' 'A' 'M' 'U' 'M' 'A' 'M' 'U' 'U' 'U' 'M' 'U' 'A' 'M' 'M' 'U' 'A'
 'U' 'A' 'M' 'U' 'U' 'M' 'A' 'U' 'A' 'M' 'M' 'M' 'A' 'U' 'U' 'U' 'M' 'M'
 'M' 'A' 'U' 'M' 'M' 'U' 'M' 'M' 'M' 'M' 'A' 'A' 'M' 'U' 'U' 'A' 'M' 'M']"
15301,1,131,54,77,67,0,0,"['A' 'U' 'U' 'A' 'U' 'A' 'M' 'A' 'A' 'M' 'A' 'A' 'A' 'A' 'M' 'M' 'U' 'M'
 'A' 'M' 'M' 'M' 'M' 'M' 'U' 'M' 'M' 'U' 'U' 'M' 'A' 'U' 'U' 'U' 'U' 'U'
 'M' 'U' 'A' 'U' 'M' 'U' 'U' 'U' 'A' 'U' 'M' 'U' 'U' 'U' 'M' 'U' 'M' 'A'
 'U' 'M' 'U' 'U' 'U' 'M' 'U' 'M' 'A' 'A' 'A' 'M' 'M' 'M' 'U' 'M' 'M' 'M'
 'M' 'M' 'M' 'U' 'M' 'U' 'U' 'U' 'U' 'A' 'M' 'M' 'U' 'M' 'M' 'M' 'U' 'A'
 'A' 'A' 'M' 'M' 'U' 'U' 'M' 'M' 'M' 'A' 'A' 'A' 'U' 'M' 'U' 'M' 'M' 'A'
 'U' 'U' 'A' 'U' 'M' 'U' 'M' 'M' 'M' 'M' 'M' 'A' 'U' 'U' 'A' 'U' 'A' 'M'
 'M' 'A' 'M' 'A' 'U' 'A' 'A' 'A' 'A' 'A' 'A' 'A' 'A' 'M' 'M' 'U' 'U' 'A'
 'M' 'A' 'A' 'M' 'U' 'M' 'A' 'M' 'U' 'U' 'U' 'M' 'U' 'A' 'M' 'M' 'U' 'U'
 'M' 'A' 'U' 'U' 'U' 'M' 'A' 'U' 'U' 'M' 'A' 'U' 'A' 'A' 'U' 'U' 'M' 'M'
 'U' 'A' 'U' 'M' 'M' 'M' 'M' 'M' 'M' 'M' 'A' 'A' 'M' 'A' 'U' 'A' 'M' 'M']"
15401,2,123,50,73,75,0,0,"['A' 'U' 'U' 'A' 'A' 'U' 'U' 'U' 'A' 'M' 'A' 'A' 'A' 'A' 'M' 'M' 'U' 'U'
 'U' 'U' 'U' 'M' 'M' 'M' 'U' 'U' 'M' 'M' 'M' 'M' 'U' 'U' 'U' 'U' 'M' 'M'
 'M' 'U' 'A' 'U' 'M' 'A' 'U' 'M' 'A' 'A' 'M' 'U' 'U' 'U' 'U' 'U' 'M' 'A'
 'U' 'M' 'U' 'M' 'M' 'M' 'U' 'M' 'A' 'U' 'A' 'M' 'M' 'M' 'U' 'M' 'M' 'M'
 'M' 'M' 'M' 'U' 'U' 'U' 'U' 'U' 'M' 'A' 'M' 'M' 'A' 'M' 'M' 'M' 'M' 'U'
 'A' 'A' 'U' 'M' 'A' 'U' 'M' 'M' 'M' 'A' 'A' 'A' 'U' 'U' 'M' 'M' 'M' 'A'
 'U' 'U' 'A' 'U' 'M' 'U' 'M' 'M' 'U' 'M' 'U' 'U' 'U' 'U' 'A' 'U' 'U' 'M'
 'M' 'A' 'M' 'A' 'U' 'A' 'A' 'A' 'A' 'A' 'A' 'A' 'A' 'M' 'M' 'U' 'U' 'U'
 'M' 'A' 'A' 'M' 'U' 'M' 'A' 'M' 'U' 'U' 'U' 'U' 'A' 'A' 'U' 'M' 'U' 'A'
 'M' 'A' 'U' 'U' 'U' 'M' 'A' 'M' 'U' 'M' 'A' 'U' 'A' 'U' 'U' 'U' 'M' 'M'
 'A' 'A' 'U' 'M' 'U' 'M' 'M' 'M' 'M' 'M' 'U' 'A' 'U' 'U' 'U' 'A' 'M' 'M']"
15501,2,121,51,70,77,0,1,"['A' 'U' 'U' 'A' 'A' 'U' 'U' 'U' 'A' 'U' 'A' 'A' 'A' 'A' 'M' 'M' 'A' 'M'
 'A' 'U' 'A' 'M' 'M' 'M' 'M' 'U' 'M' 'M' 'M' 'M' 'U' 'U' 'U' 'U' 'M' 'U'
 'M' 'M' 'U' 'M' 'U' 'U' 'U' 'U' 'A' 'A' 'M' 'U' 'U' 'U' 'U' 'A' 'M' 'A'
 'M' 'M' 'U' 'M' 'M' 'M' 'U' 'U' 'A' 'M' 'A' 'M' 'M' 'M' 'U' 'M' 'M' 'M'
 'M' 'M' 'M' 'U' 'U' 'U' 'U' 'U' 'U' 'A' 'M' 'M' 'A' 'M' 'U' 'M' 'M' 'M'
 'A' 'A' 'U' 'U' 'A' 'U' 'M' 'M' 'M' 'A' 'A' 'U' 'U' 'U' 'M' 'U' 'M' 'A'
 'U' 'U' 'A' 'U' 'M' 'U' 'M' 'M' 'U' 'M' 'U' 'A' 'U' 'A' 'A' 'U' 'U' 'M'
 'M' 'A' 'A' 'A' 'U' 'A' 'A' 'A' 'A' 'A' 'A' 'U' 'A' 'M' 'M' 'U' 'U' 'U'
 'U' 'U' 'A' 'M' 'U' 'M' 'U' 'M' 'U' 'U' 'A' 'U' 'A' 'A' 'U' 'M' 'U' 'A'
 'M' 'A' 'U' 'U' 'U' 'M' 'A' 'M' 'U' 'M' 'A' 'U' 'A' 'U' 'M' 'U' 'M' 'M'
 'A' 'U' 'U' 'M' 'U' 'M' 'U' 'M' 'M' 'M' 'U' 'A' 'A' 'U' 'M' 'U' 'M' 'M']"
15601,1,128,56,72,70,0,0,"['A' 'U' 'U' 'A' 'A' 'M' 'U' 'U' 'A' 'A' 'A' 'A' 'A' 'A' 'M' 'U' 'A' 'M'
 'A' 'U' 'U' 'M' 'M' 'M' 'U' 'A' 'M' 'M' 'M' 'M' 'M' 'M' 'U' 'M' 'M' 'A'
 'M' 'M' 'A' 'M' 'U' 'A' 'A' 'U' 'A' 'A' 'U' 'U' 'U' 'U' 'U' 'U' 'M' 'U'
 'M' 'U' 'M' 'M' 'M' 'M' 'U' 'U' 'A' 'M' 'A' 'M' 'M' 'M' 'M' 'M' 'M' 'M'
 'M' 'U' 'M' 'U' 'M' 'U' 'U' 'U' 'U' 'A' 'U' 'M' 'A' 'M' 'U' 'M' 'M' 'M'
 'A' 'A' 'U' 'U' 'A' 'U' 'U' 'M' 'M' 'A' 'A' 'M' 'U' 'A' 'M' 'U' 'M' 'A'
 'U' 'U' 'A' 'U' 'M' 'U' 'M' 'U' 'U' 'M' 'U' 'U' 'U' 'A' 'A' 'U' 'U' 'M'
 'M' 'A' 'A' 'A' 'U' 'A' 'A' 'A' 'A' 'A' 'A' 'A' 'A' 'M' 'M' 'U' 'U' 'A'
 'U' 'U' 'A' 'M' 'U' 'M' 'M' 'M' 'U' 'U' 'U' 'M' 'A' 'A' 'A' 'M' 'A' 'M'
 'M' 'A' 'U' 'U' 'U' 'M' 'A' 'M' 'U' 'M' 'A' 'U' 'A' 'U' 'M' 'M' 'M' 'M'
 'A' 'U' 'U' 'M' 'U' 'M' 'U' 'M' 'U' 'U' 'U' 'A' 'A' 'U' 'M' 'U' 'M' 'M']"
15701,0,124,59,65,74,0,0,"['A' 'U' 'A' 'A' 'A' 'U' 'A' 'M' 'A' 'A' 'A' 'A' 'U' 'A' 'M' 'U' 'A' 'U'
 'A' 'M' 'U' 'M' 'U' 'U' 'A' 'A' 'A' 'M' 'M' 'M' 'M' 'M' 'U' 'U' 'U' 'A'
 'M' 'U' 'A' 'M' 'U' 'A' 'A' 'U' 'A' 'A' 'U' 'U' 'U' 'A' 'U' 'U' 'M' 'U'
 'M' 'U' 'M' 'A' 'U' 'M' 'A' 'M' 'U' 'M' 'A' 'M' 'M' 'M' 'M' 'M' 'M' 'M'
 'M' 'U' 'M' 'U' 'M' 'U' 'U' 'U' 'U' 'U' 'U' 'A' 'U' 'M' 'U' 'M' 'M' 'U'
 'A' 'U' 'U' 'U' 'M' 'U' 'U' 'M' 'M' 'A' 'A' 'M' 'U' 'A' 'M' 'U' 'U' 'A'
 'U' 'U' 'A' 'U' 'M' 'M' 'M' 'U' 'A' 'M' 'A' 'U' 'M' 'A' 'A' 'M' 'U' 'M'
 'M' 'A' 'U' 'A' 'U' 'U' 'A' 'A' 'A' 'A' 'A' 'A' 'A' 'M' 'M' 'A' 'M' 'A'
 'M' 'U' 'U' 'M' 'M' 'M' 'M' 'M' 'U' 'U' 'A' 'M' 'A' 'U' 'A' 'U' 'U' 'U'
 'M' 'A' 'U' 'U' 'M' 'U' 'A' 'M' 'U' 'M' 'A' 'U' 'A' 'U' 'M' 'M' 'M' 'M'
 'A' 'U' 'A' 'M' 'U' 'M' 'U' 'U' 'A' 'U' 'U' 'A' 'A' 'U' 'U' 'U' 'M' 'M']"
15801,0,118,59,59,80,0,1,"['A' 'U' 'A' 'A' 'A' 'U' 'A' 'M' 'A' 'A' 'U' 'A' 'U' 'U' 'M' 'U' 'A' 'U'
 'A' 'U' 'U' 'M' 'U' 'U' 'A' 'A' 'A' 'M' 'M' 'U' 'A' 'M' 'U' 'U' 'M' 'A'
 'U' 'U' 'A' 'M' 'M' 'A' 'U' 'U' 'A' 'A' 'U' 'U' 'U' 'U' 'U' 'U' 'U' 'U'
 'M' 'U' 'M' 'A' 'U' 'M' 'U' 'M' 'M' 'M' 'U' 'M' 'M' 'M' 'M' 'M' 'U' 'M'
 'M' 'M' 'M' 'U' 'M' 'U' 'A' 'U' 'U' 'U' 'U' 'A' 'A' 'U' 'A' 'M' 'M' 'A'
 'A' 'U' 'U' 'U' 'M' 'U' 'U' 'U' 'M' 'A' 'U' 'M' 'U' 'U' 'M' 'U' 'M' 'A'
 'U' 'U' 'A' 'U' 'M' 'M' 'M' 'M' 'U' 'M' 'A' 'A' 'M' 'A' 'A' 'U' 'U' 'M'
 'M' 'A' 'U' 'A' 'U' 'A' 'A' 'A' 'A' 'A' 'A' 'U' 'A' 'M' 'M' 'A' 'M' 'A'
 'M' 'A' 'U' 'U' 'M' 'M' 'U' 'M' 'U' 'A' 'U' 'A' 'A' 'U' 'A' 'U' 'U' 'U'
 'U' 'A' 'U' 'U' 'U' 'A' 'U' 'M' 'U' 'M' 'M' 'U' 'A' 'A' 'M' 'M' 'M' 'M'
 'A' 'M' 'U' 'M' 'U' 'M' 'U' 'U' 'A' 'U' 'U' 'A' 'A' 'A' 'U' 'A' 'M' 'M']"
15901,0,126,65,61,72,0,0,"['A' 'U' 'U' 'A' 'A' 'A' 'A' 'M' 'A' 'A' 'U' 'U' 'M' 'U' 'M' 'U' 'A' 'U'
 'U' 'A' 'U' 'M' 'M' 'A' 'U' 'A' 'A' 'M' 'M' 'U' 'U' 'M' 'U' 'U' 'M' 'A'
 'M' 'A' 'A' 'A' 'U' 'A' 'U' 'U' 'U' 'A' 'A' 'U' 'A' 'U' 'A' 'U' 'U' 'U'
 'M' 'U' 'U' 'A' 'U' 'M' 'U' 'M' 'M' 'M' 'A' 'M' 'M' 'M' 'M' 'M' 'M' 'M'
 'M' 'M' 'U' 'U' 'M' 'M' 'A' 'A' 'M' 'A' 'U' 'A' 'U' 'M' 'A' 'U' 'M' 'A'
 'A' 'U' 'U' 'U' 'M' 'U' 'U' 'A' 'M' 'A' 'U' 'M' 'U' 'M' 'M' 'U' 'M' 'A'
 'U' 'U' 'A' 'U' 'M' 'M' 'M' 'M' 'A' 'M' 'A' 'M' 'M' 'A' 'U' 'M' 'U' 'M'
 'M' 'A' 'U' 'U' 'U' 'A' 'A' 'A' 'A' 'U' 'A' 'A' 'A' 'U' 'M' 'A' 'M' 'A'
 'U' 'U' 'U' 'U' 'M' 'M' 'A' 'M' 'M' 'A' 'U' 'A' 'U' 'U' 'A' 'U' 'U' 'A'
 'M' 'A' 'U' 'U' 'U' 'U' 'U' 'M' 'A' 'M' 'M' 'A' 'A' 'U' 'M' 'M' 'M' 'M'
 'A' 'M' 'A' 'U' 'A' 'U' 'A' 'U' 'A' 'U' 'U' 'A' 'A' 'A' 'U' 'A' 'U' 'M']"
16001,2,126,63,63,72,0,0,"['A' 'U' 'A' 'A' 'U' 'A' 'A' 'M' 'U' 'A' 'U' 'U' 'M' 'A' 'M' 'U' 'A' 'A'
 'M' 'U' 'U' 'M' 'M' 'A' 'U' 'A' 'A' 'M' 'M' 'M' 'A' 'M' 'M' 'U' 'M' 'A'
 'M' 'A' 'A' 'A' 'U' 'A' 'U' 'U' 'U' 'A' 'A' 'U' 'A' 'M' 'A' 'U' 'A' 'U'
 'A' 'U' 'U' 'A' 'M' 'M' 'U' 'M' 'M' 'U' 'A' 'M' 'M' 'M' 'U' 'M' 'M' 'M'
 'M' 'M' 'M' 'U' 'U' 'M' 'A' 'A' 'U' 'A' 'U' 'A' 'U' 'M' 'A' 'U' 'M' 'A'
 'A' 'M' 'U' 'U' 'M' 'U' 'U' 'U' 'M' 'U' 'M' 'M' 'A' 'M' 'M' 'U' 'M' 'A'
 'M' 'A' 'A' 'U' 'U' 'M' 'M' 'M' 'A' 'M' 'U' 'U' 'U' 'U' 'U' 'M' 'M' 'U'
 'M' 'A' 'A' 'U' 'U' 'A' 'A' 'A' 'A' 'A' 'A' 'A' 'A' 'U' 'M' 'M' 'M' 'A'
 'U' 'M' 'A' 'U' 'M' 'M' 'A' 'M' 'M' 'A' 'U' 'A' 'A' 'U' 'A' 'M' 'M' 'A'
 'M' 'U' 'U' 'U' 'U' 'U' 'U' 'M' 'A' 'M' 'M' 'A' 'U' 'U' 'U' 'M' 'U' 'M'
 'U' 'U' 'A' 'U' 'A' 'U' 'U' 'U' 'A' 'U' 'U' 'U' 'A' 'U' 'U' 'A' 'U' 'M']"
16101,3,118,64,54,80,1,0,"['A' 'U' 'U' 'U' 'U' 'A' 'A' 'M' 'U' 'A' 'U' 'U' 'M' 'U' 'M' 'M' 'U' 'A'
 'M' 'A' 'A' 'M' 'U' 'A' 'U' 'A' 'A' 'M' 'M' 'M' 'A' 'A' 'M' 'M' 'U' 'A'
 'U' 'A' 'A' 'A' 'U' 'A' 'U' 'U' 'M' 'A' 'A' 'A' 'A' 'M' 'U' 'A' 'A' 'U'
 'A' 'A' 'U' 'A' 'M' 'M' 'U' 'M' 'U' 'A' 'A' 'M' 'M' 'M' 'M' 'M' 'M' 'M'
 'U' 'M' 'M' 'U' 'U' 'M' 'A' 'U' 'U' 'U' 'M' 'A' 'U' 'M' 'A' 'U' 'M' 'U'
 'A' 'M' 'U' 'U' 'M' 'U' 'U' 'U' 'U' 'U' 'U' 'M' 'A' 'U' 'M' 'U' 'U' 'A'
 'M' 'A' 'A' 'A' 'U' 'U' 'M' 'M' 'A' 'U' 'U' 'U' 'U' 'U' 'A' 'M' 'M' 'U'
 'U' 'A' 'M' 'M' 'U' 'A' 'A' 'A' 'A' 'A' 'A' 'A' 'U' 'U' 'M' 'U' 'M' 'U'
 'U' 'M' 'A' 'U' 'M' 'M' 'A' 'M' 'M' 'A' 'U' 'A' 'A' 'A' 'U' 'M' 'U' 'A'
 'M' 'U' 'A' 'U' 'U' 'U' 'U' 'U' 'A' 'M' 'M' 'U' 'U' 'U' 'U' 'U' 'M' 'M'
 'A' 'U' 'A' 'U' 'A' 'A' 'U' 'U' 'A' 'U' 'U' 'U' 'A' 'A' 'U' 'A' 'U' 'M']"
16201,2,117,58,59,81,0,1,"['A' 'U' 'U' 'U' 'U' 'A' 'M' 'M' 'U' 'A' 'U' 'U' 'M' 'U' 'M' 'M' 'U' 'U'
 'M' 'A' 'A' 'M' 'U' 'U' 'U' 'U' 'A' 'M' 'M' 'M' 'A' 'A' 'U' 'M' 'U' 'U'
 'U' 'A' 'A' 'A' 'U' 'A' 'U' 'U' 'M' 'A' 'A' 'U' 'A' 'M' 'U' 'A' 'A' 'U'
 'U' 'A' 'U' 'A' 'M' 'M' 'U' 'M' 'U' 'A' 'U' 'M' 'M' 'M' 'M' 'M' 'M' 'M'
 'M' 'M' 'U' 'U' 'M' 'M' 'U' 'U' 'U' 'U' 'M' 'M' 'U' 'M' 'A' 'U' 'A' 'A'
 'U' 'M' 'U' 'U' 'U' 'U' 'A' 'A' 'A' 'A' 'U' 'M' 'U' 'M' 'M' 'U' 'U' 'A'
 'M' 'U' 'A' 'A' 'U' 'A' 'M' 'M' 'A' 'U' 'U' 'U' 'A' 'M' 'A' 'U' 'U' 'M'
 'U' 'U' 'M' 'U' 'U' 'A' 'A' 'A' 'A' 'A' 'A' 'A' 'U' 'M' 'M' 'A' 'M' 'U'
 'A' 'M' 'U' 'U' 'M' 'U' 'A' 'U' 'M' 'A' 'M' 'A' 'M' 'U' 'U' 'M' 'A' 'A'
 'U' 'U' 'A' 'U' 'M' 'U' 'U' 'M' 'U' 'M' 'M' 'M' 'U' 'U' 'U' 'U' 'M' 'M'
 'M' 'U' 'A' 'U' 'A' 'A' 'U' 'M' 'A' 'A' 'U' 'A' 'A' 'A' 'U' 'A' 'U' 'M']"
16301,3,113,56,57,85,0,0,"['A' 'U' 'U' 'U' 'U' 'A' 'M' 'M' 'U' 'U' 'U' 'U' 'M' 'U' 'M' 'M' 'U' 'U'
 'U' 'A' 'A' 'M' 'A' 'A' 'U' 'U' 'A' 'M' 'M' 'M' 'A' 'A' 'M' 'M' 'U' 'U'
 'U' 'A' 'U' 'U' 'U' 'A' 'U' 'U' 'U' 'U' 'A' 'U' 'A' 'M' 'U' 'A' 'A' 'U'
 'U' 'A' 'U' 'U' 'M' 'M' 'U' 'M' 'U' 'U' 'U' 'M' 'M' 'M' 'M' 'M' 'M' 'M'
 'M' 'U' 'M' 'U' 'U' 'U' 'U' 'U' 'U' 'U' 'M' 'M' 'U' 'M' 'A' 'U' 'U' 'U'
 'U' 'M' 'U' 'U' 'M' 'U' 'A' 'A' 'A' 'A' 'U' 'U' 'U' 'M' 'U' 'U' 'M' 'A'
 'M' 'U' 'A' 'A' 'A' 'A' 'M' 'M' 'A' 'U' 'U' 'U' 'A' 'M' 'U' 'U' 'A' 'M'
 'U' 'A' 'M' 'U' 'U' 'A' 'A' 'A' 'A' 'A' 'A' 'A' 'A' 'U' 'M' 'A' 'M' 'M'
 'U' 'M' 'U' 'U' 'M' 'M' 'A' 'U' 'M' 'A' 'M' 'A' 'M' 'U' 'U' 'M' 'U' 'A'
 'U' 'A' 'A' 'U' 'M' 'U' 'M' 'A' 'M' 'U' 'U' 'M' 'U' 'U' 'A' 'U' 'M' 'M'
 'M' 'A' 'A' 'M' 'A' 'A' 'U' 'M' 'U' 'A' 'A' 'U' 'A' 'A' 'U' 'A' 'U' 'M']"
16401,2,123,64,59,75,0,1,"['A' 'U' 'U' 'U' 'U' 'A' 'M' 'M' 'U' 'U' 'M' 'M' 'M' 'M' 'M' 'M' 'U' 'A'
 'U' 'A' 'A' 'M' 'A' 'A' 'U' 'U' 'A' 'M' 'A' 'M' 'A' 'A' 'M' 'M' 'U' 'M'
 'U' 'A' 'A' 'A' 'U' 'A' 'M' 'A' 'U' 'M' 'A' 'U' 'A' 'M' 'U' 'A' 'A' 'M'
 'U' 'A' 'U' 'U' 'U' 'U' 'U' 'M' 'U' 'A' 'U' 'M' 'M' 'M' 'M' 'M' 'M' 'M'
 'M' 'U' 'M' 'U' 'U' 'A' 'U' 'U' 'U' 'A' 'M' 'M' 'A' 'U' 'U' 'U' 'A' 'U'
 'U' 'M' 'U' 'M' 'U' 'U' 'U' 'A' 'A' 'A' 'U' 'U' 'U' 'M' 'A' 'U' 'M' 'A'
 'M' 'U' 'U' 'U' 'A' 'A' 'M' 'M' 'A' 'U' 'U' 'U' 'A' 'M' 'A' 'U' 'A' 'A'
 'U' 'A' 'U' 'U' 'U' 'A' 'A' 'A' 'A' 'A' 'A' 'A' 'A' 'U' 'M' 'A' 'M' 'M'
 'U' 'M' 'A' 'U' 'M' 'M' 'U' 'U' 'M' 'A' 'M' 'A' 'U' 'M' 'U' 'U' 'U' 'A'
 'A' 'A' 'A' 'M' 'M' 'U' 'M' 'A' 'M' 'M' 'U' 'M' 'U' 'U' 'A' 'A' 'M' 'M'
 'U' 'U' 'A' 'M' 'A' 'A' 'U' 'M' 'U' 'A' 'A' 'U' 'A' 'M' 'U' 'U' 'U' 'M']"
16501,3,112,60,52,86,0,0,"['A' 'M' 'U' 'U' 'U' 'A' 'U' 'M' 'U' 'U' 'M' 'U' 'M' 'U' 'M' 'M' 'U' 'U'
 'U' 'A' 'A' 'M' 'A' 'A' 'U' 'U' 'M' 'M' 'A' 'U' 'U' 'A' 'M' 'M' 'U' 'M'
 'U' 'U' 'A' 'U' 'A' 'U' 'M' 'A' 'U' 'M' 'U' 'M' 'A' 'U' 'U' 'A' 'A' 'U'
 'U' 'A' 'U' 'U' 'U' 'A' 'M' 'U' 'U' 'A' 'U' 'M' 'M' 'M' 'M' 'M' 'U' 'M'
 'M' 'M' 'M' 'U' 'U' 'A' 'U' 'U' 'U' 'U' 'U' 'U' 'A' 'U' 'A' 'U' 'A' 'U'
 'U' 'M' 'M' 'M' 'A' 'U' 'U' 'A' 'A' 'A' 'U' 'U' 'M' 'U' 'U' 'M' 'M' 'A'
 'M' 'U' 'M' 'U' 'U' 'A' 'U' 'U' 'A' 'U' 'U' 'U' 'A' 'U' 'A' 'U' 'A' 'A'
 'U' 'A' 'U' 'A' 'U' 'U' 'A' 'A' 'A' 'A' 'A' 'A' 'A' 'A' 'M' 'A' 'U' 'U'
 'U' 'M' 'A' 'A' 'M' 'M' 'A' 'M' 'M' 'U' 'M' 'U' 'U' 'M' 'U' 'A' 'M' 'A'
 'U' 'A' 'U' 'M' 'M' 'U' 'M' 'A' 'M' 'U' 'U' 'M' 'A' 'U' 'A' 'A' 'U' 'M'
 'U' 'U' 'A' 'M' 'A' 'A' 'A' 'M' 'U' 'A' 'A' 'M' 'A' 'M' 'U' 'U' 'U' 'U']"
16601,0,111,55,56,87,1,0,"['A' 'M' 'M' 'U' 'U' 'M' 'U' 'U' 'U' 'A' 'M' 'A' 'U' 'U' 'M' 'M' 'U' 'U'
 'U' 'A' 'U' 'M' 'U' 'A' 'U' 'U' 'U' 'U' 'A' 'M' 'U' 'A' 'M' 'M' 'U' 'M'
 'U' 'U' 'M' 'U' 'A' 'U' 'M' 'U' 'U' 'M' 'A' 'M' 'A' 'A' 'U' 'A' 'A' 'U'
 'U' 'A' 'A' 'U' 'U' 'A' 'M' 'U' 'U' 'A' 'U' 'M' 'M' 'M' 'M' 'U' 'M' 'M'
 'M' 'M' 'M' 'M' 'U' 'A' 'A' 'U' 'M' 'U' 'A' 'U' 'A' 'U' 'A' 'U' 'A' 'U'
 'U' 'U' 'U' 'M' 'U' 'U' 'M' 'A' 'A' 'A' 'M' 'M' 'U' 'U' 'U' 'U' 'M' 'A'
 'M' 'U' 'M' 'M' 'U' 'A' 'U' 'U' 'A' 'U' 'U' 'U' 'A' 'U' 'A' 'U' 'U' 'A'
 'M' 'M' 'U' 'M' 'U' 'A' 'A' 'A' 'A' 'A' 'A' 'A' 'A' 'A' 'M' 'U' 'U' 'A'
 'U' 'M' 'A' 'A' 'M' 'M' 'U' 'U' 'M' 'U' 'U' 'U' 'U' 'M' 'U' 'A' 'M' 'A'
 'U' 'A' 'U' 'M' 'M' 'U' 'M' 'U' 'M' 'M' 'U' 'M' 'U' 'U' 'A' 'A' 'U' 'U'
 'U' 'U' 'U' 'M' 'A' 'A' 'A' 'M' 'U' 'A' 'A' 'M' 'A' 'M' 'U' 'U' 'M' 'U']"
16701,1,108,54,54,90,0,0,"['A' 'M' 'M' 'U' 'U' 'M' 'U' 'U' 'U' 'A' 'M' 'U' 'A' 'U' 'U' 'M' 'U' 'U'
 'U' 'A' 'U' 'M' 'U' 'U' 'U' 'U' 'U' 'U' 'A' 'U' 'A' 'A' 'U' 'M' 'U' 'M'
 'M' 'U' 'M' 'A' 'A' 'A' 'M' 'U' 'U' 'M' 'A' 'M' 'A' 'U' 'U' 'A' 'U' 'U'
 'U' 'U' 'U' 'M' 'U' 'A' 'U' 'U' 'A' 'U' 'M' 'M' 'M' 'M' 'M' 'M' 'M' 'M'
 'M' 'U' 'M' 'U' 'U' 'U' 'U' 'A' 'M' 'A' 'A' 'M' 'A' 'U' 'U' 'U' 'A' 'U'
 'U' 'U' 'U' 'M' 'A' 'U' 'M' 'A' 'A' 'A' 'M' 'U' 'U' 'U' 'U' 'U' 'M' 'A'
 'U' 'M' 'M' 'M' 'U' 'A' 'M' 'U' 'U' 'U' 'U' 'U' 'A' 'U' 'A' 'U' 'U' 'A'
 'M' 'M' 'M' 'U' 'A' 'A' 'A' 'A' 'A' 'A' 'A' 'A' 'A' 'A' 'M' 'U' 'U' 'A'
 'U' 'M' 'A' 'A' 'M' 'M' 'U' 'A' 'M' 'U' 'M' 'U' 'M' 'M' 'U' 'A' 'M' 'A'
 'U' 'U' 'U' 'M' 'M' 'U' 'M' 'U' 'M' 'U' 'U' 'U' 'U' 'U' 'A' 'A' 'U' 'M'
 'A' 'U' 'U' 'M' 'A' 'A' 'U' 'M' 'A' 'A' 'A' 'U' 'A' 'M' 'U' 'U' 'U' 'U']"
16801,2,111,59,52,87,1,0,"['A' 'M' 'M' 'M' 'U' 'M' 'U' 'U' 'U' 'A' 'M' 'A' 'U' 'A' 'U' 'M' 'U' 'U'
 'U' 'A' 'U' 'U' 'U' 'M' 'U' 'U' 'U' 'U' 'A' 'A' 'U' 'A' 'U' 'M' 'U' 'U'
 'M' 'M' 'M' 'A' 'A' 'A' 'M' 'A' 'A' 'U' 'A' 'M' 'U' 'U' 'U' 'A' 'U' 'U'
 'U' 'U' 'U' 'U' 'A' 'A' 'U' 'A' 'A' 'U' 'M' 'M' 'M' 'M' 'M' 'M' 'M' 'U'
 'M' 'M' 'M' 'U' 'A' 'U' 'U' 'A' 'U' 'A' 'U' 'M' 'A' 'U' 'U' 'U' 'U' 'M'
 'M' 'U' 'U' 'U' 'A' 'U' 'M' 'U' 'A' 'U' 'M' 'U' 'M' 'A' 'A' 'U' 'U' 'A'
 'U' 'U' 'U' 'M' 'U' 'A' 'M' 'U' 'U' 'U' 'U' 'U' 'A' 'A' 'A' 'U' 'A' 'A'
 'M' 'M' 'M' 'U' 'A' 'A' 'A' 'A' 'A' 'A' 'A' 'A' 'A' 'A' 'M' 'U' 'U' 'A'
 'U' 'M' 'A' 'A' 'U' 'M' 'U' 'A' 'M' 'U' 'M' 'U' 'M' 'M' 'A' 'A' 'M' 'A'
 'M' 'M' 'A' 'M' 'M' 'U' 'M' 'U' 'U' 'U' 'M' 'M' 'U' 'U' 'A' 'A' 'U' 'U'
 'U' 'U' 'U' 'M' 'A' 'A' 'U' 'M' 'A' 'A' 'U' 'U' 'A' 'M' 'U' 'U' 'U' 'U']"
16901,1,119,65,54,79,0,1,"['A' 'U' 'U' 'M' 'U' 'M' 'U' 'M' 'A' 'U' 'M' 'A' 'U' 'U' 'A' 'M' 'U' 'U'
 'A' 'A' 'U' 'U' 'U' 'M' 'U' 'M' 'M' 'U' 'A' 'A' 'A' 'A' 'U' 'M' 'U' 'U'
 'U' 'A' 'M' 'U' 'A' 'A' 'M' 'A' 'A' 'U' 'A' 'M' 'U' 'U' 'U' 'A' 'M' 'U'
 'U' 'U' 'M' 'U' 'A' 'A' 'U' 'A' 'A' 'U' 'M' 'M' 'M' 'M' 'U' 'M' 'M' 'M'
 'M' 'M' 'M' 'U' 'M' 'U' 'U' 'A' 'U' 'U' 'A' 'A' 'A' 'U' 'U' 'U' 'U' 'U'
 'U' 'M' 'U' 'U' 'A' 'U' 'M' 'U' 'A' 'U' 'M' 'U' 'M' 'A' 'M' 'A' 'U' 'A'
 'U' 'U' 'U' 'M' 'U' 'A' 'M' 'A' 'U' 'U' 'A' 'U' 'A' 'A' 'A' 'U' 'A' 'A'
 'M' 'U' 'M' 'U' 'A' 'A' 'A' 'A' 'A' 'A' 'A' 'A' 'A' 'A' 'M' 'U' 'M' 'A'
 'U' 'M' 'A' 'U' 'U' 'M' 'U' 'A' 'M' 'U' 'U' 'U' 'M' 'M' 'A' 'A' 'U' 'A'
 'M' 'M' 'A' 'M' 'M' 'U' 'A' 'A' 'M' 'U' 'M' 'M' 'U' 'M' 'A' 'A' 'U' 'U'
 'A' 'A' 'U' 'M' 'U' 'A' 'M' 'M' 'A' 'U' 'U' 'U' 'A' 'M' 'U' 'U' 'M' 'A']"
17001,2,125,74,51,73,0,0,"['A' 'U' 'M' 'M' 'M' 'M' 'M' 'U' 'A' 'A' 'M' 'A' 'U' 'U' 'A' 'M' 'U' 'A'
 'U' 'A' 'U' 'U' 'U' 'M' 'U' 'U' 'U' 'U' 'A' 'A' 'A' 'A' 'U' 'M' 'A' 'U'
 'M' 'A' 'M' 'A' 'A' 'U' 'M' 'M' 'A' 'U' 'A' 'U' 'U' 'U' 'A' 'A' 'M' 'U'
 'A' 'A' 'M' 'M' 'A' 'A' 'A' 'A' 'A' 'U' 'M' 'M' 'M' 'M' 'M' 'M' 'M' 'U'
 'M' 'M' 'M' 'U' 'M' 'A' 'U' 'A' 'U' 'U' 'A' 'A' 'A' 'U' 'A' 'U' 'U' 'A'
 'U' 'M' 'U' 'M' 'A' 'U' 'U' 'U' 'A' 'A' 'M' 'U' 'M' 'A' 'M' 'A' 'U' 'A'
 'U' 'A' 'M' 'M' 'M' 'A' 'M' 'A' 'U' 'U' 'U' 'U' 'U' 'A' 'A' 'U' 'A' 'A'
 'M' 'U' 'M' 'U' 'A' 'A' 'A' 'A' 'A' 'A' 'A' 'A' 'A' 'A' 'M' 'U' 'M' 'A'
 'U' 'U' 'U' 'U' 'U' 'U' 'U' 'A' 'M' 'U' 'U' 'U' 'M' 'M' 'A' 'A' 'U' 'A'
 'M' 'U' 'A' 'U' 'M' 'U' 'A' 'A' 'M' 'A' 'U' 'U' 'A' 'M' 'U' 'A' 'U' 'U'
 'A' 'A' 'U' 'M' 'U' 'A' 'M' 'M' 'A' 'A' 'U' 'U' 'A' 'U' 'U' 'U' 'M' 'A']"
17101,2,126,80,46,72,1,0,"['A' 'U' 'M' 'U' 'U' 'A' 'U' 'A' 'A' 'A' 'M' 'U' 'U' 'U' 'A' 'M' 'A' 'A'
 'U' 'A' 'A' 'A' 'U' 'M' 'U' 'U' 'U' 'U' 'A' 'U' 'A' 'A' 'U' 'M' 'A' 'M'
 'M' 'A' 'M' 'M' 'A' 'U' 'U' 'M' 'A' 'U' 'A' 'A' 'U' 'U' 'A' 'A' 'M' 'U'
 'A' 'A' 'M' 'U' 'A' 'A' 'A' 'A' 'A' 'A' 'U' 'M' 'M' 'M' 'M' 'M' 'U' 'M'
 'M' 'M' 'M' 'M' 'U' 'A' 'U' 'U' 'A' 'A' 'A' 'A' 'U' 'M' 'A' 'M' 'A' 'A'
 'A' 'M' 'U' 'M' 'A' 'U' 'U' 'A' 'A' 'A' 'M' 'U' 'M' 'A' 'M' 'A' 'U' 'U'
 'U' 'A' 'U' 'U' 'M' 'U' 'M' 'U' 'U' 'U' 'A' 'A' 'U' 'A' 'U' 'U' 'A' 'A'
 'U' 'U' 'M' 'A' 'A' 'A' 'A' 'A' 'A' 'A' 'A' 'A' 'A' 'A' 'M' 'U' 'U' 'U'
 'A' 'U' 'U' 'A' 'A' 'U' 'U' 'A' 'M' 'M' 'A' 'U' 'M' 'M' 'U' 'A' 'U' 'U'
 'U' 'U' 'A' 'U' 'U' 'M' 'A' 'A' 'M' 'A' 'U' 'M' 'A' 'M' 'U' 'A' 'U' 'U'
 'A' 'U' 'U' 'M' 'U' 'A' 'M' 'M' 'A' 'A' 'U' 'U' 'A' 'U' 'M' 'U' 'M' 'A']"
17201,2,128,83,45,70,0,0,"['A' 'U' 'M' 'U' 'U' 'A' 'A' 'U' 'A' 'A' 'M' 'U' 'A' 'M' 'A' 'M' 'A' 'A'
 'U' 'A' 'A' 'U' 'U' 'M' 'M' 'M' 'A' 'U' 'A' 'U' 'A' 'A' 'M' 'U' 'A' 'M'
 'U' 'A' 'M' 'M' 'A' 'U' 'M' 'M' 'A' 'U' 'A' 'U' 'U' 'M' 'A' 'A' 'M' 'U'
 'U' 'A' 'M' 'A' 'U' 'A' 'A' 'A' 'U' 'A' 'U' 'M' 'M' 'U' 'M' 'M' 'M' 'M'
 'M' 'M' 'M' 'M' 'M' 'A' 'U' 'U' 'A' 'A' 'A' 'A' 'U' 'M' 'A' 'U' 'A' 'A'
 'A' 'A' 'A' 'U' 'A' 'U' 'U' 'A' 'A' 'A' 'M' 'A' 'M' 'A' 'U' 'A' 'U' 'A'
 'U' 'A' 'M' 'U' 'M' 'M' 'M' 'U' 'U' 'U' 'A' 'A' 'U' 'A' 'U' 'U' 'A' 'A'
 'U' 'U' 'M' 'U' 'A' 'A' 'A' 'A' 'A' 'A' 'A' 'A' 'A' 'A' 'U' 'U' 'A' 'U'
 'A' 'M' 'U' 'A' 'A' 'U' 'U' 'A' 'M' 'U' 'A' 'U' 'M' 'M' 'U' 'U' 'U' 'U'
 'U' 'A' 'A' 'U' 'U' 'M' 'A' 'A' 'U' 'A' 'U' 'M' 'A' 'M' 'A' 'A' 'U' 'U'
 'A' 'U' 'U' 'M' 'A' 'A' 'U' 'M' 'U' 'A' 'U' 'U' 'A' 'U' 'U' 'U' 'M' 'A']"
17301,3,134,88,46,64,1,0,"['A' 'U' 'M' 'M' 'U' 'A' 'A' 'U' 'U' 'A' 'U' 'M' 'A' 'M' 'A' 'M' 'A' 'U'
 'U' 'A' 'A' 'U' 'M' 'M' 'M' 'U' 'A' 'U' 'A' 'M' 'A' 'A' 'M' 'U' 'A' 'U'
 'U' 'A' 'M' 'M' 'A' 'A' 'M' 'M' 'A' 'U' 'A' 'A' 'U' 'U' 'A' 'A' 'M' 'U'
 'U' 'U' 'U' 'A' 'U' 'A' 'A' 'A' 'U' 'A' 'U' 'M' 'M' 'M' 'M' 'M' 'U' 'M'
 'M' 'M' 'M' 'M' 'M' 'A' 'M' 'M' 'A' 'A' 'A' 'M' 'U' 'U' 'A' 'A' 'A' 'A'
 'U' 'A' 'A' 'A' 'A' 'U' 'A' 'A' 'A' 'A' 'M' 'A' 'M' 'A' 'A' 'A' 'U' 'A'
 'U' 'A' 'U' 'U' 'M' 'M' 'M' 'U' 'U' 'A' 'A' 'A' 'U' 'A' 'M' 'U' 'U' 'A'
 'A' 'U' 'M' 'U' 'A' 'A' 'A' 'A' 'A' 'A' 'A' 'A' 'A' 'A' 'U' 'U' 'A' 'A'
 'M' 'M' 'U' 'A' 'A' 'U' 'U' 'A' 'M' 'U' 'A' 'U' 'M' 'U' 'U' 'U' 'A' 'U'
 'U' 'A' 'A' 'U' 'M' 'M' 'A' 'A' 'A' 'U' 'U' 'M' 'U' 'M' 'A' 'A' 'U' 'A'
 'A' 'A' 'U' 'A' 'U' 'A' 'U' 'M' 'U' 'A' 'U' 'U' 'A' 'U' 'U' 'A' 'M' 'A']"
17401,1,136,87,49,62,1,0,"['A' 'U' 'M' 'M' 'U' 'A' 'U' 'A' 'A' 'U' 'U' 'M' 'A' 'M' 'A' 'U' 'A' 'U'
 'M' 'A' 'U' 'U' 'M' 'M' 'U' 'U' 'A' 'U' 'A' 'M' 'A' 'A' 'M' 'U' 'A' 'U'
 'M' 'A' 'M' 'M' 'A' 'A' 'M' 'M' 'A' 'U' 'A' 'A' 'A' 'M' 'A' 'A' 'U' 'U'
 'U' 'U' 'U' 'A' 'U' 'A' 'A' 'A' 'U' 'A' 'M' 'M' 'M' 'M' 'M' 'M' 'M' 'M'
 'U' 'M' 'M' 'M' 'M' 'A' 'M' 'M' 'U' 'A' 'A' 'M' 'U' 'U' 'A' 'A' 'A' 'A'
 'A' 'A' 'U' 'A' 'A' 'U' 'U' 'A' 'U' 'A' 'M' 'A' 'M' 'M' 'A' 'A' 'U' 'A'
 'U' 'U' 'M' 'M' 'M' 'M' 'M' 'U' 'A' 'A' 'A' 'A' 'U' 'A' 'U' 'U' 'U' 'U'
 'A' 'M' 'M' 'U' 'A' 'A' 'A' 'A' 'A' 'A' 'A' 'A' 'A' 'A' 'U' 'U' 'A' 'A'
 'M' 'U' 'U' 'A' 'A' 'U' 'A' 'A' 'U' 'U' 'A' 'U' 'M' 'U' 'A' 'U' 'U' 'U'
 'A' 'A' 'A' 'U' 'M' 'M' 'A' 'A' 'A' 'A' 'U' 'U' 'U' 'U' 'A' 'A' 'M' 'A'
 'U' 'A' 'A' 'A' 'U' 'A' 'U' 'M' 'M' 'A' 'U' 'U' 'A' 'A' 'M' 'A' 'M' 'A']"
17501,3,142,89,53,56,0,0,"['A' 'A' 'M' 'M' 'U' 'A' 'M' 'A' 'A' 'U' 'U' 'M' 'A' 'M' 'A' 'U' 'A' 'U'
 'M' 'A' 'U' 'U' 'M' 'M' 'U' 'A' 'A' 'U' 'A' 'M' 'A' 'U' 'M' 'U' 'U' 'U'
 'M' 'A' 'U' 'M' 'U' 'A' 'M' 'M' 'A' 'U' 'A' 'A' 'A' 'M' 'M' 'A' 'U' 'A'
 'M' 'U' 'A' 'A' 'U' 'A' 'A' 'M' 'U' 'A' 'U' 'M' 'U' 'M' 'M' 'M' 'M' 'M'
 'M' 'M' 'M' 'M' 'M' 'A' 'M' 'M' 'U' 'A' 'A' 'M' 'M' 'U' 'A' 'A' 'U' 'U'
 'A' 'U' 'U' 'U' 'A' 'U' 'U' 'A' 'A' 'A' 'M' 'A' 'M' 'A' 'A' 'A' 'U' 'A'
 'A' 'U' 'M' 'U' 'M' 'M' 'U' 'U' 'A' 'A' 'U' 'A' 'M' 'A' 'A' 'A' 'A' 'U'
 'A' 'M' 'M' 'A' 'A' 'A' 'A' 'A' 'A' 'A' 'A' 'A' 'A' 'U' 'A' 'U' 'A' 'A'
 'M' 'U' 'U' 'A' 'A' 'A' 'A' 'A' 'U' 'A' 'U' 'M' 'U' 'U' 'A' 'A' 'M' 'U'
 'A' 'U' 'U' 'A' 'M' 'M' 'A' 'A' 'A' 'A' 'U' 'A' 'A' 'U' 'A' 'A' 'M' 'A'
 'M' 'A' 'A' 'U' 'U' 'A' 'U' 'M' 'M' 'A' 'M' 'U' 'A' 'A' 'M' 'U' 'M' 'A']"
17601,1,126,77,49,72,1,0,"['A' 'A' 'U' 'M' 'U' 'A' 'U' 'A' 'U' 'U' 'U' 'U' 'A' 'M' 'U' 'A' 'A' 'U'
 'M' 'A' 'U' 'U' 'M' 'M' 'U' 'A' 'A' 'M' 'A' 'M' 'A' 'M' 'M' 'U' 'A' 'U'
 'M' 'A' 'U' 'U' 'U' 'A' 'M' 'M' 'A' 'A' 'A' 'A' 'A' 'M' 'M' 'A' 'U' 'A'
 'M' 'U' 'U' 'A' 'U' 'A' 'A' 'U' 'M' 'A' 'A' 'M' 'M' 'M' 'U' 'M' 'M' 'M'
 'M' 'M' 'M' 'M' 'U' 'U' 'U' 'M' 'U' 'A' 'A' 'A' 'M' 'U' 'U' 'U' 'U' 'U'
 'A' 'U' 'U' 'U' 'A' 'U' 'U' 'A' 'A' 'A' 'M' 'U' 'U' 'A' 'A' 'A' 'U' 'U'
 'A' 'U' 'M' 'A' 'M' 'M' 'U' 'U' 'A' 'A' 'U' 'U' 'M' 'A' 'U' 'A' 'A' 'A'
 'A' 'M' 'A' 'A' 'A' 'A' 'A' 'A' 'A' 'A' 'A' 'A' 'A' 'U' 'A' 'U' 'A' 'A'
 'M' 'M' 'U' 'U' 'A' 'M' 'U' 'A' 'U' 'U' 'U' 'M' 'U' 'U' 'A' 'A' 'M' 'U'
 'A' 'A' 'U' 'U' 'M' 'M' 'A' 'A' 'A' 'A' 'U' 'U' 'A' 'U' 'U' 'A' 'M' 'A'
 'U' 'U' 'A' 'U' 'M' 'M' 'U' 'M' 'M' 'U' 'M' 'A' 'U' 'A' 'M' 'U' 'M' 'U']"
17701,1,128,80,48,70,1,0,"['A' 'A' 'U' 'M' 'A' 'A' 'U' 'A' 'A' 'U' 'U' 'M' 'U' 'M' 'U' 'M' 'A' 'U'
 'M' 'A' 'U' 'U' 'U' 'M' 'M' 'A' 'A' 'M' 'A' 'M' 'U' 'U' 'U' 'M' 'A' 'U'
 'U' 'A' 'A' 'U' 'U' 'A' 'U' 'M' 'A' 'A' 'A' 'A' 'A' 'U' 'M' 'A' 'U' 'A'
 'U' 'U' 'M' 'M' 'U' 'U' 'A' 'U' 'M' 'A' 'A' 'M' 'U' 'M' 'M' 'M' 'M' 'M'
 'M' 'M' 'M' 'M' 'U' 'M' 'A' 'U' 'U' 'A' 'U' 'A' 'M' 'M' 'U' 'M' 'A' 'U'
 'A' 'U' 'U' 'U' 'A' 'U' 'U' 'A' 'A' 'A' 'M' 'U' 'U' 'A' 'A' 'U' 'A' 'A'
 'A' 'M' 'M' 'A' 'M' 'M' 'U' 'U' 'A' 'A' 'A' 'U' 'M' 'A' 'U' 'A' 'A' 'A'
 'A' 'M' 'A' 'A' 'A' 'A' 'A' 'A' 'A' 'A' 'A' 'A' 'A' 'U' 'A' 'U' 'A' 'A'
 'M' 'U' 'U' 'A' 'A' 'U' 'U' 'A' 'U' 'M' 'U' 'M' 'U' 'U' 'A' 'A' 'U' 'U'
 'M' 'A' 'U' 'U' 'M' 'M' 'A' 'A' 'A' 'A' 'U' 'U' 'A' 'U' 'U' 'A' 'M' 'A'
 'A' 'U' 'A' 'U' 'U' 'U' 'U' 'M' 'M' 'U' 'M' 'A' 'U' 'A' 'M' 'U' 'M' 'A']"
17801,0,135,83,52,63,0,1,"['A' 'A' 'U' 'A' 'U' 'A' 'M' 'A' 'U' 'A' 'A' 'M' 'A' 'M' 'M' 'M' 'A' 'U'
 'M' 'A' 'U' 'A' 'A' 'M' 'M' 'A' 'A' 'M' 'U' 'M' 'U' 'U' 'U' 'U' 'A' 'U'
 'U' 'A' 'A' 'U' 'U' 'U' 'U' 'M' 'A' 'A' 'A' 'A' 'A' 'U' 'M' 'A' 'U' 'A'
 'U' 'U' 'M' 'M' 'U' 'U' 'A' 'A' 'M' 'A' 'A' 'M' 'M' 'M' 'M' 'M' 'M' 'U'
 'M' 'M' 'M' 'M' 'M' 'M' 'U' 'U' 'U' 'A' 'A' 'A' 'U' 'M' 'M' 'M' 'A' 'U'
 'A' 'U' 'A' 'M' 'A' 'U' 'U' 'A' 'A' 'A' 'U' 'A' 'M' 'A' 'A' 'M' 'U' 'A'
 'A' 'M' 'M' 'U' 'U' 'M' 'U' 'U' 'A' 'A' 'A' 'M' 'M' 'A' 'U' 'A' 'A' 'A'
 'A' 'M' 'A' 'U' 'A' 'U' 'A' 'A' 'A' 'A' 'A' 'A' 'A' 'A' 'A' 'U' 'A' 'A'
 'M' 'M' 'U' 'A' 'U' 'U' 'U' 'U' 'U' 'M' 'M' 'M' 'A' 'U' 'A' 'A' 'U' 'U'
 'M' 'A' 'U' 'U' 'M' 'U' 'A' 'A' 'A' 'A' 'A' 'U' 'A' 'U' 'U' 'A' 'M' 'A'
 'A' 'U' 'A' 'U' 'U' 'U' 'M' 'M' 'U' 'U' 'M' 'A' 'U' 'A' 'M' 'A' 'M' 'A']"
17901,2,126,82,44,72,0,1,"['A' 'A' 'U' 'A' 'U' 'A' 'M' 'A' 'A' 'A' 'A' 'M' 'A' 'M' 'U' 'M' 'U' 'U'
 'U' 'A' 'M' 'A' 'A' 'M' 'M' 'A' 'A' 'M' 'U' 'A' 'U' 'U' 'A' 'U' 'A' 'U'
 'U' 'U' 'A' 'M' 'U' 'U' 'U' 'U' 'A' 'A' 'A' 'A' 'A' 'U' 'M' 'A' 'U' 'A'
 'M' 'U' 'M' 'M' 'M' 'A' 'U' 'U' 'U' 'A' 'U' 'M' 'M' 'M' 'U' 'M' 'M' 'M'
 'M' 'M' 'M' 'M' 'M' 'M' 'U' 'U' 'A' 'A' 'A' 'A' 'U' 'M' 'M' 'M' 'A' 'U'
 'A' 'A' 'A' 'U' 'A' 'U' 'U' 'A' 'A' 'A' 'U' 'A' 'U' 'U' 'A' 'M' 'U' 'A'
 'A' 'M' 'M' 'U' 'U' 'M' 'A' 'U' 'A' 'A' 'A' 'M' 'M' 'A' 'A' 'A' 'A' 'U'
 'A' 'M' 'A' 'U' 'U' 'A' 'A' 'A' 'A' 'A' 'A' 'A' 'A' 'U' 'A' 'U' 'A' 'A'
 'U' 'M' 'U' 'A' 'A' 'U' 'U' 'U' 'U' 'U' 'M' 'M' 'A' 'U' 'A' 'A' 'U' 'U'
 'U' 'A' 'U' 'U' 'M' 'U' 'A' 'A' 'A' 'A' 'U' 'U' 'A' 'U' 'A' 'A' 'U' 'U'
 'U' 'M' 'A' 'U' 'A' 'M' 'M' 'U' 'U' 'U' 'U' 'A' 'U' 'U' 'M' 'U' 'A' 'A']"
18001,1,129,84,45,69,1,0,"['A' 'A' 'A' 'A' 'U' 'U' 'U' 'A' 'A' 'A' 'A' 'M' 'A' 'M' 'A' 'M' 'U' 'M'
 'U' 'A' 'M' 'A' 'U' 'M' 'M' 'A' 'A' 'M' 'U' 'A' 'U' 'U' 'A' 'U' 'A' 'A'
 'M' 'U' 'A' 'M' 'U' 'U' 'A' 'U' 'A' 'A' 'A' 'A' 'A' 'U' 'M' 'A' 'U' 'A'
 'M' 'U' 'M' 'M' 'U' 'A' 'U' 'U' 'U' 'M' 'M' 'M' 'U' 'M' 'M' 'M' 'M' 'M'
 'M' 'M' 'M' 'M' 'U' 'M' 'A' 'U' 'A' 'A' 'A' 'A' 'A' 'M' 'A' 'M' 'A' 'U'
 'A' 'A' 'A' 'M' 'A' 'U' 'U' 'A' 'A' 'A' 'U' 'U' 'U' 'U' 'U' 'U' 'U' 'U'
 'A' 'M' 'U' 'A' 'U' 'M' 'U' 'U' 'U' 'A' 'A' 'M' 'U' 'A' 'U' 'A' 'U' 'M'
 'A' 'U' 'A' 'U' 'U' 'U' 'A' 'A' 'A' 'A' 'A' 'A' 'A' 'U' 'A' 'U' 'A' 'A'
 'U' 'M' 'A' 'A' 'A' 'A' 'M' 'U' 'U' 'U' 'M' 'M' 'A' 'U' 'A' 'A' 'A' 'A'
 'U' 'A' 'U' 'A' 'M' 'U' 'A' 'U' 'A' 'A' 'U' 'U' 'A' 'U' 'A' 'A' 'U' 'U'
 'M' 'M' 'U' 'M' 'A' 'M' 'M' 'A' 'U' 'U' 'U' 'A' 'U' 'U' 'M' 'A' 'A' 'A']"
18101,2,131,83,48,67,0,1,"['A' 'A' 'U' 'A' 'U' 'U' 'U' 'U' 'M' 'U' 'U' 'M' 'U' 'M' 'A' 'M' 'A' 'M'
 'A' 'A' 'M' 'U' 'U' 'M' 'U' 'A' 'A' 'M' 'U' 'A' 'U' 'U' 'A' 'A' 'A' 'A'
 'M' 'U' 'A' 'M' 'U' 'U' 'A' 'U' 'A' 'A' 'A' 'A' 'A' 'U' 'M' 'A' 'U' 'A'
 'U' 'A' 'M' 'M' 'M' 'U' 'A' 'U' 'U' 'M' 'M' 'M' 'M' 'M' 'M' 'M' 'M' 'U'
 'M' 'M' 'M' 'M' 'U' 'M' 'A' 'U' 'A' 'A' 'U' 'A' 'A' 'M' 'A' 'U' 'A' 'M'
 'A' 'U' 'A' 'M' 'A' 'A' 'U' 'A' 'A' 'A' 'U' 'U' 'U' 'U' 'U' 'A' 'U' 'M'
 'U' 'M' 'M' 'A' 'A' 'M' 'U' 'U' 'U' 'U' 'A' 'M' 'U' 'U' 'M' 'U' 'U' 'M'
 'A' 'U' 'A' 'A' 'U' 'A' 'A' 'A' 'A' 'A' 'A' 'A' 'A' 'U' 'A' 'M' 'A' 'A'
 'A' 'U' 'A' 'A' 'A' 'A' 'U' 'A' 'U' 'U' 'M' 'M' 'A' 'U' 'A' 'A' 'A' 'U'
 'U' 'A' 'A' 'A' 'M' 'U' 'A' 'U' 'A' 'A' 'A' 'U' 'U' 'U' 'U' 'A' 'A' 'U'
 'M' 'M' 'U' 'M' 'A' 'M' 'M' 'A' 'A' 'U' 'M' 'A' 'A' 'U' 'M' 'U' 'A' 'A']"
18201,2,121,71,50,77,1,0,"['A' 'A' 'U' 'A' 'U' 'U' 'M' 'U' 'M' 'U' 'A' 'U' 'A' 'M' 'A' 'M' 'U' 'M'
 'U' 'A' 'M' 'U' 'U' 'M' 'U' 'U' 'U' 'M' 'U' 'A' 'A' 'U' 'A' 'A' 'A' 'A'
 'M' 'M' 'A' 'M' 'U' 'U' 'A' 'U' 'A' 'U' 'A' 'A' 'U' 'U' 'M' 'A' 'U' 'A'
 'U' 'A' 'M' 'U' 'M' 'U' 'A' 'U' 'U' 'M' 'A' 'U' 'M' 'M' 'M' 'M' 'M' 'M'
 'M' 'M' 'M' 'U' 'U' 'M' 'A' 'U' 'U' 'A' 'U' 'A' 'A' 'M' 'U' 'U' 'A' 'M'
 'A' 'U' 'U' 'M' 'A' 'A' 'U' 'A' 'A' 'U' 'U' 'U' 'M' 'U' 'U' 'A' 'U' 'M'
 'U' 'M' 'M' 'A' 'A' 'M' 'U' 'U' 'M' 'U' 'A' 'U' 'U' 'U' 'M' 'U' 'U' 'U'
 'A' 'U' 'A' 'U' 'U' 'A' 'A' 'A' 'A' 'A' 'A' 'A' 'A' 'U' 'A' 'M' 'A' 'U'
 'A' 'U' 'A' 'A' 'A' 'A' 'U' 'A' 'M' 'M' 'M' 'M' 'U' 'M' 'A' 'A' 'M' 'M'
 'U' 'A' 'A' 'A' 'M' 'A' 'U' 'U' 'U' 'A' 'M' 'A' 'U' 'U' 'U' 'A' 'A' 'U'
 'M' 'M' 'U' 'M' 'A' 'U' 'U' 'A' 'A' 'U' 'M' 'A' 'U' 'A' 'M' 'U' 'A' 'U']"
18301,1,124,72,52,74,0,1,"['A' 'A' 'M' 'A' 'A' 'U' 'M' 'U' 'U' 'U' 'A' 'A' 'A' 'M' 'A' 'U' 'U' 'M'
 'U' 'A' 'M' 'U' 'M' 'U' 'U' 'U' 'U' 'M' 'M' 'A' 'U' 'U' 'A' 'A' 'A' 'U'
 'M' 'M' 'A' 'A' 'U' 'A' 'A' 'U' 'U' 'A' 'A' 'A' 'U' 'U' 'M' 'A' 'M' 'U'
 'U' 'A' 'M' 'A' 'M' 'U' 'A' 'M' 'U' 'M' 'U' 'M' 'M' 'U' 'M' 'M' 'M' 'M'
 'M' 'M' 'M' 'U' 'A' 'M' 'M' 'U' 'U' 'A' 'U' 'A' 'U' 'M' 'A' 'U' 'A' 'M'
 'A' 'M' 'M' 'U' 'A' 'U' 'U' 'A' 'A' 'U' 'U' 'U' 'M' 'U' 'U' 'A' 'U' 'M'
 'U' 'M' 'M' 'A' 'A' 'M' 'M' 'A' 'M' 'U' 'A' 'U' 'U' 'A' 'M' 'U' 'U' 'U'
 'A' 'U' 'A' 'A' 'U' 'A' 'A' 'A' 'A' 'A' 'A' 'A' 'A' 'U' 'A' 'M' 'A' 'U'
 'A' 'U' 'U' 'A' 'A' 'A' 'U' 'A' 'M' 'M' 'M' 'M' 'M' 'M' 'A' 'A' 'M' 'M'
 'U' 'A' 'A' 'U' 'M' 'U' 'U' 'U' 'A' 'A' 'U' 'A' 'U' 'U' 'U' 'U' 'A' 'U'
 'U' 'M' 'U' 'M' 'A' 'U' 'U' 'A' 'A' 'U' 'U' 'A' 'U' 'A' 'M' 'A' 'A' 'U']"
18401,2,123,76,47,75,1,0,"['A' 'A' 'U' 'A' 'A' 'U' 'M' 'U' 'M' 'M' 'A' 'A' 'A' 'M' 'U' 'A' 'A' 'U'
 'U' 'A' 'M' 'U' 'M' 'U' 'U' 'A' 'U' 'M' 'M' 'A' 'U' 'U' 'U' 'A' 'A' 'U'
 'M' 'M' 'A' 'A' 'U' 'A' 'A' 'U' 'U' 'A' 'A' 'A' 'U' 'M' 'M' 'A' 'U' 'A'
 'U' 'A' 'U' 'A' 'U' 'A' 'A' 'M' 'U' 'M' 'U' 'M' 'M' 'M' 'U' 'M' 'M' 'M'
 'M' 'M' 'M' 'A' 'A' 'M' 'M' 'U' 'U' 'U' 'A' 'U' 'M' 'M' 'A' 'U' 'A' 'M'
 'A' 'M' 'M' 'U' 'A' 'U' 'A' 'M' 'A' 'A' 'U' 'A' 'M' 'A' 'U' 'A' 'U' 'U'
 'U' 'U' 'M' 'U' 'A' 'U' 'U' 'A' 'M' 'A' 'A' 'U' 'M' 'A' 'M' 'U' 'U' 'U'
 'A' 'U' 'A' 'U' 'U' 'A' 'A' 'A' 'A' 'A' 'A' 'A' 'A' 'U' 'A' 'M' 'U' 'U'
 'A' 'U' 'A' 'A' 'A' 'A' 'A' 'A' 'M' 'M' 'U' 'M' 'M' 'M' 'A' 'A' 'M' 'U'
 'U' 'A' 'U' 'U' 'M' 'U' 'A' 'U' 'A' 'A' 'A' 'A' 'U' 'U' 'U' 'U' 'U' 'U'
 'U' 'M' 'U' 'M' 'A' 'U' 'A' 'A' 'A' 'U' 'U' 'U' 'M' 'A' 'U' 'U' 'U' 'U']"
18501,1,123,73,50,75,0,1,"['A' 'U' 'U' 'A' 'U' 'U' 'M' 'A' 'M' 'M' 'A' 'A' 'A' 'M' 'U' 'A' 'A' 'U'
 'A' 'A' 'M' 'U' 'M' 'U' 'U' 'A' 'A' 'M' 'M' 'A' 'U' 'M' 'U' 'A' 'A' 'U'
 'M' 'U' 'U' 'A' 'U' 'A' 'A' 'U' 'U' 'A' 'A' 'A' 'U' 'M' 'M' 'A' 'U' 'U'
 'U' 'U' 'U' 'A' 'U' 'A' 'U' 'M' 'U' 'M' 'U' 'M' 'M' 'M' 'U' 'M' 'M' 'M'
 'M' 'M' 'M' 'U' 'A' 'M' 'U' 'U' 'U' 'A' 'A' 'U' 'U' 'M' 'U' 'U' 'A' 'U'
 'A' 'M' 'M' 'U' 'A' 'U' 'A' 'U' 'M' 'A' 'U' 'A' 'M' 'U' 'U' 'A' 'A' 'U'
 'U' 'U' 'M' 'U' 'U' 'M' 'A' 'A' 'M' 'A' 'A' 'M' 'M' 'A' 'U' 'U' 'A' 'A'
 'A' 'U' 'A' 'U' 'U' 'A' 'A' 'A' 'A' 'A' 'A' 'A' 'A' 'U' 'A' 'M' 'M' 'U'
 'A' 'U' 'U' 'A' 'A' 'U' 'A' 'U' 'M' 'M' 'U' 'M' 'M' 'M' 'A' 'A' 'M' 'U'
 'U' 'A' 'U' 'U' 'M' 'U' 'A' 'A' 'A' 'A' 'A' 'A' 'U' 'A' 'U' 'U' 'M' 'U'
 'U' 'M' 'M' 'M' 'A' 'M' 'A' 'A' 'A' 'U' 'U' 'U' 'M' 'A' 'U' 'U' 'A' 'M']"
18601,1,120,70,50,78,0,1,"['A' 'U' 'U' 'A' 'U' 'U' 'U' 'U' 'M' 'M' 'A' 'U' 'A' 'U' 'U' 'A' 'A' 'U'
 'A' 'A' 'M' 'U' 'M' 'A' 'M' 'A' 'A' 'U' 'M' 'A' 'U' 'M' 'U' 'A' 'A' 'U'
 'M' 'U' 'U' 'A' 'A' 'A' 'A' 'U' 'U' 'A' 'A' 'A' 'A' 'M' 'M' 'A' 'A' 'U'
 'U' 'U' 'A' 'A' 'U' 'A' 'M' 'M' 'U' 'M' 'U' 'M' 'M' 'M' 'M' 'M' 'M' 'M'
 'M' 'M' 'U' 'U' 'U' 'M' 'U' 'U' 'U' 'A' 'A' 'U' 'U' 'U' 'U' 'U' 'A' 'U'
 'U' 'U' 'M' 'U' 'U' 'U' 'A' 'A' 'M' 'A' 'U' 'A' 'M' 'U' 'U' 'A' 'A' 'A'
 'U' 'U' 'M' 'U' 'U' 'M' 'A' 'A' 'U' 'U' 'U' 'M' 'M' 'U' 'U' 'U' 'A' 'A'
 'A' 'M' 'A' 'U' 'U' 'A' 'A' 'A' 'A' 'A' 'A' 'A' 'A' 'U' 'A' 'M' 'M' 'U'
 'A' 'U' 'M' 'U' 'A' 'U' 'A' 'U' 'M' 'M' 'U' 'M' 'M' 'M' 'U' 'U' 'M' 'U'
 'U' 'U' 'U' 'M' 'M' 'U' 'A' 'A' 'A' 'A' 'A' 'A' 'U' 'U' 'M' 'M' 'U' 'U'
 'A' 'M' 'M' 'M' 'A' 'M' 'A' 'A' 'A' 'U' 'A' 'U' 'U' 'A' 'M' 'A' 'A' 'M']"
18701,0,122,70,52,76,1,0,"['A' 'M' 'U' 'A' 'U' 'U' 'U' 'U' 'U' 'M' 'A' 'A' 'A' 'A' 'U' 'A' 'A' 'M'
 'A' 'A' 'M' 'U' 'M' 'A' 'M' 'U' 'A' 'U' 'M' 'U' 'A' 'M' 'A' 'A' 'A' 'U'
 'U' 'U' 'M' 'A' 'U' 'U' 'A' 'U' 'U' 'A' 'A' 'A' 'A' 'M' 'M' 'A' 'U' 'U'
 'A' 'M' 'A' 'A' 'U' 'A' 'M' 'U' 'U' 'M' 'U' 'U' 'M' 'M' 'M' 'M' 'M' 'M'
 'M' 'M' 'M' 'U' 'U' 'M' 'U' 'U' 'U' 'A' 'A' 'M' 'M' 'A' 'A' 'U' 'A' 'U'
 'U' 'U' 'M' 'U' 'U' 'U' 'A' 'U' 'M' 'A' 'U' 'U' 'U' 'M' 'U' 'U' 'U' 'A'
 'U' 'A' 'M' 'U' 'U' 'M' 'A' 'U' 'U' 'U' 'A' 'M' 'U' 'U' 'U' 'U' 'A' 'A'
 'A' 'M' 'A' 'A' 'U' 'A' 'A' 'A' 'A' 'A' 'A' 'U' 'A' 'M' 'A' 'M' 'M' 'U'
 'A' 'U' 'M' 'M' 'A' 'U' 'A' 'A' 'M' 'M' 'U' 'M' 'M' 'U' 'U' 'U' 'M' 'U'
 'A' 'U' 'U' 'M' 'M' 'U' 'A' 'A' 'A' 'A' 'A' 'A' 'U' 'U' 'M' 'M' 'U' 'U'
 'A' 'U' 'M' 'M' 'A' 'M' 'U' 'A' 'A' 'U' 'U' 'A' 'M' 'A' 'M' 'A' 'A' 'U']"
18801,3,132,76,56,66,0,1,"['A' 'M' 'U' 'A' 'U' 'M' 'U' 'U' 'M' 'M' 'A' 'A' 'A' 'A' 'U' 'U' 'A' 'M'
 'A' 'A' 'M' 'U' 'M' 'A' 'U' 'U' 'U' 'U' 'M' 'U' 'A' 'M' 'A' 'A' 'A' 'A'
 'U' 'U' 'M' 'A' 'U' 'A' 'M' 'A' 'U' 'A' 'A' 'U' 'A' 'M' 'M' 'U' 'U' 'U'
 'A' 'M' 'A' 'A' 'U' 'U' 'M' 'U' 'U' 'U' 'A' 'M' 'M' 'M' 'M' 'M' 'M' 'M'
 'M' 'U' 'M' 'A' 'U' 'M' 'U' 'U' 'U' 'A' 'A' 'M' 'M' 'A' 'A' 'U' 'A' 'U'
 'U' 'U' 'M' 'U' 'U' 'A' 'U' 'U' 'M' 'A' 'U' 'U' 'M' 'M' 'U' 'U' 'A' 'A'
 'A' 'A' 'U' 'A' 'M' 'M' 'A' 'U' 'A' 'U' 'A' 'M' 'A' 'A' 'U' 'M' 'U' 'A'
 'U' 'M' 'A' 'A' 'U' 'A' 'A' 'A' 'A' 'A' 'A' 'A' 'A' 'M' 'A' 'M' 'M' 'U'
 'A' 'U' 'M' 'U' 'U' 'A' 'A' 'A' 'U' 'M' 'U' 'U' 'M' 'A' 'M' 'M' 'U' 'M'
 'A' 'M' 'U' 'M' 'M' 'A' 'A' 'A' 'A' 'A' 'A' 'U' 'U' 'A' 'M' 'M' 'U' 'U'
 'U' 'U' 'M' 'M' 'A' 'M' 'M' 'A' 'A' 'U' 'U' 'A' 'M' 'A' 'M' 'A' 'A' 'A']"
18901,2,142,73,69,56,1,0,"['A' 'M' 'M' 'A' 'U' 'M' 'U' 'M' 'M' 'M' 'A' 'A' 'A' 'A' 'U' 'U' 'A' 'M'
 'M' 'A' 'M' 'M' 'M' 'U' 'M' 'U' 'U' 'U' 'M' 'U' 'A' 'M' 'A' 'U' 'A' 'A'
 'U' 'A' 'M' 'A' 'U' 'A' 'M' 'A' 'A' 'A' 'A' 'U' 'A' 'M' 'M' 'M' 'M' 'U'
 'U' 'M' 'A' 'A' 'U' 'U' 'U' 'M' 'U' 'A' 'A' 'M' 'M' 'M' 'M' 'M' 'M' 'M'
 'M' 'U' 'M' 'A' 'M' 'M' 'U' 'U' 'U' 'A' 'U' 'M' 'M' 'A' 'A' 'A' 'A' 'U'
 'A' 'U' 'M' 'U' 'U' 'U' 'M' 'U' 'M' 'A' 'U' 'M' 'U' 'M' 'M' 'U' 'A' 'U'
 'A' 'A' 'U' 'U' 'M' 'A' 'A' 'U' 'A' 'U' 'A' 'M' 'A' 'A' 'U' 'M' 'A' 'A'
 'A' 'M' 'A' 'A' 'A' 'A' 'A' 'A' 'A' 'A' 'A' 'A' 'A' 'M' 'A' 'M' 'M' 'U'
 'A' 'M' 'M' 'U' 'A' 'M' 'M' 'A' 'A' 'M' 'U' 'U' 'M' 'A' 'M' 'M' 'U' 'M'
 'A' 'M' 'U' 'M' 'M' 'A' 'M' 'U' 'A' 'A' 'A' 'U' 'U' 'U' 'U' 'M' 'M' 'U'
 'U' 'U' 'M' 'M' 'U' 'M' 'M' 'U' 'A' 'U' 'A' 'A' 'M' 'A' 'M' 'A' 'A' 'A']"
19001,1,137,72,65,61,1,0,"['A' 'M' 'M' 'A' 'M' 'M' 'U' 'U' 'M' 'M' 'A' 'A' 'U' 'A' 'A' 'U' 'A' 'U'
 'M' 'A' 'M' 'M' 'M' 'U' 'M' 'U' 'U' 'A' 'M' 'A' 'A' 'M' 'A' 'U' 'U' 'A'
 'U' 'U' 'M' 'U' 'M' 'A' 'M' 'A' 'A' 'A' 'U' 'U' 'A' 'M' 'M' 'M' 'M' 'U'
 'U' 'M' 'A' 'A' 'U' 'U' 'U' 'M' 'U' 'A' 'A' 'U' 'M' 'M' 'M' 'M' 'M' 'M'
 'M' 'M' 'M' 'U' 'M' 'M' 'A' 'A' 'U' 'A' 'U' 'M' 'M' 'U' 'A' 'A' 'A' 'U'
 'A' 'U' 'M' 'A' 'U' 'U' 'M' 'U' 'M' 'U' 'U' 'U' 'U' 'U' 'M' 'U' 'M' 'U'
 'A' 'A' 'U' 'M' 'M' 'A' 'A' 'U' 'A' 'U' 'A' 'M' 'A' 'A' 'U' 'M' 'A' 'A'
 'A' 'M' 'A' 'A' 'A' 'A' 'A' 'A' 'A' 'A' 'A' 'A' 'A' 'U' 'U' 'U' 'M' 'U'
 'A' 'M' 'M' 'U' 'A' 'A' 'M' 'A' 'A' 'U' 'A' 'U' 'M' 'A' 'M' 'M' 'A' 'M'
 'U' 'M' 'A' 'M' 'M' 'A' 'M' 'M' 'A' 'U' 'A' 'M' 'U' 'U' 'U' 'M' 'U' 'M'
 'U' 'A' 'U' 'M' 'A' 'M' 'M' 'U' 'A' 'U' 'A' 'A' 'M' 'U' 'U' 'A' 'A' 'A']"
19101,2,133,77,56,65,0,1,"['A' 'U' 'M' 'U' 'M' 'M' 'A' 'U' 'M' 'M' 'U' 'A' 'M' 'A' 'A' 'U' 'U' 'U'
 'M' 'A' 'U' 'M' 'M' 'U' 'U' 'A' 'U' 'A' 'M' 'A' 'A' 'U' 'U' 'A' 'U' 'U'
 'U' 'U' 'U' 'U' 'M' 'A' 'M' 'A' 'A' 'M' 'M' 'U' 'A' 'M' 'M' 'M' 'M' 'U'
 'U' 'M' 'A' 'A' 'U' 'U' 'U' 'M' 'U' 'A' 'A' 'U' 'M' 'M' 'M' 'M' 'M' 'M'
 'M' 'M' 'M' 'U' 'M' 'U' 'A' 'A' 'U' 'A' 'A' 'A' 'M' 'U' 'A' 'A' 'U' 'A'
 'A' 'M' 'M' 'A' 'U' 'M' 'M' 'U' 'U' 'U' 'A' 'U' 'M' 'U' 'U' 'A' 'M' 'U'
 'A' 'A' 'U' 'U' 'M' 'A' 'A' 'U' 'A' 'U' 'U' 'M' 'A' 'A' 'A' 'M' 'A' 'A'
 'A' 'M' 'A' 'A' 'A' 'A' 'U' 'A' 'A' 'A' 'U' 'A' 'A' 'U' 'U' 'U' 'U' 'U'
 'A' 'M' 'M' 'U' 'A' 'A' 'U' 'A' 'A' 'A' 'A' 'A' 'M' 'A' 'M' 'M' 'A' 'M'
 'A' 'M' 'A' 'U' 'A' 'A' 'M' 'M' 'U' 'U' 'A' 'M' 'A' 'A' 'U' 'M' 'U' 'U'
 'U' 'U' 'U' 'M' 'A' 'M' 'M' 'A' 'A' 'U' 'A' 'A' 'M' 'U' 'A' 'A' 'A' 'A']"
19201,2,129,79,50,69,0,0,"['A' 'U' 'A' 'M' 'M' 'M' 'A' 'U' 'A' 'U' 'U' 'A' 'U' 'U' 'A' 'A' 'U' 'U'
 'M' 'A' 'U' 'U' 'U' 'U' 'M' 'U' 'U' 'U' 'M' 'U' 'A' 'U' 'M' 'A' 'M' 'U'
 'U' 'U' 'U' 'U' 'M' 'A' 'M' 'A' 'A' 'U' 'M' 'U' 'A' 'M' 'M' 'M' 'M' 'U'
 'U' 'M' 'A' 'A' 'A' 'U' 'U' 'M' 'U' 'A' 'A' 'M' 'M' 'M' 'M' 'M' 'U' 'M'
 'M' 'M' 'M' 'A' 'M' 'U' 'A' 'A' 'U' 'U' 'U' 'A' 'M' 'U' 'A' 'M' 'U' 'A'
 'A' 'M' 'U' 'A' 'U' 'M' 'M' 'M' 'A' 'U' 'A' 'U' 'U' 'U' 'U' 'A' 'M' 'U'
 'A' 'A' 'U' 'U' 'M' 'A' 'U' 'U' 'A' 'U' 'M' 'U' 'A' 'A' 'A' 'M' 'A' 'A'
 'U' 'M' 'A' 'A' 'A' 'A' 'A' 'A' 'A' 'A' 'A' 'A' 'A' 'U' 'U' 'U' 'A' 'U'
 'A' 'M' 'U' 'U' 'A' 'A' 'A' 'A' 'A' 'A' 'A' 'A' 'M' 'A' 'M' 'M' 'A' 'U'
 'A' 'U' 'A' 'U' 'A' 'A' 'M' 'M' 'U' 'U' 'U' 'U' 'U' 'A' 'A' 'M' 'U' 'A'
 'M' 'A' 'A' 'M' 'A' 'M' 'M' 'A' 'A' 'U' 'A' 'A' 'M' 'U' 'A' 'A' 'A' 'U']"
19301,2,127,80,47,71,0,0,"['A' 'U' 'A' 'M' 'M' 'M' 'A' 'M' 'A' 'U' 'U' 'A' 'U' 'A' 'A' 'A' 'M' 'U'
 'A' 'A' 'U' 'U' 'U' 'U' 'U' 'M' 'U' 'A' 'U' 'A' 'A' 'U' 'M' 'U' 'M' 'A'
 'M' 'U' 'U' 'U' 'M' 'M' 'U' 'A' 'A' 'U' 'U' 'A' 'A' 'M' 'M' 'M' 'M' 'U'
 'U' 'M' 'A' 'A' 'A' 'U' 'U' 'A' 'U' 'U' 'A' 'M' 'M' 'M' 'M' 'U' 'M' 'M'
 'M' 'M' 'M' 'A' 'M' 'U' 'A' 'A' 'U' 'U' 'A' 'U' 'M' 'U' 'A' 'M' 'U' 'A'
 'U' 'M' 'U' 'A' 'U' 'M' 'M' 'M' 'A' 'U' 'A' 'U' 'A' 'U' 'U' 'A' 'M' 'U'
 'A' 'A' 'U' 'A' 'M' 'A' 'U' 'U' 'A' 'U' 'U' 'U' 'A' 'A' 'A' 'M' 'A' 'A'
 'U' 'M' 'A' 'A' 'A' 'A' 'A' 'A' 'A' 'A' 'A' 'A' 'A' 'U' 'U' 'U' 'A' 'U'
 'U' 'U' 'U' 'U' 'A' 'A' 'A' 'A' 'A' 'U' 'A' 'A' 'M' 'A' 'M' 'U' 'U' 'A'
 'U' 'U' 'A' 'M' 'M' 'A' 'M' 'U' 'U' 'U' 'U' 'M' 'U' 'A' 'A' 'M' 'A' 'A'
 'M' 'A' 'A' 'M' 'U' 'M' 'M' 'A' 'A' 'U' 'A' 'A' 'U' 'A' 'U' 'A' 'A' 'U']"
19401,1,114,69,45,84,0,1,"['A' 'U' 'M' 'U' 'M' 'M' 'A' 'M' 'A' 'U' 'U' 'A' 'U' 'A' 'A' 'A' 'M' 'U'
 'A' 'A' 'U' 'U' 'A' 'U' 'U' 'M' 'U' 'U' 'U' 'A' 'A' 'M' 'U' 'U' 'M' 'A'
 'M' 'M' 'U' 'U' 'U' 'M' 'U' 'A' 'A' 'U' 'U' 'A' 'U' 'M' 'M' 'M' 'M' 'M'
 'M' 'U' 'U' 'U' 'U' 'U' 'A' 'A' 'U' 'M' 'A' 'M' 'M' 'M' 'M' 'M' 'M' 'M'
 'M' 'U' 'M' 'A' 'M' 'U' 'A' 'A' 'U' 'U' 'A' 'A' 'M' 'U' 'A' 'M' 'U' 'A'
 'U' 'U' 'A' 'U' 'U' 'M' 'M' 'M' 'U' 'U' 'A' 'U' 'U' 'U' 'A' 'A' 'U' 'U'
 'A' 'A' 'U' 'A' 'U' 'A' 'M' 'U' 'A' 'U' 'U' 'U' 'U' 'A' 'U' 'M' 'A' 'U'
 'U' 'U' 'A' 'A' 'A' 'A' 'A' 'A' 'A' 'A' 'A' 'A' 'A' 'U' 'U' 'U' 'A' 'U'
 'A' 'U' 'U' 'U' 'A' 'A' 'U' 'U' 'A' 'U' 'A' 'A' 'U' 'A' 'M' 'U' 'U' 'U'
 'U' 'M' 'A' 'M' 'U' 'A' 'M' 'A' 'U' 'A' 'U' 'A' 'U' 'U' 'A' 'M' 'U' 'A'
 'M' 'A' 'A' 'M' 'M' 'M' 'M' 'U' 'U' 'U' 'A' 'A' 'U' 'U' 'U' 'A' 'A' 'U']"
19501,3,115,71,44,83,0,1,"['A' 'U' 'M' 'U' 'M' 'M' 'U' 'M' 'A' 'M' 'U' 'A' 'U' 'A' 'A' 'U' 'M' 'M'
 'U' 'U' 'U' 'U' 'A' 'U' 'A' 'M' 'A' 'A' 'U' 'U' 'A' 'U' 'A' 'M' 'M' 'A'
 'U' 'U' 'U' 'U' 'U' 'M' 'U' 'A' 'A' 'U' 'U' 'A' 'U' 'M' 'M' 'M' 'U' 'M'
 'M' 'A' 'U' 'M' 'U' 'U' 'A' 'U' 'U' 'M' 'A' 'M' 'M' 'M' 'M' 'M' 'M' 'M'
 'M' 'U' 'M' 'A' 'M' 'U' 'A' 'A' 'U' 'U' 'A' 'A' 'M' 'U' 'A' 'U' 'A' 'A'
 'A' 'U' 'A' 'U' 'A' 'U' 'M' 'M' 'A' 'M' 'U' 'U' 'U' 'A' 'A' 'A' 'U' 'U'
 'A' 'A' 'U' 'A' 'U' 'A' 'M' 'U' 'A' 'U' 'U' 'U' 'U' 'A' 'A' 'M' 'A' 'U'
 'A' 'U' 'U' 'A' 'A' 'U' 'A' 'A' 'A' 'A' 'A' 'A' 'A' 'A' 'U' 'U' 'U' 'A'
 'A' 'U' 'U' 'U' 'A' 'A' 'U' 'U' 'A' 'U' 'A' 'A' 'U' 'A' 'U' 'U' 'U' 'U'
 'A' 'M' 'A' 'M' 'U' 'A' 'M' 'A' 'U' 'A' 'U' 'U' 'U' 'U' 'M' 'M' 'A' 'M'
 'M' 'U' 'A' 'M' 'M' 'M' 'U' 'U' 'A' 'U' 'U' 'A' 'U' 'U' 'U' 'A' 'A' 'U']"
19601,0,127,77,50,71,0,0,"['A' 'A' 'M' 'A' 'M' 'M' 'U' 'M' 'A' 'U' 'U' 'U' 'U' 'M' 'A' 'U' 'U' 'M'
 'U' 'U' 'U' 'U' 'A' 'U' 'A' 'M' 'A' 'A' 'U' 'U' 'A' 'A' 'A' 'M' 'M' 'A'
 'U' 'A' 'U' 'A' 'A' 'M' 'U' 'A' 'A' 'U' 'U' 'A' 'U' 'M' 'U' 'M' 'U' 'M'
 'M' 'A' 'M' 'M' 'M' 'U' 'A' 'A' 'U' 'U' 'A' 'M' 'M' 'M' 'M' 'M' 'U' 'M'
 'M' 'M' 'M' 'A' 'M' 'U' 'A' 'A' 'A' 'U' 'A' 'A' 'M' 'U' 'A' 'U' 'A' 'U'
 'A' 'U' 'U' 'U' 'A' 'A' 'M' 'M' 'A' 'M' 'U' 'M' 'U' 'A' 'A' 'A' 'U' 'U'
 'A' 'A' 'M' 'A' 'U' 'A' 'M' 'U' 'U' 'M' 'U' 'M' 'A' 'U' 'A' 'U' 'A' 'U'
 'A' 'M' 'M' 'U' 'A' 'A' 'A' 'A' 'A' 'A' 'A' 'A' 'A' 'A' 'M' 'A' 'U' 'U'
 'A' 'A' 'U' 'A' 'A' 'A' 'U' 'U' 'A' 'U' 'A' 'U' 'M' 'A' 'U' 'U' 'U' 'M'
 'U' 'M' 'A' 'M' 'U' 'A' 'M' 'A' 'U' 'A' 'A' 'U' 'U' 'U' 'U' 'U' 'A' 'M'
 'M' 'U' 'U' 'M' 'M' 'U' 'M' 'M' 'A' 'A' 'U' 'U' 'A' 'U' 'A' 'A' 'A' 'U']"
19701,3,134,80,54,64,0,1,"['A' 'A' 'M' 'A' 'M' 'M' 'U' 'M' 'A' 'U' 'U' 'U' 'U' 'M' 'A' 'M' 'M' 'M'
 'U' 'A' 'U' 'U' 'A' 'A' 'A' 'M' 'M' 'A' 'U' 'U' 'A' 'A' 'A' 'U' 'M' 'A'
 'M' 'A' 'A' 'A' 'A' 'U' 'A' 'A' 'M' 'U' 'U' 'U' 'A' 'M' 'A' 'M' 'U' 'U'
 'M' 'A' 'M' 'M' 'M' 'M' 'A' 'A' 'U' 'M' 'U' 'M' 'M' 'M' 'M' 'U' 'M' 'M'
 'M' 'M' 'M' 'A' 'M' 'U' 'A' 'A' 'A' 'U' 'A' 'A' 'M' 'U' 'U' 'U' 'A' 'A'
 'A' 'M' 'U' 'U' 'A' 'A' 'M' 'M' 'A' 'M' 'A' 'M' 'U' 'A' 'A' 'A' 'U' 'U'
 'A' 'A' 'M' 'A' 'A' 'A' 'U' 'U' 'U' 'M' 'U' 'M' 'A' 'U' 'U' 'A' 'A' 'U'
 'A' 'M' 'M' 'U' 'U' 'A' 'A' 'A' 'A' 'A' 'A' 'U' 'A' 'A' 'M' 'A' 'U' 'U'
 'A' 'A' 'U' 'A' 'A' 'U' 'U' 'U' 'A' 'U' 'A' 'U' 'M' 'U' 'M' 'U' 'U' 'M'
 'U' 'M' 'U' 'M' 'U' 'A' 'M' 'A' 'A' 'A' 'A' 'U' 'U' 'A' 'A' 'U' 'A' 'M'
 'M' 'U' 'A' 'U' 'M' 'U' 'M' 'M' 'A' 'A' 'U' 'U' 'A' 'U' 'A' 'A' 'A' 'U']"
19801,2,141,81,60,57,0,1,"['A' 'A' 'M' 'A' 'M' 'M' 'U' 'M' 'A' 'A' 'U' 'U' 'U' 'M' 'U' 'M' 'M' 'M'
 'M' 'U' 'U' 'U' 'A' 'A' 'U' 'M' 'M' 'A' 'M' 'A' 'A' 'A' 'A' 'A' 'M' 'A'
 'M' 'U' 'A' 'A' 'A' 'U' 'A' 'A' 'M' 'U' 'U' 'U' 'A' 'M' 'A' 'U' 'U' 'M'
 'M' 'A' 'M' 'M' 'M' 'M' 'A' 'A' 'U' 'U' 'M' 'M' 'M' 'M' 'M' 'M' 'M' 'U'
 'M' 'M' 'M' 'U' 'U' 'U' 'U' 'A' 'A' 'U' 'A' 'A' 'M' 'M' 'U' 'A' 'U' 'A'
 'A' 'M' 'U' 'U' 'A' 'U' 'M' 'M' 'A' 'M' 'A' 'M' 'A' 'A' 'A' 'U' 'U' 'A'
 'A' 'A' 'M' 'A' 'A' 'A' 'M' 'A' 'U' 'M' 'U' 'U' 'A' 'U' 'A' 'A' 'A' 'A'
 'A' 'M' 'M' 'U' 'U' 'A' 'A' 'A' 'A' 'A' 'A' 'A' 'A' 'A' 'U' 'M' 'A' 'A'
 'A' 'U' 'U' 'A' 'A' 'U' 'M' 'M' 'U' 'U' 'M' 'U' 'M' 'U' 'M' 'A' 'A' 'M'
 'M' 'U' 'U' 'M' 'U' 'A' 'M' 'U' 'A' 'A' 'A' 'U' 'U' 'A' 'A' 'A' 'A' 'M'
 'M' 'U' 'A' 'U' 'M' 'U' 'M' 'M' 'A' 'A' 'A' 'U' 'A' 'U' 'U' 'A' 'A' 'M']"
19901,2,125,70,55,73,0,0,"['A' 'U' 'M' 'A' 'M' 'M' 'U' 'M' 'A' 'U' 'U' 'U' 'U' 'M' 'U' 'M' 'M' 'M'
 'M' 'U' 'U' 'U' 'A' 'U' 'U' 'M' 'M' 'A' 'U' 'A' 'U' 'A' 'U' 'A' 'U' 'U'
 'M' 'U' 'U' 'U' 'U' 'U' 'A' 'A' 'M' 'U' 'U' 'A' 'U' 'M' 'A' 'U' 'U' 'M'
 'M' 'A' 'M' 'M' 'U' 'M' 'A' 'A' 'U' 'U' 'M' 'M' 'M' 'M' 'M' 'M' 'M' 'M'
 'M' 'M' 'U' 'U' 'U' 'U' 'U' 'A' 'A' 'U' 'U' 'A' 'M' 'U' 'U' 'A' 'U' 'A'
 'A' 'M' 'U' 'M' 'A' 'M' 'M' 'M' 'A' 'M' 'A' 'M' 'A' 'A' 'A' 'U' 'U' 'A'
 'A' 'A' 'M' 'A' 'A' 'A' 'M' 'A' 'A' 'M' 'U' 'U' 'A' 'M' 'U' 'A' 'U' 'U'
 'A' 'A' 'M' 'U' 'U' 'A' 'A' 'A' 'A' 'A' 'A' 'A' 'A' 'U' 'A' 'M' 'A' 'U'
 'A' 'A' 'U' 'A' 'A' 'U' 'M' 'M' 'M' 'U' 'U' 'U' 'M' 'U' 'M' 'A' 'A' 'U'
 'A' 'A' 'U' 'M' 'U' 'A' 'M' 'U' 'A' 'U' 'U' 'U' 'A' 'U' 'U' 'A' 'A' 'M'
 'M' 'U' 'A' 'U' 'M' 'U' 'M' 'U' 'A' 'A' 'A' 'A' 'A' 'M' 'A' 'U' 'A' 'U']"
20001,3,126,72,54,72,1,0,"['A' 'A' 'M' 'A' 'M' 'M' 'U' 'M' 'A' 'U' 'U' 'M' 'U' 'U' 'A' 'M' 'M' 'A'
 'M' 'U' 'U' 'M' 'U' 'U' 'M' 'M' 'U' 'A' 'U' 'A' 'U' 'U' 'U' 'U' 'M' 'U'
 'M' 'U' 'A' 'U' 'U' 'U' 'A' 'A' 'U' 'U' 'M' 'A' 'U' 'M' 'A' 'U' 'U' 'U'
 'M' 'A' 'M' 'U' 'U' 'M' 'A' 'A' 'U' 'U' 'U' 'M' 'M' 'M' 'M' 'M' 'M' 'M'
 'M' 'M' 'U' 'U' 'U' 'U' 'U' 'A' 'A' 'M' 'A' 'A' 'M' 'M' 'U' 'A' 'M' 'A'
 'A' 'U' 'A' 'U' 'A' 'M' 'M' 'M' 'U' 'U' 'U' 'U' 'A' 'A' 'A' 'A' 'M' 'A'
 'A' 'A' 'M' 'A' 'A' 'A' 'U' 'A' 'U' 'M' 'U' 'U' 'A' 'U' 'U' 'A' 'A' 'M'
 'U' 'A' 'M' 'A' 'M' 'A' 'A' 'A' 'A' 'A' 'A' 'A' 'A' 'U' 'A' 'M' 'M' 'A'
 'M' 'A' 'M' 'A' 'A' 'U' 'M' 'M' 'M' 'U' 'U' 'U' 'U' 'U' 'U' 'A' 'U' 'A'
 'A' 'A' 'U' 'U' 'U' 'A' 'M' 'U' 'A' 'M' 'A' 'U' 'A' 'U' 'U' 'A' 'A' 'M'
 'U' 'U' 'A' 'M' 'M' 'A' 'U' 'M' 'A' 'A' 'A' 'A' 'U' 'M' 'A' 'U' 'A' 'U']"
20101,0,123,67,56,75,1,0,"['A' 'U' 'A' 'A' 'M' 'M' 'U' 'U' 'A' 'A' 'A' 'M' 'U' 'M' 'A' 'M' 'M' 'U'
 'U' 'M' 'U' 'M' 'A' 'U' 'M' 'U' 'U' 'A' 'M' 'U' 'U' 'U' 'U' 'U' 'U' 'U'
 'M' 'M' 'U' 'M' 'U' 'U' 'A' 'A' 'U' 'U' 'A' 'A' 'U' 'M' 'A' 'U' 'U' 'U'
 'U' 'A' 'M' 'U' 'M' 'M' 'A' 'A' 'U' 'A' 'U' 'M' 'U' 'M' 'M' 'M' 'M' 'M'
 'M' 'M' 'M' 'U' 'U' 'U' 'U' 'A' 'U' 'M' 'A' 'A' 'M' 'M' 'U' 'A' 'M' 'A'
 'A' 'U' 'A' 'M' 'A' 'M' 'U' 'M' 'M' 'U' 'A' 'A' 'A' 'A' 'A' 'U' 'M' 'A'
 'A' 'U' 'M' 'A' 'A' 'A' 'U' 'A' 'M' 'M' 'U' 'U' 'U' 'U' 'M' 'A' 'A' 'M'
 'U' 'U' 'M' 'A' 'M' 'A' 'A' 'A' 'A' 'A' 'A' 'A' 'A' 'A' 'A' 'M' 'U' 'A'
 'M' 'U' 'M' 'U' 'U' 'M' 'U' 'A' 'M' 'U' 'M' 'A' 'U' 'M' 'U' 'A' 'U' 'U'
 'U' 'A' 'U' 'U' 'U' 'A' 'M' 'U' 'A' 'M' 'A' 'A' 'A' 'M' 'U' 'A' 'A' 'U'
 'U' 'U' 'A' 'M' 'M' 'A' 'U' 'M' 'U' 'A' 'A' 'A' 'U' 'M' 'U' 'U' 'U' 'U']"
20201,1,122,63,59,76,1,0,"['A' 'M' 'A' 'A' 'M' 'M' 'U' 'U' 'A' 'A' 'A' 'M' 'U' 'M' 'A' 'U' 'U' 'M'
 'U' 'U' 'U' 'M' 'A' 'M' 'M' 'U' 'U' 'A' 'M' 'U' 'U' 'U' 'U' 'U' 'M' 'M'
 'M' 'U' 'U' 'M' 'U' 'U' 'A' 'A' 'U' 'U' 'A' 'U' 'U' 'M' 'U' 'U' 'U' 'U'
 'U' 'A' 'M' 'U' 'U' 'M' 'A' 'A' 'U' 'M' 'A' 'U' 'M' 'M' 'M' 'M' 'M' 'M'
 'M' 'M' 'M' 'U' 'A' 'U' 'M' 'A' 'U' 'M' 'A' 'A' 'M' 'M' 'U' 'A' 'M' 'A'
 'A' 'U' 'A' 'M' 'A' 'M' 'U' 'M' 'M' 'U' 'A' 'A' 'A' 'A' 'A' 'U' 'M' 'A'
 'U' 'U' 'M' 'U' 'A' 'A' 'U' 'A' 'U' 'M' 'M' 'U' 'U' 'U' 'M' 'A' 'A' 'M'
 'U' 'U' 'M' 'U' 'M' 'A' 'A' 'A' 'A' 'A' 'A' 'A' 'U' 'A' 'A' 'U' 'U' 'A'
 'M' 'U' 'M' 'U' 'U' 'U' 'U' 'U' 'M' 'U' 'U' 'A' 'M' 'M' 'A' 'A' 'A' 'U'
 'U' 'U' 'U' 'U' 'U' 'A' 'U' 'U' 'A' 'M' 'A' 'A' 'A' 'M' 'A' 'A' 'M' 'U'
 'M' 'U' 'A' 'M' 'M' 'A' 'A' 'M' 'U' 'A' 'A' 'A' 'U' 'M' 'U' 'U' 'M' 'M']"
20301,2,115,65,50,83,0,0,"['A' 'M' 'A' 'A' 'M' 'U' 'U' 'U' 'A' 'U' 'A' 'U' 'U' 'U' 'A' 'U' 'U' 'M'
 'U' 'U' 'U' 'M' 'A' 'M' 'U' 'A' 'U' 'A' 'M' 'M' 'U' 'U' 'A' 'A' 'M' 'M'
 'M' 'U' 'U' 'M' 'A' 'U' 'A' 'U' 'U' 'U' 'A' 'U' 'U' 'U' 'U' 'U' 'A' 'U'
 'A' 'U' 'U' 'U' 'U' 'M' 'A' 'A' 'U' 'M' 'U' 'M' 'M' 'M' 'M' 'M' 'M' 'M'
 'U' 'M' 'M' 'U' 'A' 'U' 'U' 'A' 'A' 'M' 'A' 'A' 'M' 'M' 'U' 'U' 'M' 'A'
 'A' 'A' 'A' 'M' 'A' 'M' 'U' 'U' 'A' 'U' 'U' 'U' 'A' 'A' 'A' 'U' 'M' 'A'
 'U' 'U' 'M' 'U' 'A' 'A' 'U' 'A' 'A' 'M' 'M' 'U' 'U' 'U' 'U' 'U' 'A' 'M'
 'U' 'U' 'M' 'U' 'M' 'A' 'A' 'A' 'A' 'A' 'A' 'A' 'U' 'A' 'A' 'U' 'A' 'A'
 'M' 'U' 'M' 'U' 'U' 'U' 'U' 'U' 'M' 'U' 'U' 'A' 'M' 'U' 'A' 'U' 'A' 'A'
 'M' 'M' 'A' 'A' 'M' 'A' 'U' 'M' 'A' 'M' 'U' 'A' 'U' 'A' 'A' 'A' 'U' 'U'
 'M' 'U' 'A' 'M' 'U' 'A' 'A' 'M' 'M' 'U' 'U' 'A' 'U' 'U' 'U' 'U' 'M' 'M']"
20401,2,124,76,48,74,1,0,"['A' 'M' 'A' 'A' 'M' 'U' 'U' 'U' 'U' 'M' 'A' 'U' 'A' 'U' 'A' 'U' 'A' 'U'
 'U' 'U' 'U' 'M' 'A' 'U' 'M' 'A' 'U' 'A' 'U' 'M' 'A' 'A' 'A' 'A' 'M' 'M'
 'U' 'U' 'U' 'M' 'A' 'A' 'A' 'A' 'A' 'U' 'U' 'A' 'U' 'U' 'A' 'U' 'M' 'U'
 'A' 'U' 'U' 'U' 'U' 'A' 'A' 'A' 'A' 'A' 'M' 'M' 'M' 'M' 'M' 'M' 'M' 'M'
 'U' 'M' 'M' 'U' 'A' 'M' 'U' 'A' 'A' 'M' 'A' 'A' 'M' 'M' 'U' 'M' 'M' 'A'
 'A' 'U' 'A' 'M' 'A' 'M' 'A' 'U' 'A' 'A' 'U' 'U' 'U' 'A' 'U' 'A' 'M' 'U'
 'U' 'U' 'U' 'U' 'A' 'A' 'U' 'A' 'A' 'M' 'M' 'U' 'A' 'U' 'A' 'U' 'A' 'M'
 'U' 'M' 'M' 'U' 'U' 'A' 'A' 'A' 'A' 'A' 'A' 'A' 'U' 'U' 'A' 'U' 'A' 'A'
 'M' 'U' 'M' 'U' 'U' 'A' 'U' 'U' 'M' 'U' 'M' 'A' 'M' 'A' 'A' 'U' 'A' 'A'
 'M' 'M' 'A' 'U' 'M' 'A' 'M' 'M' 'A' 'M' 'U' 'A' 'U' 'A' 'A' 'A' 'A' 'U'
 'U' 'U' 'A' 'M' 'U' 'U' 'A' 'M' 'U' 'U' 'U' 'A' 'U' 'U' 'U' 'A' 'U' 'M']"
20501,0,128,72,56,70,0,0,"['A' 'M' 'A' 'A' 'M' 'U' 'U' 'U' 'A' 'M' 'A' 'U' 'A' 'U' 'A' 'U' 'A' 'M'
 'A' 'U' 'U' 'M' 'A' 'U' 'M' 'A' 'U' 'U' 'U' 'M' 'A' 'A' 'A' 'A' 'M' 'M'
 'U' 'M' 'U' 'M' 'A' 'A' 'A' 'A' 'A' 'U' 'U' 'A' 'M' 'M' 'A' 'U' 'M' 'M'
 'A' 'U' 'U' 'U' 'M' 'A' 'A' 'A' 'A' 'U' 'U' 'M' 'M' 'M' 'M' 'M' 'M' 'M'
 'M' 'U' 'M' 'U' 'A' 'A' 'U' 'A' 'A' 'M' 'A' 'A' 'M' 'M' 'U' 'M' 'M' 'U'
 'A' 'U' 'A' 'M' 'A' 'M' 'A' 'A' 'A' 'U' 'U' 'M' 'M' 'A' 'U' 'A' 'M' 'U'
 'A' 'M' 'U' 'U' 'U' 'A' 'U' 'A' 'A' 'M' 'U' 'U' 'A' 'U' 'U' 'M' 'A' 'M'
 'U' 'M' 'M' 'M' 'U' 'U' 'A' 'A' 'A' 'A' 'A' 'A' 'A' 'U' 'U' 'U' 'A' 'U'
 'U' 'U' 'M' 'A' 'M' 'U' 'U' 'U' 'M' 'U' 'M' 'A' 'M' 'U' 'A' 'U' 'A' 'A'
 'M' 'M' 'A' 'A' 'M' 'U' 'M' 'M' 'A' 'M' 'U' 'A' 'M' 'A' 'A' 'A' 'U' 'U'
 'U' 'U' 'A' 'U' 'U' 'U' 'U' 'U' 'U' 'M' 'U' 'A' 'A' 'U' 'U' 'A' 'A' 'M']"
20601,0,132,73,59,66,0,0,"['A' 'M' 'A' 'A' 'M' 'U' 'A' 'U' 'U' 'U' 'A' 'U' 'A' 'M' 'A' 'U' 'A' 'U'
 'U' 'M' 'U' 'M' 'A' 'U' 'M' 'A' 'A' 'U' 'U' 'M' 'A' 'A' 'A' 'A' 'M' 'M'
 'M' 'M' 'A' 'M' 'U' 'A' 'A' 'A' 'A' 'U' 'U' 'A' 'M' 'M' 'A' 'U' 'M' 'M'
 'A' 'U' 'A' 'U' 'M' 'A' 'A' 'U' 'A' 'U' 'U' 'U' 'M' 'M' 'M' 'M' 'M' 'M'
 'M' 'M' 'M' 'U' 'A' 'A' 'U' 'A' 'A' 'M' 'A' 'A' 'M' 'M' 'U' 'M' 'A' 'U'
 'A' 'U' 'A' 'M' 'A' 'M' 'U' 'A' 'A' 'U' 'M' 'M' 'U' 'A' 'A' 'U' 'U' 'U'
 'A' 'M' 'A' 'A' 'M' 'A' 'U' 'A' 'A' 'M' 'U' 'U' 'U' 'M' 'U' 'M' 'A' 'M'
 'U' 'M' 'M' 'M' 'M' 'A' 'A' 'A' 'A' 'A' 'A' 'A' 'A' 'U' 'U' 'A' 'A' 'U'
 'U' 'U' 'U' 'A' 'M' 'A' 'U' 'U' 'M' 'U' 'M' 'U' 'U' 'M' 'U' 'M' 'A' 'U'
 'M' 'M' 'A' 'A' 'U' 'U' 'M' 'M' 'U' 'M' 'U' 'A' 'M' 'A' 'A' 'A' 'U' 'U'
 'M' 'A' 'U' 'U' 'U' 'U' 'U' 'U' 'U' 'M' 'A' 'A' 'A' 'A' 'U' 'A' 'M' 'M']"
20701,3,125,66,59,73,0,1,"['A' 'M' 'A' 'A' 'M' 'M' 'U' 'U' 'A' 'U' 'U' 'U' 'U' 'M' 'A' 'U' 'A' 'M'
 'M' 'M' 'U' 'U' 'A' 'U' 'M' 'A' 'A' 'U' 'U' 'M' 'A' 'A' 'A' 'A' 'M' 'M'
 'M' 'M' 'U' 'M' 'U' 'A' 'U' 'A' 'U' 'U' 'U' 'A' 'M' 'M' 'A' 'U' 'M' 'U'
 'A' 'U' 'M' 'U' 'M' 'A' 'A' 'A' 'A' 'M' 'A' 'M' 'M' 'U' 'M' 'M' 'M' 'M'
 'M' 'M' 'M' 'U' 'A' 'A' 'U' 'A' 'U' 'M' 'A' 'A' 'U' 'U' 'U' 'M' 'A' 'U'
 'A' 'U' 'A' 'U' 'A' 'U' 'U' 'A' 'A' 'M' 'M' 'U' 'U' 'A' 'A' 'U' 'U' 'U'
 'U' 'M' 'A' 'A' 'M' 'A' 'U' 'A' 'U' 'M' 'A' 'U' 'A' 'M' 'U' 'M' 'A' 'M'
 'A' 'M' 'M' 'U' 'M' 'A' 'A' 'A' 'A' 'A' 'A' 'A' 'A' 'U' 'U' 'A' 'U' 'U'
 'U' 'A' 'U' 'A' 'M' 'U' 'M' 'U' 'M' 'U' 'M' 'U' 'U' 'M' 'U' 'U' 'A' 'U'
 'M' 'M' 'U' 'A' 'U' 'U' 'M' 'M' 'U' 'M' 'U' 'A' 'M' 'A' 'U' 'A' 'U' 'M'
 'M' 'A' 'U' 'U' 'M' 'U' 'U' 'U' 'U' 'M' 'A' 'A' 'A' 'A' 'U' 'A' 'M' 'M']"
20801,1,126,64,62,72,1,0,"['A' 'M' 'A' 'A' 'M' 'M' 'M' 'U' 'A' 'U' 'U' 'A' 'M' 'U' 'A' 'M' 'A' 'M'
 'M' 'U' 'U' 'U' 'U' 'M' 'U' 'A' 'A' 'U' 'U' 'M' 'A' 'A' 'A' 'A' 'M' 'M'
 'M' 'M' 'U' 'M' 'U' 'A' 'M' 'A' 'U' 'A' 'U' 'A' 'M' 'M' 'A' 'U' 'M' 'M'
 'A' 'U' 'U' 'U' 'M' 'A' 'U' 'A' 'M' 'M' 'A' 'M' 'M' 'M' 'M' 'M' 'M' 'M'
 'U' 'M' 'M' 'U' 'A' 'M' 'U' 'A' 'U' 'M' 'A' 'A' 'U' 'U' 'U' 'M' 'A' 'U'
 'A' 'U' 'A' 'U' 'A' 'U' 'U' 'A' 'A' 'M' 'U' 'M' 'M' 'A' 'U' 'U' 'U' 'U'
 'U' 'A' 'A' 'U' 'M' 'U' 'A' 'A' 'U' 'M' 'A' 'U' 'U' 'U' 'U' 'A' 'A' 'M'
 'A' 'M' 'M' 'U' 'M' 'A' 'A' 'A' 'A' 'A' 'A' 'A' 'A' 'U' 'U' 'A' 'A' 'U'
 'A' 'A' 'U' 'U' 'M' 'M' 'M' 'U' 'M' 'M' 'M' 'U' 'M' 'A' 'A' 'U' 'A' 'U'
 'M' 'M' 'U' 'A' 'A' 'U' 'U' 'M' 'M' 'M' 'U' 'U' 'M' 'A' 'M' 'A' 'U' 'U'
 'M' 'U' 'U' 'U' 'M' 'U' 'U' 'U' 'U' 'M' 'A' 'A' 'A' 'U' 'U' 'A' 'U' 'M']"
20901,0,118,66,52,80,1,0,"['A' 'M' 'A' 'A' 'M' 'M' 'M' 'U' 'A' 'U' 'A' 'A' 'M' 'U' 'A' 'U' 'A' 'M'
 'M' 'U' 'U' 'U' 'U' 'M' 'U' 'A' 'A' 'U' 'U' 'M' 'A' 'U' 'A' 'A' 'M' 'M'
 'M' 'U' 'U' 'U' 'A' 'U' 'U' 'U' 'U' 'A' 'U' 'A' 'M' 'M' 'A' 'U' 'M' 'U'
 'A' 'U' 'U' 'A' 'M' 'A' 'U' 'A' 'M' 'M' 'A' 'M' 'M' 'M' 'M' 'M' 'M' 'U'
 'M' 'M' 'M' 'U' 'A' 'U' 'U' 'A' 'M' 'M' 'A' 'A' 'A' 'U' 'U' 'U' 'A' 'A'
 'U' 'U' 'U' 'U' 'A' 'U' 'U' 'A' 'A' 'M' 'A' 'M' 'U' 'A' 'U' 'U' 'U' 'U'
 'U' 'A' 'A' 'U' 'U' 'U' 'A' 'A' 'U' 'M' 'U' 'A' 'U' 'U' 'U' 'M' 'A' 'M'
 'A' 'M' 'U' 'A' 'M' 'A' 'A' 'A' 'A' 'A' 'A' 'A' 'A' 'M' 'U' 'A' 'A' 'U'
 'A' 'A' 'U' 'U' 'M' 'M' 'M' 'U' 'M' 'M' 'U' 'U' 'U' 'U' 'A' 'U' 'U' 'U'
 'M' 'M' 'U' 'A' 'A' 'U' 'U' 'M' 'M' 'U' 'M' 'U' 'M' 'A' 'M' 'U' 'U' 'U'
 'M' 'A' 'A' 'U' 'M' 'U' 'U' 'A' 'A' 'M' 'A' 'A' 'A' 'U' 'U' 'A' 'U' 'U']"
21001,1,113,58,55,85,0,1,"['A' 'M' 'U' 'A' 'U' 'M' 'M' 'U' 'A' 'U' 'A' 'A' 'M' 'U' 'A' 'U' 'U' 'M'
 'M' 'U' 'U' 'U' 'A' 'M' 'U' 'A' 'A' 'A' 'U' 'M' 'U' 'U' 'U' 'A' 'M' 'M'
 'M' 'M' 'U' 'U' 'A' 'U' 'U' 'U' 'U' 'U' 'A' 'A' 'M' 'U' 'A' 'U' 'M' 'M'
 'A' 'U' 'A' 'A' 'M' 'A' 'U' 'A' 'M' 'M' 'A' 'M' 'M' 'M' 'M' 'M' 'M' 'M'
 'M' 'M' 'U' 'U' 'A' 'U' 'A' 'U' 'M' 'M' 'A' 'A' 'A' 'U' 'U' 'U' 'A' 'A'
 'A' 'U' 'U' 'U' 'U' 'A' 'U' 'A' 'A' 'M' 'U' 'U' 'U' 'A' 'U' 'U' 'U' 'U'
 'U' 'A' 'U' 'M' 'U' 'U' 'A' 'A' 'U' 'M' 'U' 'A' 'U' 'U' 'U' 'M' 'A' 'M'
 'A' 'M' 'M' 'U' 'M' 'A' 'A' 'A' 'A' 'A' 'A' 'A' 'A' 'M' 'U' 'U' 'A' 'U'
 'A' 'A' 'U' 'U' 'U' 'M' 'M' 'U' 'M' 'M' 'U' 'U' 'A' 'U' 'U' 'U' 'U' 'U'
 'M' 'M' 'M' 'A' 'A' 'A' 'U' 'M' 'M' 'U' 'M' 'U' 'U' 'A' 'M' 'U' 'U' 'U'
 'M' 'M' 'U' 'U' 'M' 'M' 'U' 'A' 'M' 'M' 'A' 'U' 'U' 'U' 'U' 'A' 'U' 'U']"
21101,0,109,61,48,89,1,0,"['A' 'M' 'U' 'A' 'U' 'M' 'M' 'U' 'U' 'U' 'A' 'A' 'U' 'U' 'A' 'A' 'U' 'M'
 'U' 'U' 'U' 'U' 'A' 'U' 'U' 'A' 'U' 'A' 'U' 'M' 'U' 'U' 'U' 'U' 'M' 'U'
 'U' 'M' 'U' 'U' 'A' 'U' 'U' 'A' 'A' 'M' 'U' 'A' 'M' 'U' 'A' 'U' 'M' 'M'
 'U' 'U' 'A' 'A' 'M' 'A' 'U' 'A' 'M' 'U' 'U' 'M' 'M' 'M' 'M' 'U' 'M' 'M'
 'M' 'M' 'M' 'U' 'U' 'U' 'A' 'U' 'M' 'M' 'A' 'A' 'U' 'U' 'U' 'U' 'A' 'A'
 'A' 'A' 'U' 'U' 'U' 'A' 'A' 'U' 'A' 'M' 'M' 'U' 'U' 'U' 'U' 'U' 'U' 'U'
 'U' 'U' 'U' 'M' 'U' 'A' 'A' 'U' 'A' 'M' 'M' 'A' 'U' 'M' 'U' 'M' 'A' 'M'
 'A' 'M' 'M' 'A' 'M' 'A' 'A' 'A' 'A' 'A' 'A' 'A' 'A' 'M' 'U' 'U' 'A' 'U'
 'U' 'A' 'U' 'A' 'U' 'U' 'U' 'U' 'M' 'U' 'U' 'U' 'A' 'A' 'A' 'U' 'U' 'A'
 'M' 'M' 'M' 'A' 'A' 'A' 'U' 'M' 'M' 'A' 'M' 'A' 'U' 'A' 'M' 'U' 'A' 'U'
 'M' 'A' 'U' 'U' 'M' 'U' 'U' 'A' 'M' 'M' 'A' 'U' 'U' 'U' 'U' 'A' 'U' 'U']"
21201,3,111,62,49,87,1,0,"['A' 'U' 'U' 'M' 'U' 'M' 'M' 'M' 'U' 'U' 'A' 'A' 'U' 'U' 'A' 'A' 'A' 'M'
 'U' 'A' 'A' 'U' 'A' 'U' 'U' 'A' 'U' 'U' 'U' 'M' 'U' 'A' 'M' 'U' 'M' 'U'
 'U' 'M' 'U' 'U' 'A' 'A' 'U' 'A' 'A' 'U' 'A' 'A' 'M' 'U' 'A' 'U' 'M' 'M'
 'U' 'U' 'A' 'A' 'M' 'U' 'A' 'A' 'U' 'A' 'A' 'M' 'M' 'M' 'M' 'M' 'U' 'M'
 'M' 'M' 'M' 'U' 'U' 'M' 'U' 'M' 'M' 'M' 'U' 'A' 'A' 'M' 'U' 'U' 'A' 'A'
 'U' 'A' 'M' 'U' 'M' 'A' 'A' 'U' 'A' 'M' 'U' 'U' 'U' 'U' 'U' 'U' 'U' 'U'
 'U' 'U' 'U' 'M' 'U' 'A' 'A' 'U' 'A' 'M' 'M' 'U' 'U' 'M' 'A' 'M' 'A' 'M'
 'A' 'M' 'U' 'A' 'U' 'A' 'A' 'A' 'A' 'A' 'A' 'A' 'A' 'U' 'U' 'U' 'U' 'U'
 'U' 'A' 'M' 'U' 'U' 'U' 'U' 'M' 'M' 'U' 'U' 'U' 'A' 'U' 'A' 'M' 'U' 'A'
 'M' 'U' 'M' 'A' 'U' 'A' 'U' 'M' 'A' 'U' 'U' 'A' 'U' 'A' 'U' 'U' 'U' 'U'
 'M' 'A' 'A' 'U' 'M' 'U' 'U' 'A' 'M' 'U' 'A' 'A' 'U' 'M' 'M' 'A' 'U' 'U']"
21301,2,120,71,49,78,0,0,"['A' 'U' 'U' 'M' 'U' 'M' 'M' 'U' 'U' 'A' 'A' 'A' 'U' 'U' 'A' 'A' 'A' 'M'
 'M' 'M' 'A' 'U' 'A' 'A' 'U' 'A' 'U' 'M' 'U' 'M' 'U' 'A' 'M' 'U' 'M' 'U'
 'U' 'M' 'U' 'U' 'A' 'A' 'U' 'A' 'A' 'U' 'A' 'A' 'U' 'U' 'A' 'U' 'M' 'M'
 'U' 'U' 'A' 'A' 'M' 'U' 'A' 'A' 'U' 'U' 'A' 'M' 'M' 'U' 'M' 'M' 'M' 'M'
 'M' 'M' 'M' 'M' 'A' 'U' 'U' 'M' 'M' 'M' 'U' 'U' 'M' 'M' 'U' 'A' 'A' 'A'
 'M' 'A' 'M' 'U' 'M' 'A' 'A' 'A' 'A' 'M' 'U' 'U' 'A' 'A' 'U' 'A' 'U' 'U'
 'A' 'U' 'U' 'M' 'U' 'A' 'U' 'U' 'A' 'U' 'M' 'U' 'M' 'M' 'A' 'U' 'U' 'M'
 'A' 'U' 'U' 'A' 'U' 'M' 'A' 'A' 'A' 'A' 'A' 'A' 'A' 'M' 'U' 'U' 'A' 'U'
 'A' 'A' 'U' 'U' 'U' 'A' 'U' 'A' 'M' 'M' 'U' 'U' 'A' 'U' 'U' 'M' 'U' 'A'
 'M' 'U' 'M' 'A' 'A' 'A' 'U' 'U' 'A' 'U' 'U' 'A' 'A' 'A' 'U' 'U' 'U' 'A'
 'M' 'A' 'A' 'U' 'U' 'U' 'A' 'A' 'M' 'U' 'A' 'A' 'U' 'M' 'M' 'A' 'U' 'U']"
21401,1,114,64,50,84,1,0,"['A' 'U' 'A' 'M' 'U' 'M' 'U' 'U' 'A' 'A' 'U' 'A' 'U' 'M' 'A' 'U' 'A' 'M'
 'M' 'U' 'A' 'U' 'A' 'A' 'U' 'A' 'U' 'M' 'U' 'M' 'U' 'A' 'M' 'A' 'M' 'U'
 'U' 'M' 'U' 'M' 'A' 'A' 'A' 'A' 'A' 'U' 'A' 'A' 'U' 'M' 'A' 'U' 'M' 'M'
 'U' 'A' 'A' 'A' 'M' 'U' 'A' 'A' 'M' 'U' 'A' 'M' 'M' 'U' 'M' 'M' 'M' 'M'
 'M' 'M' 'M' 'U' 'U' 'U' 'U' 'M' 'M' 'U' 'U' 'U' 'U' 'M' 'U' 'U' 'A' 'U'
 'M' 'U' 'M' 'U' 'M' 'A' 'U' 'U' 'A' 'M' 'U' 'U' 'A' 'A' 'U' 'M' 'M' 'U'
 'U' 'U' 'A' 'M' 'U' 'U' 'U' 'U' 'A' 'M' 'M' 'U' 'M' 'M' 'A' 'U' 'U' 'M'
 'A' 'U' 'U' 'A' 'U' 'A' 'A' 'A' 'A' 'A' 'A' 'A' 'A' 'M' 'U' 'U' 'A' 'M'
 'A' 'U' 'U' 'U' 'U' 'A' 'U' 'A' 'M' 'M' 'U' 'U' 'U' 'U' 'M' 'U' 'U' 'U'
 'M' 'U' 'U' 'A' 'A' 'A' 'U' 'U' 'A' 'U' 'U' 'A' 'A' 'A' 'U' 'A' 'A' 'A'
 'M' 'A' 'U' 'U' 'U' 'U' 'A' 'U' 'U' 'U' 'A' 'A' 'U' 'M' 'M' 'A' 'M' 'U']"
21501,0,113,55,58,85,0,1,"['A' 'U' 'U' 'M' 'U' 'M' 'U' 'U' 'A' 'A' 'U' 'A' 'U' 'M' 'M' 'U' 'A' 'M'
 'M' 'U' 'A' 'U' 'A' 'A' 'U' 'A' 'U' 'M' 'U' 'M' 'U' 'A' 'M' 'A' 'M' 'U'
 'M' 'M' 'U' 'M' 'U' 'U' 'A' 'A' 'A' 'U' 'A' 'A' 'U' 'M' 'U' 'U' 'M' 'M'
 'U' 'A' 'A' 'A' 'M' 'U' 'A' 'A' 'M' 'U' 'A' 'M' 'M' 'M' 'M' 'M' 'M' 'M'
 'M' 'M' 'U' 'M' 'U' 'U' 'U' 'M' 'M' 'A' 'U' 'A' 'U' 'U' 'U' 'U' 'A' 'U'
 'M' 'U' 'M' 'U' 'M' 'A' 'U' 'U' 'U' 'M' 'U' 'U' 'U' 'M' 'A' 'U' 'M' 'U'
 'U' 'M' 'U' 'M' 'U' 'M' 'U' 'M' 'A' 'M' 'M' 'U' 'M' 'U' 'A' 'U' 'U' 'M'
 'U' 'U' 'U' 'A' 'U' 'A' 'A' 'A' 'A' 'A' 'A' 'A' 'A' 'M' 'U' 'A' 'A' 'U'
 'A' 'U' 'U' 'A' 'M' 'A' 'U' 'A' 'M' 'M' 'A' 'U' 'U' 'U' 'M' 'U' 'U' 'M'
 'M' 'U' 'U' 'A' 'U' 'A' 'M' 'U' 'A' 'U' 'U' 'M' 'A' 'U' 'M' 'A' 'A' 'A'
 'M' 'U' 'U' 'U' 'M' 'U' 'A' 'A' 'U' 'U' 'U' 'A' 'U' 'U' 'M' 'U' 'M' 'U']"
21601,2,122,62,60,76,0,0,"['A' 'U' 'U' 'M' 'A' 'M' 'M' 'U' 'A' 'A' 'U' 'A' 'U' 'M' 'M' 'A' 'A' 'U'
 'M' 'A' 'A' 'U' 'A' 'A' 'U' 'A' 'U' 'U' 'U' 'M' 'U' 'A' 'M' 'A' 'M' 'U'
 'M' 'U' 'U' 'M' 'M' 'U' 'A' 'A' 'U' 'U' 'A' 'A' 'U' 'U' 'A' 'M' 'M' 'M'
 'U' 'A' 'A' 'U' 'M' 'M' 'A' 'A' 'M' 'U' 'A' 'M' 'M' 'M' 'M' 'M' 'M' 'M'
 'M' 'U' 'M' 'M' 'U' 'U' 'M' 'M' 'M' 'U' 'U' 'A' 'U' 'U' 'M' 'U' 'A' 'M'
 'U' 'U' 'M' 'U' 'U' 'A' 'U' 'U' 'U' 'M' 'U' 'U' 'M' 'U' 'A' 'M' 'M' 'A'
 'U' 'M' 'U' 'M' 'U' 'A' 'U' 'U' 'A' 'M' 'M' 'M' 'M' 'U' 'A' 'U' 'U' 'U'
 'A' 'A' 'U' 'A' 'U' 'A' 'A' 'A' 'A' 'A' 'A' 'A' 'A' 'M' 'U' 'A' 'A' 'U'
 'A' 'U' 'A' 'A' 'M' 'A' 'M' 'A' 'U' 'M' 'A' 'U' 'U' 'U' 'U' 'U' 'U' 'M'
 'M' 'A' 'U' 'A' 'M' 'A' 'M' 'U' 'A' 'U' 'U' 'M' 'A' 'A' 'M' 'A' 'A' 'A'
 'M' 'U' 'U' 'U' 'M' 'U' 'A' 'A' 'U' 'M' 'U' 'U' 'U' 'M' 'M' 'U' 'M' 'U']"
21701,1,125,63,62,73,1,0,"['A' 'U' 'U' 'M' 'A' 'M' 'M' 'U' 'U' 'A' 'U' 'A' 'U' 'M' 'M' 'U' 'A' 'A'
 'U' 'U' 'A' 'U' 'M' 'A' 'U' 'A' 'A' 'U' 'U' 'M' 'U' 'A' 'M' 'A' 'M' 'U'
 'M' 'A' 'U' 'M' 'M' 'U' 'U' 'A' 'U' 'M' 'A' 'A' 'U' 'M' 'A' 'U' 'U' 'M'
 'U' 'A' 'U' 'U' 'M' 'M' 'A' 'A' 'M' 'U' 'A' 'M' 'M' 'M' 'U' 'M' 'M' 'M'
 'M' 'M' 'M' 'U' 'U' 'U' 'M' 'M' 'M' 'M' 'U' 'A' 'U' 'U' 'M' 'U' 'A' 'M'
 'U' 'A' 'M' 'A' 'U' 'A' 'U' 'U' 'A' 'M' 'A' 'U' 'U' 'U' 'A' 'M' 'M' 'A'
 'U' 'M' 'U' 'U' 'U' 'A' 'A' 'U' 'A' 'M' 'M' 'M' 'U' 'U' 'A' 'M' 'A' 'U'
 'A' 'A' 'U' 'U' 'U' 'A' 'A' 'A' 'A' 'A' 'A' 'A' 'A' 'U' 'M' 'A' 'A' 'A'
 'A' 'M' 'A' 'M' 'M' 'A' 'M' 'U' 'U' 'M' 'U' 'U' 'U' 'U' 'U' 'M' 'M' 'M'
 'M' 'A' 'U' 'A' 'M' 'A' 'M' 'A' 'A' 'M' 'U' 'M' 'A' 'U' 'M' 'A' 'A' 'A'
 'M' 'U' 'U' 'U' 'M' 'U' 'A' 'A' 'A' 'M' 'U' 'U' 'M' 'U' 'U' 'M' 'U' 'U']"
21801,1,115,54,61,83,0,0,"['A' 'U' 'A' 'M' 'A' 'M' 'M' 'U' 'U' 'A' 'A' 'A' 'M' 'M' 'A' 'U' 'A' 'A'
 'U' 'U' 'A' 'U' 'M' 'A' 'U' 'A' 'A' 'U' 'M' 'M' 'U' 'A' 'M' 'A' 'M' 'U'
 'M' 'A' 'U' 'U' 'U' 'U' 'U' 'A' 'M' 'M' 'A' 'A' 'U' 'M' 'U' 'U' 'U' 'M'
 'U' 'A' 'M' 'U' 'M' 'U' 'U' 'A' 'M' 'U' 'U' 'M' 'M' 'M' 'M' 'M' 'M' 'M'
 'M' 'M' 'U' 'U' 'U' 'U' 'M' 'M' 'M' 'A' 'U' 'U' 'U' 'U' 'M' 'U' 'A' 'M'
 'U' 'A' 'U' 'A' 'A' 'A' 'U' 'U' 'A' 'U' 'M' 'U' 'U' 'U' 'U' 'M' 'M' 'U'
 'U' 'M' 'U' 'U' 'U' 'U' 'U' 'U' 'A' 'M' 'M' 'M' 'M' 'M' 'A' 'M' 'A' 'A'
 'A' 'A' 'U' 'U' 'M' 'A' 'A' 'A' 'U' 'A' 'A' 'A' 'A' 'U' 'U' 'U' 'U' 'A'
 'A' 'M' 'A' 'U' 'M' 'A' 'M' 'U' 'M' 'M' 'U' 'M' 'M' 'U' 'U' 'M' 'U' 'M'
 'M' 'U' 'U' 'A' 'M' 'A' 'M' 'A' 'A' 'M' 'U' 'M' 'A' 'U' 'U' 'A' 'A' 'U'
 'U' 'U' 'U' 'U' 'M' 'U' 'A' 'U' 'U' 'M' 'M' 'U' 'U' 'U' 'A' 'M' 'U' 'U']"
21901,0,120,54,66,78,1,0,"['A' 'U' 'A' 'M' 'A' 'M' 'U' 'M' 'M' 'A' 'A' 'A' 'U' 'M' 'A' 'U' 'A' 'M'
 'M' 'M' 'U' 'U' 'M' 'A' 'U' 'A' 'U' 'U' 'M' 'U' 'A' 'A' 'M' 'U' 'M' 'U'
 'M' 'A' 'U' 'U' 'U' 'A' 'U' 'A' 'U' 'M' 'A' 'A' 'U' 'M' 'U' 'U' 'U' 'U'
 'U' 'A' 'M' 'U' 'M' 'U' 'M' 'M' 'M' 'U' 'U' 'M' 'M' 'M' 'M' 'M' 'U' 'M'
 'M' 'M' 'M' 'U' 'U' 'A' 'M' 'M' 'M' 'A' 'U' 'U' 'U' 'A' 'M' 'U' 'A' 'M'
 'U' 'A' 'A' 'A' 'U' 'A' 'U' 'U' 'A' 'U' 'U' 'A' 'U' 'U' 'M' 'U' 'M' 'U'
 'U' 'M' 'U' 'U' 'M' 'M' 'U' 'M' 'A' 'U' 'M' 'M' 'M' 'U' 'A' 'M' 'U' 'A'
 'U' 'U' 'U' 'A' 'M' 'A' 'A' 'A' 'A' 'A' 'A' 'A' 'A' 'U' 'U' 'U' 'U' 'A'
 'A' 'M' 'A' 'U' 'U' 'A' 'M' 'A' 'M' 'M' 'U' 'M' 'M' 'U' 'U' 'M' 'U' 'M'
 'M' 'M' 'U' 'A' 'U' 'A' 'M' 'A' 'U' 'M' 'A' 'U' 'A' 'M' 'U' 'A' 'U' 'U'
 'A' 'M' 'U' 'U' 'M' 'U' 'A' 'M' 'U' 'M' 'M' 'U' 'A' 'U' 'M' 'M' 'M' 'U']"
22001,0,122,50,72,76,0,1,"['A' 'U' 'A' 'M' 'A' 'M' 'M' 'M' 'M' 'A' 'A' 'A' 'U' 'M' 'A' 'U' 'A' 'M'
 'M' 'M' 'M' 'M' 'M' 'A' 'U' 'A' 'U' 'A' 'U' 'U' 'A' 'A' 'M' 'M' 'U' 'U'
 'M' 'A' 'U' 'U' 'M' 'A' 'M' 'A' 'U' 'M' 'A' 'A' 'U' 'M' 'U' 'A' 'U' 'U'
 'U' 'A' 'M' 'U' 'M' 'U' 'U' 'M' 'M' 'U' 'A' 'U' 'M' 'M' 'M' 'M' 'M' 'M'
 'M' 'M' 'M' 'U' 'U' 'U' 'M' 'U' 'M' 'U' 'U' 'U' 'U' 'A' 'M' 'U' 'A' 'U'
 'U' 'A' 'A' 'U' 'U' 'M' 'U' 'U' 'A' 'U' 'U' 'A' 'U' 'U' 'M' 'U' 'M' 'U'
 'M' 'M' 'U' 'U' 'M' 'M' 'U' 'M' 'A' 'A' 'M' 'M' 'U' 'U' 'A' 'M' 'U' 'A'
 'M' 'U' 'U' 'U' 'M' 'A' 'U' 'A' 'A' 'A' 'A' 'A' 'A' 'U' 'U' 'U' 'U' 'A'
 'A' 'M' 'A' 'U' 'U' 'A' 'M' 'A' 'M' 'M' 'A' 'M' 'U' 'U' 'U' 'M' 'U' 'M'
 'M' 'M' 'U' 'A' 'U' 'A' 'M' 'U' 'U' 'U' 'U' 'U' 'M' 'M' 'M' 'A' 'A' 'M'
 'M' 'U' 'M' 'U' 'M' 'U' 'A' 'M' 'U' 'M' 'M' 'M' 'A' 'U' 'M' 'M' 'M' 'U']"
22101,2,125,55,70,73,1,0,"['A' 'A' 'A' 'M' 'A' 'M' 'U' 'M' 'U' 'A' 'A' 'A' 'U' 'M' 'A' 'U' 'A' 'M'
 'A' 'M' 'M' 'M' 'M' 'A' 'U' 'A' 'M' 'A' 'M' 'U' 'A' 'U' 'U' 'M' 'U' 'U'
 'M' 'U' 'M' 'U' 'U' 'A' 'M' 'A' 'M' 'M' 'A' 'A' 'M' 'U' 'U' 'A' 'M' 'U'
 'A' 'U' 'M' 'U' 'M' 'U' 'M' 'M' 'M' 'M' 'A' 'M' 'M' 'M' 'M' 'U' 'M' 'M'
 'M' 'M' 'M' 'U' 'A' 'U' 'M' 'M' 'M' 'U' 'U' 'U' 'M' 'U' 'M' 'A' 'A' 'U'
 'A' 'A' 'A' 'U' 'U' 'U' 'U' 'U' 'A' 'A' 'U' 'A' 'U' 'U' 'M' 'U' 'M' 'U'
 'M' 'U' 'U' 'U' 'U' 'U' 'M' 'M' 'U' 'A' 'M' 'U' 'U' 'U' 'M' 'U' 'U' 'U'
 'M' 'U' 'U' 'U' 'M' 'A' 'A' 'A' 'A' 'A' 'A' 'A' 'A' 'U' 'U' 'U' 'M' 'A'
 'A' 'M' 'A' 'A' 'M' 'A' 'M' 'U' 'M' 'M' 'A' 'U' 'A' 'U' 'U' 'M' 'A' 'U'
 'M' 'M' 'U' 'A' 'M' 'A' 'M' 'U' 'A' 'U' 'A' 'U' 'U' 'M' 'M' 'A' 'A' 'M'
 'M' 'U' 'M' 'U' 'U' 'U' 'A' 'M' 'U' 'M' 'U' 'M' 'A' 'U' 'M' 'M' 'M' 'U']"
22201,2,126,52,74,72,0,1,"['A' 'A' 'A' 'M' 'A' 'M' 'U' 'M' 'U' 'A' 'A' 'A' 'U' 'U' 'A' 'U' 'A' 'M'
 'A' 'M' 'M' 'M' 'M' 'U' 'M' 'A' 'M' 'U' 'M' 'U' 'A' 'U' 'U' 'M' 'U' 'M'
 'M' 'A' 'A' 'U' 'A' 'A' 'M' 'A' 'M' 'U' 'U' 'A' 'M' 'A' 'M' 'A' 'M' 'A'
 'A' 'U' 'M' 'U' 'M' 'U' 'U' 'U' 'M' 'U' 'A' 'M' 'M' 'M' 'M' 'U' 'M' 'M'
 'M' 'M' 'M' 'M' 'A' 'U' 'M' 'M' 'M' 'U' 'U' 'M' 'M' 'M' 'M' 'U' 'A' 'U'
 'A' 'A' 'U' 'M' 'U' 'M' 'M' 'U' 'A' 'A' 'U' 'A' 'U' 'U' 'M' 'U' 'M' 'A'
 'M' 'U' 'U' 'U' 'U' 'U' 'M' 'M' 'U' 'U' 'M' 'M' 'U' 'U' 'M' 'U' 'U' 'M'
 'M' 'U' 'U' 'U' 'M' 'A' 'A' 'A' 'A' 'A' 'A' 'A' 'A' 'U' 'U' 'U' 'U' 'A'
 'U' 'M' 'U' 'A' 'M' 'A' 'U' 'U' 'M' 'M' 'A' 'U' 'U' 'U' 'M' 'U' 'A' 'U'
 'M' 'U' 'A' 'U' 'M' 'A' 'M' 'U' 'A' 'U' 'A' 'U' 'U' 'M' 'M' 'A' 'A' 'M'
 'M' 'M' 'M' 'U' 'U' 'U' 'U' 'M' 'U' 'M' 'U' 'M' 'A' 'M' 'M' 'M' 'M' 'A']"
22301,2,127,52,75,71,0,1,"['A' 'A' 'U' 'M' 'A' 'M' 'U' 'M' 'U' 'A' 'U' 'A' 'U' 'U' 'U' 'U' 'A' 'M'
 'A' 'U' 'M' 'U' 'U' 'U' 'M' 'A' 'M' 'U' 'M' 'M' 'U' 'M' 'U' 'M' 'U' 'M'
 'M' 'U' 'A' 'A' 'A' 'A' 'M' 'A' 'M' 'U' 'M' 'A' 'M' 'A' 'M' 'A' 'M' 'A'
 'U' 'U' 'M' 'U' 'M' 'A' 'U' 'M' 'M' 'U' 'A' 'M' 'M' 'M' 'M' 'M' 'M' 'M'
 'M' 'U' 'M' 'M' 'U' 'U' 'M' 'M' 'M' 'U' 'U' 'A' 'M' 'M' 'M' 'M' 'A' 'U'
 'U' 'A' 'U' 'M' 'U' 'M' 'M' 'M' 'U' 'A' 'U' 'A' 'A' 'U' 'M' 'U' 'U' 'A'
 'M' 'U' 'A' 'U' 'U' 'A' 'M' 'M' 'M' 'U' 'M' 'M' 'U' 'M' 'U' 'M' 'U' 'M'
 'M' 'U' 'A' 'M' 'M' 'A' 'A' 'A' 'A' 'A' 'A' 'A' 'A' 'A' 'U' 'U' 'U' 'A'
 'M' 'M' 'U' 'A' 'U' 'U' 'U' 'U' 'M' 'M' 'A' 'U' 'U' 'U' 'U' 'U' 'A' 'U'
 'M' 'U' 'A' 'U' 'M' 'A' 'M' 'M' 'A' 'M' 'A' 'U' 'U' 'M' 'A' 'A' 'A' 'U'
 'M' 'U' 'U' 'A' 'U' 'U' 'U' 'M' 'A' 'M' 'M' 'M' 'U' 'M' 'M' 'M' 'U' 'A']"
22401,4,131,53,78,67,0,1,"['A' 'A' 'U' 'M' 'U' 'M' 'U' 'A' 'U' 'U' 'U' 'A' 'U' 'M' 'U' 'U' 'A' 'U'
 'A' 'U' 'U' 'M' 'U' 'U' 'M' 'A' 'M' 'U' 'M' 'M' 'U' 'M' 'A' 'M' 'M' 'M'
 'M' 'A' 'A' 'A' 'A' 'U' 'M' 'U' 'M' 'U' 'M' 'A' 'U' 'A' 'M' 'A' 'M' 'A'
 'U' 'U' 'M' 'U' 'M' 'U' 'U' 'M' 'M' 'A' 'U' 'M' 'M' 'M' 'M' 'M' 'M' 'M'
 'U' 'M' 'M' 'M' 'U' 'U' 'M' 'M' 'M' 'U' 'U' 'A' 'U' 'M' 'M' 'M' 'A' 'U'
 'M' 'A' 'M' 'M' 'A' 'M' 'M' 'M' 'U' 'A' 'U' 'A' 'A' 'U' 'M' 'A' 'U' 'A'
 'M' 'U' 'U' 'M' 'U' 'A' 'M' 'M' 'U' 'M' 'M' 'M' 'U' 'M' 'U' 'M' 'U' 'M'
 'U' 'U' 'A' 'M' 'M' 'A' 'U' 'A' 'A' 'A' 'A' 'A' 'A' 'A' 'A' 'U' 'A' 'A'
 'M' 'M' 'U' 'A' 'A' 'U' 'U' 'U' 'M' 'M' 'A' 'U' 'M' 'M' 'M' 'U' 'A' 'A'
 'M' 'A' 'A' 'U' 'M' 'U' 'M' 'M' 'U' 'U' 'A' 'U' 'U' 'M' 'A' 'A' 'A' 'U'
 'M' 'A' 'U' 'U' 'U' 'U' 'U' 'M' 'A' 'M' 'M' 'M' 'U' 'M' 'M' 'M' 'M' 'A']"
22501,0,117,53,64,81,0,0,"['A' 'A' 'U' 'M' 'U' 'M' 'U' 'U' 'U' 'U' 'U' 'A' 'U' 'M' 'M' 'U' 'U' 'U'
 'U' 'U' 'U' 'U' 'U' 'U' 'U' 'A' 'U' 'U' 'M' 'U' 'U' 'U' 'A' 'M' 'M' 'M'
 'M' 'M' 'A' 'A' 'U' 'A' 'U' 'U' 'M' 'U' 'A' 'A' 'U' 'A' 'M' 'U' 'M' 'A'
 'U' 'U' 'M' 'U' 'M' 'U' 'U' 'M' 'M' 'A' 'U' 'M' 'M' 'M' 'M' 'M' 'U' 'M'
 'M' 'M' 'M' 'U' 'U' 'U' 'M' 'M' 'M' 'U' 'U' 'A' 'U' 'M' 'M' 'M' 'A' 'M'
 'M' 'A' 'M' 'M' 'U' 'M' 'U' 'M' 'U' 'A' 'U' 'A' 'A' 'A' 'U' 'A' 'U' 'A'
 'U' 'U' 'M' 'M' 'M' 'A' 'M' 'M' 'U' 'M' 'M' 'M' 'A' 'M' 'A' 'M' 'U' 'M'
 'A' 'U' 'A' 'M' 'M' 'A' 'A' 'A' 'A' 'A' 'A' 'A' 'A' 'A' 'A' 'U' 'A' 'A'
 'M' 'U' 'M' 'A' 'A' 'U' 'U' 'U' 'M' 'M' 'U' 'A' 'M' 'M' 'M' 'U' 'U' 'U'
 'U' 'A' 'A' 'U' 'U' 'M' 'U' 'U' 'A' 'U' 'A' 'U' 'U' 'M' 'A' 'A' 'A' 'U'
 'M' 'U' 'A' 'U' 'U' 'U' 'U' 'U' 'A' 'M' 'U' 'M' 'A' 'M' 'U' 'U' 'U' 'A']"
22601,1,122,59,63,76,0,1,"['A' 'A' 'M' 'M' 'U' 'U' 'U' 'U' 'A' 'U' 'U' 'A' 'A' 'U' 'M' 'M' 'M' 'U'
 'A' 'U' 'M' 'U' 'A' 'U' 'U' 'U' 'U' 'A' 'U' 'A' 'U' 'U' 'A' 'M' 'M' 'M'
 'M' 'M' 'A' 'A' 'U' 'U' 'U' 'U' 'M' 'U' 'A' 'A' 'U' 'U' 'M' 'U' 'U' 'A'
 'U' 'U' 'M' 'U' 'M' 'U' 'A' 'A' 'M' 'A' 'U' 'M' 'M' 'M' 'M' 'M' 'M' 'M'
 'M' 'M' 'U' 'M' 'U' 'U' 'M' 'M' 'M' 'M' 'U' 'A' 'M' 'M' 'U' 'M' 'M' 'U'
 'M' 'U' 'M' 'U' 'U' 'M' 'A' 'M' 'U' 'U' 'U' 'A' 'A' 'U' 'U' 'A' 'U' 'A'
 'A' 'U' 'A' 'M' 'M' 'A' 'M' 'M' 'M' 'M' 'M' 'M' 'A' 'M' 'A' 'M' 'A' 'M'
 'U' 'U' 'A' 'M' 'M' 'A' 'A' 'A' 'A' 'A' 'A' 'A' 'A' 'A' 'A' 'U' 'A' 'A'
 'M' 'U' 'U' 'A' 'A' 'U' 'U' 'U' 'M' 'M' 'U' 'A' 'U' 'M' 'M' 'U' 'U' 'A'
 'U' 'A' 'U' 'A' 'A' 'M' 'U' 'A' 'A' 'U' 'A' 'U' 'U' 'M' 'U' 'A' 'A' 'U'
 'M' 'M' 'A' 'U' 'U' 'U' 'U' 'U' 'A' 'M' 'U' 'M' 'A' 'M' 'U' 'U' 'U' 'A']"
22701,1,131,65,66,67,0,1,"['A' 'A' 'U' 'M' 'U' 'M' 'U' 'A' 'A' 'U' 'U' 'A' 'A' 'M' 'M' 'U' 'U' 'M'
 'A' 'M' 'M' 'U' 'A' 'U' 'U' 'U' 'U' 'A' 'U' 'A' 'M' 'U' 'A' 'M' 'A' 'M'
 'M' 'M' 'A' 'U' 'U' 'U' 'U' 'U' 'M' 'U' 'A' 'A' 'U' 'U' 'M' 'A' 'U' 'A'
 'M' 'U' 'M' 'U' 'M' 'U' 'A' 'A' 'U' 'A' 'U' 'M' 'M' 'M' 'M' 'U' 'M' 'M'
 'M' 'M' 'M' 'M' 'M' 'U' 'U' 'M' 'M' 'M' 'M' 'A' 'U' 'M' 'M' 'M' 'M' 'U'
 'U' 'U' 'U' 'U' 'U' 'M' 'A' 'M' 'U' 'A' 'U' 'A' 'A' 'U' 'M' 'M' 'M' 'A'
 'U' 'A' 'A' 'M' 'M' 'A' 'M' 'M' 'M' 'M' 'U' 'M' 'A' 'M' 'A' 'M' 'A' 'M'
 'A' 'U' 'A' 'M' 'M' 'A' 'A' 'A' 'A' 'A' 'A' 'A' 'A' 'A' 'U' 'U' 'A' 'A'
 'M' 'A' 'U' 'A' 'A' 'U' 'M' 'A' 'M' 'M' 'U' 'A' 'U' 'M' 'M' 'U' 'A' 'A'
 'U' 'A' 'U' 'A' 'U' 'M' 'U' 'A' 'A' 'U' 'A' 'U' 'U' 'M' 'U' 'A' 'A' 'M'
 'M' 'M' 'A' 'U' 'U' 'U' 'U' 'U' 'A' 'M' 'U' 'U' 'A' 'M' 'A' 'A' 'U' 'A']"
22801,1,133,62,71,65,0,0,"['A' 'U' 'U' 'M' 'U' 'M' 'U' 'A' 'A' 'U' 'U' 'M' 'U' 'A' 'U' 'A' 'A' 'M'
 'A' 'M' 'M' 'A' 'A' 'U' 'U' 'M' 'U' 'A' 'A' 'A' 'M' 'U' 'A' 'U' 'U' 'M'
 'M' 'U' 'A' 'M' 'A' 'U' 'U' 'U' 'M' 'U' 'A' 'U' 'A' 'U' 'M' 'A' 'M' 'A'
 'M' 'U' 'U' 'M' 'M' 'U' 'A' 'A' 'U' 'A' 'M' 'M' 'U' 'M' 'M' 'M' 'M' 'M'
 'M' 'M' 'M' 'M' 'M' 'M' 'U' 'M' 'M' 'M' 'M' 'U' 'U' 'M' 'U' 'M' 'M' 'U'
 'M' 'U' 'A' 'M' 'U' 'M' 'A' 'M' 'U' 'A' 'U' 'A' 'A' 'U' 'M' 'M' 'M' 'A'
 'M' 'A' 'A' 'M' 'M' 'U' 'M' 'M' 'U' 'M' 'U' 'M' 'A' 'A' 'A' 'M' 'A' 'M'
 'U' 'U' 'A' 'M' 'M' 'A' 'A' 'A' 'U' 'A' 'A' 'A' 'A' 'A' 'U' 'U' 'A' 'U'
 'M' 'A' 'U' 'A' 'A' 'U' 'A' 'A' 'M' 'M' 'U' 'A' 'U' 'U' 'M' 'U' 'A' 'A'
 'U' 'A' 'M' 'U' 'A' 'M' 'U' 'U' 'U' 'U' 'A' 'U' 'U' 'M' 'U' 'A' 'A' 'M'
 'M' 'M' 'A' 'U' 'A' 'U' 'M' 'M' 'A' 'M' 'U' 'M' 'M' 'M' 'A' 'U' 'U' 'A']"
22901,2,130,66,64,68,0,0,"['A' 'U' 'A' 'M' 'A' 'M' 'U' 'A' 'U' 'A' 'U' 'U' 'U' 'A' 'U' 'A' 'A' 'M'
 'A' 'M' 'U' 'U' 'U' 'M' 'U' 'U' 'U' 'A' 'A' 'A' 'M' 'U' 'U' 'A' 'U' 'M'
 'M' 'U' 'A' 'M' 'A' 'M' 'A' 'A' 'M' 'U' 'A' 'M' 'A' 'U' 'M' 'A' 'M' 'A'
 'M' 'M' 'U' 'U' 'M' 'U' 'U' 'A' 'U' 'U' 'M' 'M' 'M' 'M' 'M' 'M' 'M' 'M'
 'M' 'U' 'M' 'M' 'M' 'M' 'U' 'M' 'U' 'M' 'M' 'U' 'U' 'M' 'U' 'M' 'U' 'U'
 'M' 'U' 'A' 'A' 'U' 'M' 'A' 'M' 'U' 'U' 'A' 'A' 'A' 'U' 'M' 'U' 'M' 'A'
 'M' 'A' 'A' 'U' 'M' 'A' 'M' 'M' 'U' 'U' 'U' 'M' 'A' 'U' 'U' 'M' 'A' 'M'
 'U' 'U' 'A' 'M' 'M' 'A' 'A' 'A' 'A' 'A' 'A' 'A' 'A' 'A' 'U' 'U' 'A' 'U'
 'M' 'A' 'A' 'A' 'A' 'M' 'A' 'A' 'M' 'U' 'A' 'U' 'U' 'U' 'M' 'U' 'A' 'A'
 'U' 'A' 'U' 'U' 'A' 'M' 'U' 'U' 'U' 'A' 'A' 'U' 'U' 'M' 'M' 'A' 'A' 'M'
 'M' 'M' 'A' 'U' 'A' 'U' 'M' 'M' 'A' 'M' 'A' 'U' 'M' 'M' 'A' 'U' 'U' 'A']"
23001,1,127,75,52,71,1,0,"['A' 'U' 'A' 'M' 'A' 'M' 'U' 'A' 'U' 'A' 'U' 'U' 'U' 'U' 'U' 'A' 'A' 'U'
 'A' 'M' 'U' 'U' 'A' 'M' 'U' 'U' 'U' 'A' 'A' 'A' 'M' 'U' 'U' 'A' 'U' 'U'
 'M' 'U' 'A' 'M' 'A' 'M' 'M' 'A' 'U' 'U' 'A' 'M' 'U' 'U' 'M' 'A' 'M' 'A'
 'A' 'M' 'U' 'U' 'M' 'M' 'U' 'A' 'U' 'U' 'U' 'M' 'M' 'M' 'M' 'U' 'M' 'M'
 'M' 'M' 'M' 'M' 'M' 'U' 'U' 'M' 'A' 'M' 'M' 'A' 'U' 'M' 'U' 'M' 'A' 'U'
 'M' 'A' 'A' 'A' 'U' 'M' 'U' 'U' 'A' 'U' 'A' 'A' 'A' 'A' 'M' 'U' 'M' 'A'
 'M' 'A' 'A' 'U' 'U' 'A' 'U' 'M' 'U' 'A' 'U' 'U' 'A' 'U' 'A' 'M' 'A' 'M'
 'U' 'U' 'A' 'M' 'M' 'A' 'A' 'A' 'A' 'A' 'A' 'A' 'A' 'A' 'U' 'U' 'A' 'U'
 'U' 'A' 'U' 'A' 'A' 'A' 'U' 'A' 'U' 'U' 'A' 'A' 'U' 'U' 'M' 'U' 'A' 'A'
 'A' 'A' 'U' 'U' 'A' 'M' 'U' 'U' 'M' 'A' 'U' 'A' 'A' 'M' 'M' 'A' 'A' 'M'
 'M' 'U' 'A' 'U' 'A' 'U' 'U' 'U' 'M' 'M' 'A' 'A' 'M' 'M' 'A' 'A' 'U' 'A']"
23101,0,122,73,49,76,0,1,"['A' 'U' 'A' 'M' 'A' 'U' 'U' 'A' 'U' 'A' 'U' 'U' 'U' 'U' 'U' 'A' 'A' 'U'
 'A' 'M' 'U' 'U' 'A' 'M' 'U' 'A' 'U' 'A' 'A' 'A' 'M' 'U' 'U' 'A' 'U' 'A'
 'M' 'U' 'A' 'M' 'A' 'U' 'M' 'A' 'A' 'A' 'U' 'M' 'U' 'U' 'M' 'A' 'M' 'U'
 'A' 'U' 'U' 'A' 'M' 'U' 'U' 'A' 'U' 'A' 'U' 'M' 'M' 'M' 'M' 'M' 'M' 'M'
 'M' 'U' 'M' 'M' 'M' 'U' 'M' 'M' 'A' 'M' 'M' 'A' 'U' 'M' 'A' 'M' 'A' 'U'
 'M' 'A' 'U' 'U' 'U' 'U' 'U' 'A' 'A' 'M' 'A' 'A' 'A' 'A' 'M' 'U' 'U' 'A'
 'U' 'U' 'A' 'U' 'M' 'A' 'U' 'M' 'U' 'A' 'U' 'A' 'A' 'U' 'A' 'U' 'A' 'M'
 'A' 'U' 'A' 'M' 'M' 'A' 'A' 'A' 'A' 'A' 'A' 'A' 'A' 'U' 'U' 'U' 'A' 'U'
 'U' 'A' 'U' 'A' 'A' 'U' 'U' 'A' 'U' 'A' 'U' 'U' 'U' 'A' 'M' 'M' 'A' 'A'
 'A' 'A' 'U' 'M' 'U' 'M' 'U' 'U' 'M' 'U' 'A' 'A' 'U' 'U' 'M' 'U' 'A' 'M'
 'M' 'M' 'A' 'U' 'U' 'U' 'U' 'U' 'M' 'M' 'A' 'A' 'M' 'M' 'U' 'A' 'U' 'A']"
23201,2,120,77,43,78,0,0,"['A' 'A' 'U' 'U' 'A' 'U' 'A' 'A' 'U' 'A' 'A' 'U' 'U' 'U' 'A' 'A' 'A' 'U'
 'A' 'M' 'A' 'U' 'A' 'U' 'U' 'A' 'U' 'A' 'A' 'A' 'M' 'M' 'U' 'A' 'U' 'U'
 'M' 'A' 'U' 'U' 'A' 'U' 'U' 'A' 'A' 'A' 'U' 'U' 'A' 'U' 'M' 'A' 'M' 'U'
 'U' 'M' 'M' 'A' 'M' 'U' 'A' 'A' 'U' 'A' 'U' 'M' 'M' 'U' 'M' 'M' 'M' 'M'
 'M' 'M' 'M' 'U' 'M' 'U' 'M' 'M' 'A' 'M' 'U' 'A' 'U' 'U' 'A' 'M' 'A' 'U'
 'M' 'A' 'U' 'U' 'U' 'U' 'U' 'A' 'A' 'M' 'A' 'A' 'A' 'A' 'M' 'M' 'U' 'A'
 'U' 'A' 'U' 'M' 'M' 'A' 'U' 'U' 'U' 'A' 'U' 'A' 'A' 'U' 'U' 'M' 'A' 'M'
 'A' 'U' 'A' 'M' 'A' 'U' 'A' 'A' 'A' 'A' 'A' 'A' 'A' 'U' 'U' 'U' 'A' 'U'
 'U' 'A' 'U' 'A' 'U' 'U' 'U' 'A' 'U' 'A' 'U' 'U' 'U' 'A' 'M' 'U' 'A' 'A'
 'A' 'A' 'A' 'M' 'U' 'M' 'M' 'U' 'M' 'U' 'A' 'A' 'U' 'U' 'M' 'U' 'A' 'M'
 'M' 'M' 'A' 'U' 'U' 'U' 'U' 'U' 'M' 'M' 'A' 'A' 'U' 'U' 'U' 'A' 'A' 'A']"
23301,1,114,71,43,84,0,0,"['A' 'A' 'A' 'U' 'A' 'U' 'A' 'A' 'U' 'A' 'A' 'U' 'U' 'U' 'A' 'A' 'U' 'U'
 'A' 'M' 'U' 'U' 'U' 'U' 'M' 'U' 'A' 'A' 'A' 'A' 'M' 'M' 'A' 'U' 'U' 'U'
 'U' 'A' 'U' 'U' 'A' 'U' 'U' 'A' 'A' 'U' 'A' 'A' 'A' 'U' 'U' 'A' 'M' 'U'
 'U' 'M' 'M' 'A' 'M' 'A' 'A' 'U' 'U' 'A' 'U' 'M' 'M' 'M' 'M' 'M' 'U' 'M'
 'M' 'M' 'M' 'U' 'M' 'U' 'M' 'M' 'A' 'M' 'M' 'A' 'A' 'U' 'U' 'U' 'U' 'U'
 'M' 'A' 'U' 'U' 'U' 'A' 'U' 'A' 'U' 'U' 'U' 'U' 'A' 'U' 'M' 'M' 'A' 'U'
 'U' 'U' 'U' 'M' 'M' 'U' 'U' 'U' 'U' 'A' 'U' 'A' 'A' 'M' 'U' 'M' 'A' 'M'
 'U' 'M' 'U' 'M' 'A' 'A' 'A' 'A' 'A' 'A' 'A' 'A' 'A' 'U' 'U' 'M' 'A' 'U'
 'U' 'A' 'U' 'M' 'U' 'U' 'U' 'A' 'M' 'A' 'A' 'U' 'U' 'A' 'U' 'A' 'A' 'A'
 'A' 'A' 'U' 'M' 'U' 'U' 'M' 'U' 'M' 'U' 'A' 'A' 'M' 'U' 'M' 'A' 'A' 'U'
 'U' 'M' 'A' 'U' 'A' 'U' 'U' 'U' 'M' 'M' 'A' 'A' 'U' 'U' 'U' 'A' 'A' 'A']"
23401,0,117,75,42,81,1,0,"['A' 'U' 'A' 'A' 'A' 'U' 'A' 'A' 'A' 'A' 'A' 'U' 'M' 'U' 'A' 'A' 'U' 'U'
 'A' 'U' 'M' 'U' 'U' 'U' 'M' 'M' 'A' 'A' 'A' 'A' 'M' 'M' 'A' 'U' 'U' 'M'
 'A' 'M' 'A' 'U' 'A' 'U' 'U' 'A' 'U' 'U' 'A' 'A' 'A' 'U' 'U' 'A' 'M' 'U'
 'U' 'U' 'U' 'A' 'M' 'U' 'A' 'U' 'U' 'A' 'U' 'M' 'M' 'U' 'M' 'M' 'M' 'M'
 'M' 'M' 'M' 'A' 'U' 'U' 'M' 'M' 'A' 'M' 'M' 'A' 'A' 'U' 'U' 'U' 'U' 'U'
 'M' 'A' 'U' 'U' 'A' 'U' 'U' 'A' 'A' 'U' 'U' 'U' 'A' 'U' 'M' 'U' 'A' 'U'
 'U' 'U' 'U' 'M' 'M' 'U' 'U' 'U' 'U' 'A' 'U' 'A' 'A' 'M' 'U' 'U' 'A' 'U'
 'A' 'M' 'U' 'M' 'A' 'A' 'A' 'U' 'A' 'A' 'A' 'A' 'A' 'U' 'U' 'M' 'A' 'U'
 'U' 'A' 'U' 'M' 'U' 'U' 'U' 'A' 'U' 'A' 'A' 'A' 'M' 'A' 'U' 'A' 'A' 'A'
 'A' 'A' 'M' 'M' 'U' 'U' 'U' 'U' 'M' 'U' 'A' 'U' 'M' 'U' 'M' 'A' 'A' 'A'
 'U' 'M' 'A' 'U' 'A' 'U' 'U' 'M' 'M' 'M' 'A' 'A' 'A' 'U' 'A' 'A' 'U' 'A']"
23501,0,123,82,41,75,0,0,"['A' 'A' 'A' 'A' 'A' 'U' 'A' 'A' 'A' 'A' 'A' 'A' 'M' 'U' 'A' 'A' 'U' 'U'
 'A' 'A' 'M' 'M' 'M' 'M' 'M' 'M' 'A' 'A' 'A' 'U' 'M' 'M' 'A' 'U' 'U' 'U'
 'A' 'M' 'A' 'U' 'A' 'M' 'U' 'A' 'U' 'U' 'A' 'A' 'A' 'U' 'U' 'U' 'M' 'U'
 'U' 'U' 'U' 'A' 'U' 'U' 'A' 'U' 'A' 'A' 'U' 'M' 'M' 'M' 'M' 'U' 'M' 'M'
 'M' 'M' 'M' 'A' 'U' 'U' 'U' 'M' 'A' 'M' 'M' 'A' 'A' 'U' 'U' 'U' 'U' 'U'
 'U' 'A' 'U' 'U' 'A' 'A' 'U' 'A' 'A' 'U' 'A' 'U' 'A' 'M' 'M' 'U' 'A' 'U'
 'U' 'U' 'U' 'M' 'M' 'U' 'U' 'U' 'U' 'A' 'U' 'A' 'A' 'A' 'U' 'M' 'A' 'A'
 'U' 'M' 'U' 'M' 'A' 'A' 'U' 'A' 'A' 'A' 'U' 'A' 'A' 'U' 'U' 'M' 'A' 'U'
 'U' 'U' 'U' 'M' 'U' 'M' 'U' 'A' 'A' 'A' 'A' 'A' 'U' 'A' 'U' 'A' 'A' 'A'
 'A' 'A' 'U' 'M' 'A' 'U' 'A' 'A' 'M' 'U' 'A' 'U' 'M' 'A' 'M' 'A' 'A' 'A'
 'U' 'M' 'A' 'A' 'U' 'U' 'U' 'U' 'M' 'U' 'A' 'A' 'A' 'U' 'A' 'U' 'M' 'A']"
23601,3,121,78,43,77,0,0,"['A' 'A' 'A' 'A' 'U' 'U' 'A' 'A' 'A' 'A' 'A' 'A' 'M' 'A' 'U' 'A' 'M' 'U'
 'U' 'A' 'M' 'M' 'U' 'U' 'A' 'M' 'A' 'A' 'U' 'M' 'U' 'M' 'A' 'U' 'M' 'U'
 'A' 'M' 'A' 'U' 'A' 'U' 'M' 'M' 'U' 'U' 'A' 'A' 'A' 'U' 'U' 'U' 'M' 'A'
 'M' 'U' 'U' 'A' 'A' 'U' 'A' 'U' 'U' 'U' 'M' 'M' 'M' 'M' 'M' 'U' 'M' 'M'
 'M' 'M' 'M' 'A' 'M' 'U' 'U' 'U' 'A' 'M' 'U' 'U' 'A' 'U' 'U' 'U' 'M' 'U'
 'M' 'A' 'U' 'U' 'A' 'A' 'U' 'A' 'A' 'U' 'U' 'U' 'A' 'M' 'U' 'U' 'A' 'U'
 'U' 'U' 'A' 'M' 'U' 'U' 'U' 'U' 'U' 'A' 'U' 'A' 'U' 'A' 'U' 'M' 'A' 'A'
 'U' 'M' 'U' 'M' 'A' 'A' 'A' 'A' 'A' 'A' 'A' 'A' 'A' 'U' 'A' 'M' 'A' 'U'
 'U' 'A' 'U' 'M' 'M' 'M' 'M' 'A' 'A' 'A' 'A' 'U' 'M' 'A' 'U' 'A' 'A' 'A'
 'A' 'A' 'U' 'U' 'A' 'U' 'A' 'A' 'U' 'U' 'A' 'U' 'M' 'A' 'M' 'A' 'U' 'A'
 'U' 'M' 'A' 'U' 'U' 'U' 'A' 'U' 'M' 'U' 'U' 'A' 'A' 'M' 'A' 'U' 'U' 'A']"
23701,1,119,77,42,79,1,0,"['A' 'A' 'U' 'A' 'U' 'M' 'A' 'A' 'A' 'A' 'A' 'A' 'M' 'A' 'U' 'A' 'M' 'A'
 'U' 'A' 'M' 'M' 'U' 'U' 'A' 'M' 'A' 'U' 'U' 'U' 'A' 'M' 'A' 'U' 'U' 'U'
 'A' 'M' 'A' 'U' 'U' 'U' 'M' 'M' 'U' 'U' 'U' 'A' 'A' 'U' 'A' 'U' 'U' 'U'
 'M' 'U' 'U' 'U' 'A' 'U' 'A' 'U' 'M' 'U' 'M' 'M' 'M' 'M' 'M' 'M' 'M' 'M'
 'M' 'U' 'M' 'A' 'M' 'U' 'U' 'U' 'A' 'M' 'A' 'U' 'A' 'U' 'U' 'U' 'M' 'U'
 'M' 'U' 'U' 'A' 'A' 'A' 'U' 'A' 'A' 'A' 'U' 'U' 'A' 'U' 'U' 'M' 'A' 'A'
 'U' 'U' 'A' 'M' 'U' 'U' 'A' 'U' 'U' 'A' 'A' 'U' 'U' 'A' 'U' 'U' 'A' 'U'
 'U' 'M' 'U' 'M' 'A' 'A' 'A' 'A' 'A' 'U' 'A' 'A' 'A' 'U' 'A' 'M' 'A' 'U'
 'U' 'A' 'M' 'M' 'U' 'M' 'M' 'U' 'A' 'A' 'A' 'A' 'A' 'A' 'U' 'A' 'A' 'A'
 'A' 'U' 'U' 'U' 'A' 'M' 'U' 'U' 'U' 'M' 'U' 'M' 'M' 'A' 'M' 'A' 'U' 'A'
 'U' 'M' 'A' 'A' 'A' 'U' 'A' 'A' 'M' 'U' 'U' 'A' 'A' 'A' 'U' 'U' 'U' 'A']"
23801,0,118,74,44,80,0,0,"['A' 'A' 'U' 'U' 'U' 'M' 'A' 'A' 'A' 'A' 'A' 'A' 'U' 'A' 'U' 'A' 'M' 'A'
 'U' 'A' 'M' 'M' 'M' 'M' 'A' 'M' 'U' 'U' 'U' 'A' 'U' 'M' 'A' 'A' 'U' 'U'
 'A' 'M' 'A' 'U' 'M' 'U' 'U' 'M' 'U' 'U' 'M' 'U' 'A' 'A' 'U' 'U' 'U' 'U'
 'M' 'U' 'A' 'M' 'A' 'U' 'A' 'U' 'M' 'U' 'M' 'M' 'M' 'M' 'M' 'U' 'M' 'M'
 'M' 'M' 'M' 'U' 'M' 'U' 'U' 'U' 'A' 'A' 'A' 'U' 'A' 'A' 'U' 'U' 'M' 'U'
 'M' 'U' 'U' 'A' 'A' 'A' 'U' 'A' 'A' 'U' 'U' 'U' 'A' 'U' 'U' 'M' 'A' 'A'
 'M' 'A' 'A' 'M' 'U' 'U' 'U' 'U' 'U' 'A' 'A' 'U' 'U' 'A' 'U' 'A' 'A' 'U'
 'U' 'M' 'U' 'M' 'A' 'A' 'A' 'A' 'A' 'A' 'A' 'A' 'A' 'U' 'A' 'M' 'A' 'U'
 'U' 'U' 'M' 'M' 'U' 'M' 'M' 'U' 'A' 'A' 'U' 'M' 'A' 'A' 'A' 'A' 'A' 'U'
 'A' 'U' 'U' 'U' 'A' 'U' 'U' 'U' 'U' 'M' 'A' 'M' 'M' 'U' 'M' 'A' 'A' 'A'
 'U' 'U' 'U' 'A' 'A' 'U' 'U' 'U' 'M' 'A' 'U' 'A' 'A' 'A' 'U' 'U' 'U' 'A']"
23901,0,118,70,48,80,0,0,"['A' 'A' 'U' 'U' 'U' 'M' 'A' 'A' 'U' 'A' 'A' 'A' 'U' 'A' 'A' 'U' 'M' 'A'
 'M' 'A' 'M' 'M' 'M' 'U' 'A' 'A' 'U' 'M' 'M' 'A' 'A' 'M' 'A' 'A' 'U' 'U'
 'U' 'M' 'A' 'M' 'M' 'U' 'A' 'U' 'M' 'U' 'M' 'U' 'A' 'U' 'U' 'U' 'U' 'U'
 'M' 'U' 'A' 'U' 'A' 'U' 'A' 'U' 'U' 'U' 'M' 'M' 'M' 'M' 'M' 'M' 'M' 'M'
 'U' 'M' 'M' 'U' 'M' 'U' 'U' 'U' 'A' 'U' 'A' 'M' 'A' 'A' 'U' 'U' 'M' 'M'
 'U' 'U' 'U' 'A' 'A' 'A' 'M' 'U' 'A' 'U' 'U' 'U' 'A' 'M' 'M' 'M' 'A' 'A'
 'M' 'A' 'U' 'M' 'U' 'U' 'A' 'U' 'U' 'A' 'A' 'U' 'A' 'A' 'U' 'A' 'A' 'U'
 'U' 'M' 'U' 'M' 'A' 'A' 'A' 'A' 'A' 'A' 'A' 'A' 'A' 'U' 'A' 'M' 'A' 'U'
 'U' 'U' 'M' 'U' 'U' 'U' 'U' 'U' 'A' 'A' 'U' 'M' 'A' 'A' 'U' 'A' 'A' 'U'
 'A' 'A' 'U' 'U' 'A' 'U' 'U' 'U' 'A' 'M' 'U' 'M' 'M' 'A' 'M' 'A' 'U' 'A'
 'U' 'U' 'M' 'A' 'U' 'U' 'U' 'M' 'M' 'A' 'M' 'A' 'U' 'A' 'U' 'U' 'U' 'U']"
24001,1,115,67,48,83,1,0,"['A' 'A' 'U' 'U' 'U' 'M' 'A' 'U' 'U' 'A' 'U' 'A' 'U' 'A' 'A' 'U' 'M' 'A'
 'M' 'U' 'U' 'M' 'M' 'U' 'A' 'A' 'A' 'U' 'M' 'U' 'A' 'M' 'A' 'U' 'M' 'U'
 'U' 'M' 'A' 'M' 'M' 'A' 'A' 'U' 'M' 'U' 'M' 'A' 'A' 'U' 'U' 'A' 'A' 'U'
 'U' 'A' 'A' 'U' 'A' 'U' 'U' 'U' 'A' 'U' 'M' 'M' 'M' 'M' 'M' 'M' 'M' 'M'
 'M' 'M' 'U' 'M' 'M' 'M' 'M' 'U' 'U' 'U' 'A' 'U' 'U' 'A' 'A' 'U' 'M' 'A'
 'U' 'U' 'U' 'U' 'A' 'U' 'U' 'U' 'U' 'U' 'U' 'A' 'A' 'M' 'U' 'A' 'U' 'A'
 'M' 'U' 'U' 'M' 'U' 'M' 'U' 'A' 'U' 'A' 'A' 'A' 'A' 'A' 'U' 'A' 'A' 'A'
 'U' 'M' 'U' 'M' 'A' 'A' 'A' 'A' 'A' 'A' 'A' 'A' 'A' 'U' 'A' 'M' 'A' 'U'
 'U' 'U' 'M' 'U' 'M' 'U' 'U' 'U' 'A' 'U' 'U' 'M' 'U' 'A' 'U' 'A' 'A' 'M'
 'A' 'A' 'U' 'U' 'M' 'U' 'A' 'A' 'A' 'M' 'U' 'M' 'U' 'U' 'M' 'U' 'U' 'A'
 'U' 'U' 'M' 'A' 'M' 'U' 'U' 'M' 'M' 'A' 'M' 'A' 'U' 'A' 'U' 'U' 'U' 'U']"
24101,1,123,68,55,75,1,0,"['A' 'U' 'U' 'U' 'U' 'M' 'A' 'U' 'U' 'A' 'U' 'U' 'A' 'A' 'A' 'M' 'U' 'A'
 'M' 'U' 'M' 'M' 'M' 'M' 'A' 'A' 'A' 'U' 'U' 'U' 'A' 'M' 'U' 'U' 'M' 'U'
 'U' 'M' 'A' 'M' 'M' 'U' 'A' 'A' 'U' 'U' 'M' 'A' 'A' 'U' 'U' 'A' 'A' 'U'
 'U' 'A' 'U' 'U' 'A' 'A' 'A' 'U' 'A' 'A' 'M' 'M' 'M' 'U' 'M' 'M' 'M' 'M'
 'M' 'M' 'M' 'M' 'M' 'M' 'M' 'U' 'U' 'U' 'A' 'A' 'U' 'A' 'U' 'U' 'U' 'A'
 'U' 'U' 'U' 'U' 'A' 'U' 'U' 'A' 'U' 'A' 'U' 'U' 'A' 'M' 'M' 'U' 'U' 'A'
 'M' 'A' 'A' 'M' 'A' 'M' 'M' 'A' 'M' 'U' 'A' 'U' 'U' 'A' 'U' 'U' 'A' 'A'
 'U' 'M' 'M' 'M' 'U' 'A' 'A' 'A' 'A' 'A' 'A' 'A' 'A' 'M' 'A' 'M' 'A' 'U'
 'U' 'U' 'M' 'A' 'M' 'U' 'U' 'M' 'U' 'U' 'U' 'M' 'M' 'U' 'M' 'A' 'A' 'M'
 'A' 'A' 'M' 'U' 'U' 'U' 'A' 'A' 'A' 'M' 'U' 'U' 'U' 'U' 'A' 'A' 'U' 'A'
 'U' 'U' 'M' 'A' 'M' 'U' 'U' 'M' 'M' 'A' 'M' 'A' 'U' 'A' 'A' 'A' 'M' 'M']"
24201,0,119,65,54,79,0,0,"['A' 'U' 'U' 'U' 'U' 'M' 'U' 'U' 'M' 'A' 'U' 'U' 'A' 'A' 'A' 'M' 'U' 'A'
 'M' 'U' 'M' 'U' 'M' 'M' 'A' 'A' 'A' 'U' 'U' 'M' 'A' 'U' 'U' 'A' 'M' 'U'
 'U' 'M' 'A' 'M' 'M' 'U' 'A' 'A' 'U' 'M' 'M' 'U' 'A' 'U' 'M' 'A' 'A' 'U'
 'U' 'U' 'A' 'U' 'A' 'A' 'A' 'U' 'A' 'A' 'U' 'U' 'M' 'M' 'M' 'M' 'M' 'M'
 'M' 'M' 'M' 'U' 'M' 'U' 'M' 'U' 'U' 'A' 'A' 'A' 'M' 'A' 'U' 'U' 'U' 'M'
 'U' 'U' 'U' 'A' 'U' 'U' 'U' 'A' 'U' 'A' 'U' 'U' 'A' 'U' 'M' 'U' 'U' 'A'
 'M' 'A' 'A' 'M' 'A' 'U' 'M' 'U' 'U' 'U' 'U' 'U' 'U' 'A' 'U' 'U' 'A' 'A'
 'M' 'U' 'M' 'M' 'U' 'A' 'A' 'U' 'A' 'A' 'A' 'A' 'A' 'U' 'A' 'M' 'A' 'A'
 'U' 'U' 'M' 'A' 'M' 'U' 'M' 'U' 'U' 'U' 'A' 'M' 'M' 'U' 'U' 'A' 'A' 'M'
 'A' 'A' 'M' 'M' 'M' 'U' 'M' 'A' 'A' 'M' 'A' 'U' 'U' 'U' 'A' 'A' 'U' 'A'
 'U' 'U' 'M' 'A' 'M' 'U' 'M' 'U' 'A' 'A' 'M' 'M' 'U' 'A' 'A' 'U' 'M' 'M']"
24301,0,129,70,59,69,0,1,"['A' 'U' 'U' 'U' 'U' 'U' 'M' 'U' 'M' 'A' 'U' 'U' 'A' 'A' 'A' 'M' 'M' 'A'
 'M' 'A' 'M' 'A' 'M' 'M' 'A' 'A' 'A' 'U' 'U' 'M' 'A' 'U' 'A' 'U' 'M' 'M'
 'A' 'M' 'U' 'U' 'M' 'U' 'A' 'U' 'A' 'M' 'M' 'U' 'A' 'M' 'M' 'A' 'A' 'U'
 'A' 'A' 'U' 'U' 'A' 'A' 'U' 'M' 'U' 'A' 'U' 'M' 'M' 'M' 'U' 'M' 'M' 'M'
 'M' 'M' 'M' 'U' 'M' 'U' 'M' 'A' 'U' 'A' 'A' 'A' 'M' 'A' 'A' 'U' 'M' 'U'
 'A' 'A' 'U' 'U' 'U' 'U' 'U' 'A' 'U' 'A' 'U' 'U' 'A' 'U' 'M' 'M' 'A' 'U'
 'M' 'A' 'A' 'M' 'A' 'U' 'M' 'U' 'M' 'U' 'U' 'U' 'U' 'A' 'U' 'U' 'A' 'A'
 'M' 'U' 'M' 'M' 'U' 'A' 'A' 'A' 'A' 'A' 'A' 'A' 'A' 'M' 'A' 'M' 'U' 'A'
 'U' 'U' 'M' 'A' 'U' 'U' 'M' 'M' 'U' 'U' 'A' 'M' 'M' 'U' 'A' 'A' 'A' 'M'
 'A' 'M' 'U' 'M' 'M' 'U' 'M' 'A' 'U' 'M' 'A' 'U' 'M' 'U' 'A' 'A' 'U' 'A'
 'U' 'U' 'M' 'A' 'M' 'A' 'U' 'A' 'A' 'A' 'M' 'U' 'U' 'A' 'A' 'U' 'M' 'M']"
24401,1,116,62,54,82,0,0,"['A' 'U' 'U' 'U' 'M' 'U' 'U' 'A' 'M' 'A' 'U' 'U' 'A' 'A' 'A' 'M' 'U' 'A'
 'M' 'A' 'M' 'A' 'M' 'M' 'A' 'A' 'A' 'U' 'U' 'M' 'U' 'U' 'A' 'U' 'M' 'M'
 'U' 'M' 'U' 'U' 'M' 'U' 'A' 'U' 'A' 'M' 'U' 'U' 'A' 'M' 'M' 'A' 'A' 'U'
 'A' 'A' 'U' 'U' 'A' 'U' 'U' 'U' 'A' 'A' 'U' 'M' 'M' 'M' 'M' 'M' 'U' 'M'
 'M' 'M' 'M' 'U' 'M' 'M' 'M' 'U' 'A' 'A' 'A' 'A' 'M' 'A' 'U' 'M' 'M' 'U'
 'A' 'U' 'U' 'U' 'U' 'M' 'U' 'A' 'U' 'A' 'U' 'U' 'U' 'U' 'M' 'M' 'A' 'U'
 'M' 'A' 'A' 'M' 'U' 'U' 'U' 'U' 'M' 'A' 'U' 'U' 'U' 'U' 'A' 'U' 'A' 'A'
 'U' 'M' 'M' 'M' 'U' 'A' 'A' 'A' 'A' 'U' 'A' 'A' 'A' 'M' 'A' 'U' 'U' 'A'
 'U' 'M' 'M' 'A' 'U' 'U' 'M' 'M' 'U' 'U' 'U' 'M' 'U' 'U' 'A' 'A' 'A' 'M'
 'M' 'U' 'U' 'M' 'U' 'U' 'U' 'A' 'U' 'U' 'U' 'U' 'M' 'U' 'A' 'A' 'U' 'A'
 'U' 'A' 'A' 'A' 'U' 'A' 'U' 'A' 'U' 'U' 'M' 'M' 'U' 'A' 'A' 'M' 'M' 'M']"
24501,2,133,70,63,65,0,0,"['A' 'U' 'U' 'U' 'M' 'U' 'M' 'A' 'M' 'A' 'A' 'U' 'A' 'A' 'A' 'M' 'A' 'A'
 'M' 'A' 'M' 'U' 'M' 'M' 'A' 'A' 'A' 'U' 'M' 'M' 'A' 'A' 'A' 'A' 'M' 'M'
 'A' 'U' 'A' 'A' 'M' 'U' 'A' 'U' 'A' 'M' 'U' 'A' 'A' 'M' 'M' 'U' 'A' 'A'
 'U' 'A' 'U' 'U' 'A' 'U' 'U' 'U' 'A' 'A' 'U' 'M' 'M' 'M' 'M' 'M' 'M' 'U'
 'M' 'M' 'M' 'A' 'M' 'M' 'M' 'U' 'M' 'A' 'A' 'U' 'U' 'A' 'U' 'M' 'M' 'M'
 'A' 'U' 'U' 'U' 'U' 'M' 'U' 'A' 'M' 'A' 'U' 'U' 'U' 'M' 'M' 'M' 'A' 'U'
 'M' 'A' 'A' 'M' 'M' 'A' 'U' 'A' 'M' 'A' 'U' 'U' 'U' 'U' 'A' 'U' 'A' 'M'
 'U' 'M' 'M' 'M' 'U' 'A' 'A' 'A' 'A' 'A' 'A' 'U' 'A' 'M' 'A' 'U' 'U' 'A'
 'U' 'M' 'M' 'A' 'U' 'U' 'U' 'M' 'U' 'A' 'M' 'M' 'U' 'M' 'U' 'A' 'A' 'M'
 'M' 'A' 'A' 'M' 'U' 'U' 'U' 'U' 'U' 'U' 'U' 'M' 'M' 'U' 'A' 'A' 'A' 'A'
 'U' 'A' 'A' 'A' 'M' 'A' 'M' 'A' 'U' 'U' 'M' 'U' 'U' 'U' 'A' 'M' 'M' 'M']"
24601,0,129,64,65,69,1,0,"['A' 'M' 'U' 'U' 'M' 'U' 'M' 'U' 'M' 'U' 'A' 'U' 'A' 'A' 'A' 'U' 'U' 'U'
 'U' 'A' 'M' 'U' 'M' 'A' 'U' 'A' 'A' 'U' 'M' 'M' 'A' 'A' 'A' 'A' 'M' 'M'
 'A' 'A' 'A' 'U' 'U' 'U' 'A' 'U' 'A' 'M' 'M' 'U' 'U' 'A' 'M' 'M' 'A' 'A'
 'U' 'A' 'U' 'U' 'A' 'U' 'U' 'U' 'A' 'A' 'M' 'M' 'M' 'M' 'U' 'M' 'M' 'M'
 'M' 'M' 'M' 'A' 'M' 'M' 'M' 'U' 'U' 'A' 'U' 'M' 'U' 'A' 'U' 'M' 'M' 'M'
 'M' 'M' 'U' 'U' 'U' 'M' 'U' 'A' 'M' 'A' 'U' 'U' 'M' 'M' 'M' 'M' 'A' 'U'
 'M' 'A' 'A' 'M' 'M' 'U' 'A' 'A' 'M' 'A' 'U' 'U' 'U' 'U' 'A' 'M' 'A' 'M'
 'U' 'M' 'U' 'M' 'U' 'A' 'A' 'A' 'A' 'A' 'A' 'A' 'A' 'M' 'A' 'U' 'U' 'A'
 'U' 'M' 'M' 'U' 'U' 'U' 'A' 'M' 'U' 'A' 'M' 'M' 'U' 'U' 'U' 'A' 'A' 'M'
 'M' 'A' 'U' 'M' 'A' 'U' 'U' 'U' 'U' 'U' 'U' 'M' 'M' 'U' 'A' 'A' 'A' 'A'
 'M' 'A' 'A' 'A' 'M' 'A' 'M' 'U' 'U' 'U' 'M' 'M' 'U' 'U' 'A' 'M' 'M' 'A']"
24701,3,136,63,73,62,0,0,"['A' 'M' 'U' 'U' 'M' 'A' 'M' 'U' 'M' 'U' 'A' 'U' 'A' 'A' 'U' 'M' 'M' 'A'
 'M' 'A' 'U' 'U' 'M' 'A' 'U' 'A' 'A' 'M' 'M' 'M' 'A' 'A' 'A' 'A' 'M' 'M'
 'A' 'U' 'U' 'U' 'U' 'U' 'A' 'U' 'A' 'M' 'U' 'U' 'U' 'A' 'M' 'M' 'A' 'A'
 'U' 'A' 'U' 'A' 'A' 'U' 'U' 'A' 'U' 'A' 'U' 'M' 'M' 'M' 'M' 'M' 'U' 'M'
 'M' 'M' 'M' 'A' 'M' 'M' 'M' 'U' 'U' 'U' 'U' 'M' 'M' 'A' 'A' 'U' 'M' 'M'
 'M' 'M' 'U' 'U' 'U' 'M' 'U' 'A' 'M' 'A' 'U' 'U' 'M' 'M' 'M' 'M' 'A' 'M'
 'M' 'U' 'A' 'M' 'U' 'A' 'A' 'A' 'M' 'A' 'M' 'U' 'U' 'M' 'A' 'M' 'A' 'M'
 'U' 'M' 'U' 'M' 'A' 'A' 'A' 'A' 'A' 'A' 'A' 'A' 'A' 'M' 'A' 'A' 'A' 'A'
 'A' 'M' 'M' 'U' 'U' 'M' 'A' 'M' 'U' 'A' 'M' 'M' 'U' 'A' 'M' 'U' 'U' 'M'
 'M' 'U' 'U' 'M' 'U' 'U' 'U' 'U' 'U' 'M' 'U' 'M' 'M' 'M' 'A' 'U' 'A' 'A'
 'M' 'A' 'U' 'A' 'M' 'A' 'M' 'U' 'U' 'M' 'M' 'M' 'U' 'M' 'A' 'U' 'M' 'A']"
24801,1,137,64,73,61,0,0,"['A' 'A' 'U' 'U' 'U' 'A' 'A' 'A' 'M' 'M' 'A' 'A' 'U' 'A' 'U' 'U' 'U' 'U'
 'M' 'A' 'A' 'M' 'U' 'U' 'U' 'A' 'A' 'M' 'M' 'M' 'A' 'A' 'A' 'A' 'M' 'M'
 'A' 'U' 'M' 'M' 'U' 'U' 'A' 'U' 'A' 'M' 'A' 'U' 'A' 'U' 'M' 'M' 'A' 'U'
 'U' 'A' 'U' 'M' 'U' 'M' 'U' 'A' 'U' 'A' 'A' 'M' 'M' 'M' 'U' 'M' 'M' 'M'
 'M' 'M' 'M' 'A' 'M' 'M' 'M' 'U' 'U' 'A' 'M' 'M' 'M' 'U' 'A' 'A' 'U' 'M'
 'M' 'M' 'U' 'A' 'U' 'M' 'M' 'U' 'M' 'A' 'M' 'U' 'M' 'M' 'M' 'U' 'A' 'M'
 'M' 'M' 'A' 'M' 'U' 'A' 'A' 'A' 'M' 'A' 'M' 'U' 'U' 'M' 'A' 'U' 'U' 'M'
 'U' 'U' 'U' 'M' 'A' 'A' 'A' 'A' 'A' 'A' 'A' 'A' 'A' 'U' 'U' 'U' 'A' 'A'
 'U' 'M' 'M' 'U' 'U' 'M' 'A' 'M' 'U' 'A' 'M' 'U' 'U' 'A' 'U' 'A' 'U' 'M'
 'M' 'M' 'U' 'M' 'U' 'M' 'U' 'U' 'A' 'M' 'A' 'U' 'M' 'M' 'A' 'M' 'A' 'U'
 'M' 'A' 'M' 'A' 'U' 'A' 'M' 'A' 'U' 'M' 'M' 'M' 'U' 'M' 'A' 'M' 'M' 'A']"
24901,0,125,54,71,73,0,0,"['A' 'A' 'U' 'U' 'U' 'A' 'U' 'A' 'M' 'M' 'A' 'A' 'U' 'A' 'A' 'U' 'M' 'M'
 'M' 'A' 'A' 'U' 'U' 'U' 'U' 'A' 'A' 'M' 'M' 'U' 'A' 'A' 'A' 'A' 'U' 'M'
 'A' 'U' 'M' 'M' 'M' 'U' 'A' 'A' 'U' 'U' 'A' 'U' 'A' 'M' 'M' 'U' 'U' 'U'
 'A' 'A' 'U' 'U' 'M' 'M' 'U' 'U' 'U' 'U' 'A' 'U' 'M' 'M' 'M' 'M' 'M' 'M'
 'M' 'M' 'M' 'U' 'M' 'M' 'M' 'M' 'M' 'A' 'M' 'M' 'M' 'U' 'A' 'A' 'U' 'M'
 'M' 'M' 'U' 'A' 'U' 'U' 'M' 'U' 'M' 'U' 'M' 'U' 'A' 'M' 'M' 'U' 'A' 'M'
 'M' 'M' 'A' 'M' 'U' 'A' 'A' 'U' 'M' 'A' 'M' 'U' 'M' 'M' 'U' 'U' 'M' 'M'
 'U' 'U' 'M' 'M' 'A' 'U' 'U' 'A' 'A' 'A' 'A' 'A' 'A' 'M' 'U' 'U' 'A' 'A'
 'U' 'M' 'U' 'U' 'U' 'M' 'U' 'M' 'U' 'A' 'M' 'U' 'U' 'U' 'U' 'A' 'U' 'M'
 'M' 'M' 'U' 'M' 'U' 'M' 'U' 'U' 'A' 'U' 'A' 'U' 'U' 'M' 'U' 'M' 'A' 'U'
 'M' 'A' 'U' 'A' 'U' 'U' 'M' 'A' 'A' 'M' 'U' 'M' 'U' 'M' 'A' 'M' 'M' 'A']"
25001,2,126,52,74,72,0,1,"['A' 'A' 'U' 'U' 'U' 'U' 'U' 'A' 'M' 'M' 'A' 'M' 'A' 'A' 'A' 'M' 'M' 'M'
 'M' 'A' 'U' 'U' 'U' 'A' 'U' 'U' 'A' 'M' 'M' 'U' 'U' 'A' 'A' 'U' 'U' 'M'
 'U' 'U' 'M' 'M' 'U' 'M' 'A' 'A' 'U' 'U' 'U' 'U' 'A' 'M' 'M' 'U' 'A' 'U'
 'A' 'U' 'U' 'U' 'U' 'M' 'M' 'M' 'A' 'U' 'A' 'M' 'M' 'M' 'M' 'U' 'M' 'M'
 'M' 'M' 'M' 'U' 'M' 'U' 'M' 'U' 'M' 'U' 'M' 'M' 'M' 'U' 'A' 'A' 'M' 'M'
 'M' 'M' 'U' 'A' 'U' 'U' 'A' 'U' 'U' 'U' 'M' 'U' 'A' 'M' 'M' 'U' 'A' 'M'
 'M' 'M' 'A' 'U' 'U' 'A' 'A' 'A' 'M' 'U' 'U' 'M' 'U' 'M' 'A' 'U' 'M' 'M'
 'U' 'A' 'M' 'M' 'A' 'A' 'A' 'A' 'A' 'A' 'A' 'A' 'U' 'M' 'U' 'M' 'A' 'A'
 'U' 'M' 'U' 'M' 'U' 'M' 'M' 'M' 'U' 'A' 'M' 'U' 'U' 'U' 'U' 'U' 'A' 'U'
 'M' 'M' 'M' 'M' 'A' 'M' 'M' 'U' 'A' 'U' 'U' 'U' 'U' 'M' 'A' 'M' 'U' 'U'
 'M' 'A' 'U' 'A' 'U' 'M' 'M' 'A' 'A' 'M' 'M' 'M' 'U' 'U' 'A' 'M' 'M' 'A']"
25101,3,121,55,66,77,0,0,"['A' 'U' 'U' 'U' 'U' 'U' 'U' 'A' 'U' 'M' 'A' 'M' 'A' 'U' 'A' 'M' 'A' 'M'
 'M' 'A' 'U' 'U' 'A' 'U' 'A' 'A' 'A' 'M' 'U' 'U' 'U' 'A' 'A' 'M' 'U' 'M'
 'U' 'U' 'U' 'M' 'U' 'U' 'A' 'A' 'U' 'U' 'A' 'U' 'U' 'M' 'M' 'M' 'A' 'M'
 'A' 'U' 'A' 'U' 'U' 'M' 'M' 'U' 'A' 'U' 'A' 'U' 'M' 'M' 'M' 'M' 'M' 'M'
 'M' 'M' 'M' 'U' 'M' 'U' 'U' 'U' 'M' 'A' 'U' 'M' 'M' 'M' 'A' 'A' 'U' 'M'
 'M' 'M' 'M' 'A' 'U' 'U' 'A' 'U' 'U' 'M' 'M' 'U' 'A' 'M' 'U' 'U' 'A' 'M'
 'M' 'M' 'A' 'U' 'U' 'U' 'A' 'A' 'M' 'U' 'U' 'M' 'U' 'M' 'U' 'U' 'M' 'M'
 'A' 'U' 'M' 'U' 'A' 'A' 'A' 'A' 'A' 'A' 'A' 'A' 'U' 'M' 'U' 'M' 'U' 'A'
 'U' 'U' 'A' 'M' 'U' 'M' 'M' 'U' 'U' 'A' 'M' 'M' 'A' 'U' 'U' 'U' 'A' 'U'
 'M' 'M' 'M' 'M' 'A' 'U' 'M' 'U' 'A' 'U' 'A' 'U' 'U' 'M' 'A' 'M' 'A' 'U'
 'U' 'A' 'U' 'A' 'M' 'M' 'M' 'A' 'U' 'M' 'M' 'U' 'U' 'M' 'A' 'M' 'U' 'A']"
25201,1,131,59,72,67,0,1,"['A' 'U' 'U' 'U' 'U' 'U' 'U' 'A' 'M' 'M' 'A' 'M' 'U' 'U' 'U' 'U' 'A' 'M'
 'M' 'A' 'U' 'M' 'A' 'U' 'A' 'A' 'A' 'M' 'U' 'A' 'U' 'A' 'A' 'M' 'U' 'M'
 'A' 'U' 'U' 'M' 'U' 'A' 'M' 'A' 'U' 'A' 'A' 'M' 'M' 'M' 'M' 'M' 'A' 'M'
 'A' 'A' 'A' 'M' 'U' 'M' 'M' 'U' 'A' 'U' 'A' 'M' 'U' 'M' 'M' 'M' 'M' 'M'
 'M' 'M' 'M' 'U' 'M' 'A' 'U' 'U' 'M' 'A' 'U' 'M' 'M' 'M' 'U' 'A' 'U' 'M'
 'U' 'M' 'M' 'U' 'A' 'U' 'A' 'U' 'U' 'M' 'M' 'U' 'A' 'M' 'U' 'U' 'A' 'M'
 'M' 'M' 'A' 'U' 'U' 'U' 'A' 'U' 'M' 'U' 'U' 'M' 'U' 'M' 'A' 'M' 'U' 'M'
 'A' 'M' 'M' 'U' 'A' 'A' 'A' 'A' 'A' 'A' 'A' 'A' 'A' 'M' 'U' 'M' 'U' 'A'
 'A' 'A' 'A' 'M' 'M' 'M' 'A' 'U' 'A' 'U' 'M' 'M' 'A' 'A' 'M' 'U' 'A' 'U'
 'M' 'M' 'U' 'M' 'A' 'U' 'M' 'U' 'A' 'U' 'U' 'A' 'M' 'M' 'U' 'M' 'A' 'U'
 'U' 'A' 'U' 'U' 'M' 'U' 'M' 'A' 'M' 'M' 'M' 'A' 'U' 'M' 'U' 'M' 'U' 'U']"
25301,3,122,58,64,76,1,0,"['A' 'U' 'A' 'U' 'U' 'U' 'U' 'A' 'M' 'U' 'U' 'M' 'U' 'U' 'U' 'U' 'A' 'M'
 'M' 'M' 'U' 'M' 'U' 'U' 'U' 'A' 'A' 'M' 'M' 'A' 'U' 'U' 'A' 'M' 'U' 'M'
 'A' 'U' 'U' 'M' 'U' 'A' 'M' 'A' 'A' 'A' 'U' 'M' 'M' 'M' 'A' 'M' 'A' 'M'
 'U' 'A' 'U' 'M' 'U' 'M' 'M' 'U' 'A' 'U' 'A' 'M' 'M' 'M' 'M' 'M' 'M' 'M'
 'M' 'M' 'U' 'U' 'U' 'A' 'U' 'U' 'M' 'A' 'U' 'M' 'U' 'M' 'U' 'A' 'U' 'U'
 'U' 'U' 'M' 'U' 'A' 'U' 'U' 'M' 'U' 'M' 'M' 'U' 'A' 'M' 'U' 'U' 'A' 'M'
 'M' 'M' 'A' 'U' 'A' 'U' 'A' 'U' 'A' 'U' 'U' 'M' 'U' 'M' 'A' 'U' 'M' 'U'
 'A' 'M' 'M' 'A' 'A' 'A' 'A' 'A' 'A' 'A' 'A' 'A' 'A' 'M' 'U' 'U' 'U' 'A'
 'A' 'A' 'A' 'M' 'M' 'M' 'U' 'U' 'A' 'U' 'M' 'M' 'A' 'A' 'M' 'M' 'A' 'U'
 'U' 'A' 'U' 'M' 'A' 'U' 'M' 'U' 'A' 'U' 'U' 'A' 'M' 'U' 'U' 'M' 'A' 'M'
 'U' 'A' 'U' 'U' 'M' 'A' 'M' 'A' 'A' 'M' 'M' 'A' 'U' 'M' 'U' 'M' 'U' 'U']"
25401,2,122,62,60,76,1,0,"['A' 'A' 'A' 'A' 'U' 'A' 'U' 'A' 'M' 'U' 'U' 'M' 'U' 'U' 'U' 'M' 'U' 'M'
 'M' 'M' 'A' 'M' 'U' 'M' 'U' 'A' 'A' 'A' 'M' 'A' 'M' 'A' 'A' 'U' 'U' 'M'
 'A' 'U' 'M' 'M' 'U' 'U' 'M' 'A' 'A' 'A' 'U' 'M' 'M' 'U' 'A' 'U' 'A' 'M'
 'M' 'A' 'U' 'M' 'U' 'M' 'U' 'A' 'A' 'U' 'A' 'M' 'M' 'M' 'M' 'M' 'M' 'M'
 'M' 'U' 'M' 'U' 'U' 'A' 'U' 'U' 'M' 'A' 'U' 'U' 'U' 'M' 'U' 'A' 'U' 'U'
 'U' 'U' 'U' 'U' 'U' 'U' 'U' 'M' 'U' 'M' 'M' 'U' 'A' 'M' 'U' 'U' 'A' 'M'
 'U' 'U' 'A' 'A' 'A' 'U' 'A' 'A' 'A' 'M' 'U' 'M' 'U' 'U' 'A' 'M' 'U' 'U'
 'A' 'M' 'M' 'U' 'A' 'A' 'A' 'A' 'A' 'A' 'A' 'A' 'A' 'M' 'A' 'U' 'U' 'A'
 'A' 'A' 'A' 'U' 'M' 'M' 'U' 'M' 'A' 'M' 'M' 'M' 'A' 'U' 'M' 'M' 'U' 'U'
 'U' 'A' 'A' 'M' 'U' 'M' 'M' 'A' 'U' 'A' 'U' 'U' 'U' 'U' 'U' 'M' 'A' 'U'
 'U' 'A' 'U' 'U' 'M' 'A' 'M' 'U' 'A' 'M' 'M' 'A' 'U' 'M' 'U' 'M' 'A' 'U']"
25501,1,115,61,54,83,1,0,"['A' 'U' 'A' 'A' 'U' 'A' 'U' 'A' 'M' 'U' 'U' 'M' 'U' 'M' 'U' 'M' 'U' 'M'
 'U' 'M' 'A' 'M' 'U' 'M' 'U' 'U' 'A' 'A' 'U' 'U' 'M' 'A' 'A' 'U' 'U' 'M'
 'A' 'U' 'M' 'M' 'U' 'M' 'M' 'A' 'A' 'A' 'U' 'M' 'U' 'U' 'A' 'U' 'A' 'M'
 'M' 'A' 'U' 'M' 'U' 'U' 'U' 'A' 'A' 'U' 'A' 'M' 'M' 'M' 'M' 'M' 'M' 'U'
 'M' 'M' 'M' 'U' 'U' 'A' 'U' 'A' 'M' 'A' 'U' 'U' 'U' 'U' 'U' 'A' 'U' 'U'
 'A' 'U' 'U' 'M' 'U' 'A' 'U' 'M' 'U' 'M' 'M' 'U' 'A' 'M' 'U' 'A' 'U' 'U'
 'A' 'A' 'A' 'A' 'A' 'U' 'A' 'A' 'A' 'M' 'U' 'M' 'M' 'U' 'A' 'U' 'U' 'U'
 'U' 'M' 'M' 'U' 'U' 'A' 'U' 'A' 'A' 'A' 'A' 'A' 'A' 'U' 'A' 'U' 'M' 'A'
 'A' 'A' 'A' 'M' 'M' 'M' 'U' 'M' 'U' 'M' 'U' 'U' 'A' 'M' 'U' 'M' 'U' 'U'
 'U' 'U' 'A' 'M' 'U' 'M' 'M' 'A' 'U' 'A' 'U' 'U' 'U' 'A' 'U' 'M' 'A' 'U'
 'U' 'A' 'U' 'U' 'U' 'U' 'M' 'A' 'A' 'M' 'U' 'U' 'U' 'M' 'A' 'M' 'A' 'A']"
25601,2,124,57,67,74,1,0,"['A' 'A' 'A' 'A' 'U' 'A' 'U' 'A' 'M' 'U' 'U' 'M' 'M' 'M' 'U' 'M' 'U' 'U'
 'U' 'M' 'A' 'M' 'U' 'M' 'U' 'M' 'U' 'A' 'U' 'U' 'M' 'U' 'A' 'U' 'U' 'M'
 'A' 'U' 'M' 'M' 'M' 'M' 'M' 'U' 'A' 'A' 'U' 'M' 'U' 'U' 'A' 'U' 'U' 'M'
 'M' 'A' 'M' 'M' 'U' 'U' 'U' 'A' 'A' 'A' 'A' 'M' 'M' 'M' 'M' 'M' 'M' 'M'
 'M' 'U' 'M' 'U' 'U' 'A' 'M' 'A' 'U' 'A' 'U' 'M' 'U' 'U' 'U' 'A' 'U' 'U'
 'A' 'U' 'U' 'M' 'M' 'U' 'M' 'M' 'U' 'M' 'M' 'U' 'A' 'M' 'U' 'A' 'U' 'U'
 'A' 'A' 'A' 'A' 'A' 'A' 'U' 'U' 'A' 'M' 'U' 'M' 'M' 'U' 'A' 'U' 'A' 'M'
 'U' 'M' 'M' 'U' 'U' 'A' 'A' 'A' 'A' 'A' 'A' 'A' 'A' 'M' 'A' 'U' 'U' 'M'
 'U' 'A' 'A' 'M' 'M' 'M' 'U' 'M' 'A' 'M' 'U' 'M' 'A' 'M' 'U' 'M' 'M' 'M'
 'U' 'M' 'A' 'M' 'M' 'M' 'A' 'A' 'U' 'A' 'M' 'U' 'U' 'A' 'U' 'M' 'A' 'U'
 'U' 'A' 'U' 'U' 'U' 'U' 'M' 'A' 'U' 'U' 'M' 'U' 'U' 'M' 'A' 'M' 'A' 'U']"
25701,0,121,56,65,77,1,0,"['A' 'A' 'A' 'U' 'U' 'A' 'A' 'A' 'M' 'U' 'U' 'M' 'U' 'M' 'U' 'M' 'U' 'U'
 'U' 'M' 'A' 'M' 'U' 'M' 'U' 'U' 'U' 'A' 'U' 'U' 'M' 'U' 'U' 'U' 'U' 'M'
 'A' 'U' 'M' 'M' 'M' 'M' 'M' 'M' 'A' 'U' 'M' 'M' 'A' 'M' 'U' 'U' 'U' 'M'
 'M' 'A' 'U' 'M' 'U' 'A' 'U' 'A' 'A' 'A' 'A' 'M' 'M' 'M' 'M' 'U' 'M' 'M'
 'M' 'M' 'M' 'U' 'M' 'A' 'M' 'A' 'U' 'A' 'U' 'M' 'U' 'U' 'A' 'A' 'U' 'U'
 'U' 'U' 'U' 'M' 'U' 'U' 'M' 'M' 'A' 'M' 'M' 'A' 'A' 'U' 'U' 'A' 'U' 'A'
 'U' 'A' 'A' 'A' 'A' 'U' 'M' 'A' 'A' 'M' 'M' 'U' 'U' 'U' 'A' 'U' 'U' 'M'
 'U' 'U' 'M' 'U' 'U' 'A' 'A' 'A' 'A' 'A' 'U' 'A' 'A' 'M' 'A' 'U' 'U' 'M'
 'U' 'A' 'U' 'M' 'M' 'M' 'U' 'M' 'A' 'M' 'M' 'U' 'A' 'M' 'A' 'M' 'M' 'M'
 'M' 'M' 'A' 'M' 'M' 'M' 'A' 'U' 'U' 'A' 'M' 'U' 'U' 'A' 'M' 'U' 'U' 'A'
 'U' 'A' 'U' 'M' 'U' 'U' 'U' 'A' 'U' 'U' 'M' 'A' 'U' 'M' 'A' 'U' 'A' 'U']"
25801,1,131,62,69,67,0,0,"['A' 'A' 'U' 'M' 'U' 'A' 'A' 'A' 'M' 'A' 'U' 'M' 'M' 'M' 'U' 'M' 'U' 'U'
 'U' 'U' 'A' 'U' 'U' 'M' 'U' 'U' 'U' 'A' 'U' 'M' 'M' 'U' 'U' 'A' 'M' 'M'
 'M' 'M' 'M' 'M' 'M' 'M' 'U' 'M' 'A' 'A' 'M' 'U' 'A' 'M' 'M' 'A' 'U' 'M'
 'M' 'A' 'M' 'M' 'A' 'A' 'U' 'A' 'A' 'A' 'A' 'M' 'M' 'M' 'U' 'M' 'M' 'M'
 'M' 'M' 'M' 'M' 'M' 'A' 'U' 'A' 'U' 'A' 'U' 'U' 'U' 'U' 'U' 'A' 'U' 'A'
 'A' 'U' 'U' 'M' 'U' 'U' 'M' 'M' 'A' 'M' 'M' 'A' 'A' 'U' 'U' 'A' 'A' 'U'
 'U' 'U' 'A' 'U' 'A' 'U' 'M' 'A' 'U' 'M' 'M' 'M' 'U' 'U' 'A' 'U' 'M' 'M'
 'U' 'A' 'M' 'U' 'U' 'A' 'A' 'A' 'A' 'A' 'A' 'A' 'A' 'M' 'A' 'U' 'U' 'M'
 'U' 'U' 'U' 'U' 'M' 'M' 'A' 'M' 'A' 'U' 'U' 'A' 'A' 'M' 'A' 'M' 'M' 'M'
 'M' 'U' 'A' 'M' 'M' 'M' 'A' 'M' 'M' 'A' 'M' 'A' 'U' 'A' 'U' 'U' 'U' 'A'
 'M' 'A' 'M' 'A' 'U' 'U' 'U' 'A' 'U' 'M' 'M' 'A' 'U' 'M' 'A' 'U' 'A' 'U']"
25901,0,123,59,64,75,0,1,"['A' 'U' 'U' 'M' 'A' 'A' 'U' 'A' 'M' 'A' 'U' 'U' 'M' 'M' 'U' 'U' 'M' 'A'
 'U' 'U' 'A' 'A' 'M' 'M' 'U' 'U' 'U' 'A' 'U' 'U' 'M' 'U' 'U' 'A' 'M' 'M'
 'M' 'U' 'M' 'M' 'M' 'M' 'U' 'M' 'U' 'U' 'M' 'U' 'A' 'M' 'M' 'A' 'U' 'M'
 'M' 'A' 'U' 'U' 'A' 'A' 'U' 'U' 'A' 'A' 'U' 'M' 'U' 'M' 'M' 'M' 'M' 'M'
 'M' 'M' 'M' 'U' 'M' 'U' 'M' 'A' 'U' 'A' 'A' 'U' 'U' 'U' 'U' 'A' 'M' 'A'
 'A' 'U' 'M' 'U' 'U' 'M' 'U' 'M' 'A' 'M' 'M' 'A' 'A' 'U' 'U' 'U' 'A' 'U'
 'M' 'A' 'A' 'U' 'A' 'A' 'M' 'A' 'U' 'M' 'U' 'U' 'U' 'U' 'A' 'U' 'U' 'M'
 'U' 'A' 'U' 'M' 'U' 'A' 'A' 'A' 'A' 'A' 'A' 'A' 'A' 'M' 'U' 'A' 'A' 'M'
 'U' 'U' 'U' 'U' 'M' 'M' 'A' 'M' 'A' 'U' 'U' 'A' 'A' 'M' 'A' 'M' 'M' 'M'
 'M' 'U' 'A' 'M' 'U' 'M' 'A' 'M' 'M' 'A' 'M' 'A' 'U' 'A' 'U' 'M' 'U' 'A'
 'U' 'A' 'M' 'U' 'U' 'M' 'U' 'U' 'U' 'M' 'M' 'A' 'A' 'M' 'A' 'U' 'U' 'U']"
26001,1,124,59,65,74,0,1,"['A' 'U' 'U' 'M' 'A' 'A' 'U' 'A' 'M' 'A' 'U' 'U' 'M' 'M' 'M' 'U' 'U' 'A'
 'U' 'M' 'A' 'A' 'M' 'M' 'A' 'U' 'U' 'U' 'M' 'U' 'M' 'U' 'U' 'A' 'M' 'M'
 'U' 'U' 'M' 'M' 'M' 'M' 'U' 'M' 'M' 'U' 'M' 'U' 'A' 'A' 'M' 'A' 'U' 'M'
 'M' 'A' 'A' 'U' 'U' 'U' 'M' 'U' 'U' 'A' 'U' 'M' 'M' 'M' 'M' 'M' 'M' 'M'
 'M' 'M' 'U' 'A' 'U' 'U' 'M' 'M' 'U' 'A' 'A' 'U' 'U' 'U' 'A' 'A' 'M' 'A'
 'A' 'U' 'M' 'U' 'U' 'M' 'U' 'M' 'A' 'M' 'M' 'U' 'A' 'U' 'U' 'U' 'A' 'U'
 'U' 'U' 'A' 'U' 'U' 'A' 'M' 'A' 'A' 'M' 'U' 'U' 'U' 'A' 'A' 'U' 'U' 'M'
 'U' 'A' 'U' 'M' 'U' 'A' 'A' 'A' 'A' 'A' 'A' 'A' 'A' 'U' 'A' 'A' 'A' 'M'
 'U' 'U' 'U' 'M' 'M' 'M' 'A' 'U' 'A' 'U' 'U' 'A' 'A' 'U' 'A' 'M' 'M' 'M'
 'M' 'M' 'A' 'M' 'A' 'M' 'U' 'M' 'M' 'A' 'U' 'A' 'M' 'A' 'U' 'U' 'U' 'M'
 'U' 'A' 'M' 'A' 'U' 'M' 'U' 'U' 'U' 'M' 'M' 'A' 'A' 'M' 'A' 'U' 'M' 'U']"
26101,1,113,52,61,85,0,0,"['A' 'U' 'U' 'U' 'A' 'A' 'U' 'U' 'M' 'A' 'U' 'M' 'M' 'M' 'U' 'U' 'U' 'U'
 'U' 'M' 'A' 'A' 'M' 'M' 'A' 'U' 'M' 'U' 'M' 'U' 'U' 'U' 'U' 'A' 'M' 'M'
 'U' 'A' 'M' 'M' 'M' 'A' 'U' 'M' 'M' 'U' 'M' 'U' 'A' 'A' 'U' 'A' 'U' 'M'
 'M' 'U' 'U' 'U' 'U' 'U' 'M' 'U' 'M' 'U' 'A' 'M' 'M' 'M' 'M' 'M' 'M' 'M'
 'U' 'M' 'M' 'U' 'U' 'M' 'M' 'M' 'U' 'M' 'A' 'M' 'U' 'A' 'A' 'U' 'M' 'M'
 'A' 'U' 'M' 'U' 'U' 'U' 'U' 'M' 'U' 'U' 'M' 'M' 'A' 'U' 'U' 'U' 'U' 'U'
 'U' 'M' 'A' 'U' 'U' 'U' 'M' 'U' 'A' 'A' 'U' 'U' 'U' 'A' 'A' 'U' 'U' 'M'
 'U' 'U' 'U' 'M' 'U' 'A' 'A' 'A' 'A' 'A' 'A' 'A' 'A' 'U' 'A' 'A' 'A' 'M'
 'A' 'U' 'U' 'U' 'M' 'A' 'A' 'U' 'A' 'M' 'U' 'A' 'A' 'A' 'A' 'M' 'M' 'M'
 'U' 'M' 'A' 'M' 'U' 'M' 'U' 'U' 'M' 'A' 'U' 'A' 'U' 'A' 'A' 'U' 'U' 'U'
 'U' 'A' 'M' 'A' 'U' 'M' 'M' 'U' 'U' 'M' 'M' 'A' 'U' 'M' 'A' 'U' 'U' 'U']"
26201,0,127,54,73,71,0,0,"['A' 'U' 'U' 'U' 'M' 'A' 'U' 'U' 'M' 'A' 'U' 'A' 'M' 'M' 'A' 'U' 'U' 'M'
 'M' 'M' 'U' 'A' 'M' 'M' 'U' 'U' 'M' 'U' 'M' 'U' 'M' 'A' 'M' 'A' 'M' 'M'
 'U' 'A' 'U' 'M' 'M' 'A' 'U' 'M' 'M' 'U' 'M' 'U' 'A' 'A' 'U' 'U' 'U' 'M'
 'M' 'A' 'M' 'M' 'M' 'U' 'M' 'U' 'M' 'M' 'A' 'M' 'M' 'M' 'M' 'M' 'M' 'U'
 'M' 'M' 'M' 'M' 'U' 'A' 'M' 'M' 'U' 'M' 'U' 'U' 'U' 'A' 'A' 'A' 'M' 'M'
 'A' 'U' 'M' 'U' 'M' 'U' 'U' 'U' 'U' 'U' 'U' 'M' 'U' 'M' 'U' 'U' 'M' 'U'
 'U' 'M' 'A' 'M' 'U' 'U' 'M' 'U' 'A' 'A' 'U' 'U' 'U' 'A' 'A' 'U' 'U' 'M'
 'U' 'U' 'U' 'M' 'U' 'U' 'A' 'A' 'A' 'A' 'A' 'A' 'A' 'U' 'A' 'A' 'U' 'M'
 'A' 'A' 'U' 'U' 'M' 'U' 'U' 'A' 'A' 'M' 'U' 'A' 'A' 'U' 'A' 'M' 'M' 'M'
 'U' 'M' 'A' 'M' 'U' 'M' 'M' 'U' 'M' 'A' 'U' 'A' 'M' 'A' 'A' 'U' 'U' 'M'
 'A' 'A' 'M' 'A' 'A' 'M' 'M' 'M' 'U' 'M' 'A' 'A' 'A' 'M' 'A' 'U' 'A' 'M']"
26301,3,114,50,64,84,1,0,"['A' 'U' 'U' 'U' 'M' 'U' 'A' 'A' 'U' 'U' 'U' 'A' 'U' 'M' 'A' 'U' 'U' 'U'
 'M' 'M' 'U' 'A' 'M' 'M' 'U' 'A' 'U' 'U' 'A' 'U' 'M' 'A' 'M' 'A' 'U' 'U'
 'U' 'A' 'U' 'M' 'M' 'A' 'U' 'M' 'U' 'U' 'U' 'M' 'A' 'M' 'U' 'U' 'U' 'M'
 'M' 'A' 'M' 'M' 'M' 'U' 'M' 'M' 'M' 'M' 'A' 'M' 'M' 'M' 'U' 'M' 'M' 'M'
 'M' 'M' 'M' 'M' 'U' 'U' 'M' 'U' 'U' 'M' 'U' 'U' 'U' 'A' 'U' 'A' 'M' 'U'
 'U' 'A' 'M' 'A' 'M' 'U' 'U' 'U' 'U' 'U' 'U' 'M' 'U' 'U' 'U' 'U' 'M' 'M'
 'U' 'M' 'A' 'M' 'U' 'U' 'M' 'U' 'A' 'A' 'U' 'M' 'U' 'A' 'A' 'U' 'U' 'M'
 'A' 'U' 'U' 'M' 'U' 'A' 'A' 'A' 'A' 'A' 'A' 'A' 'U' 'A' 'A' 'A' 'A' 'M'
 'A' 'A' 'U' 'A' 'M' 'U' 'U' 'A' 'A' 'M' 'U' 'U' 'U' 'U' 'A' 'U' 'M' 'M'
 'M' 'M' 'A' 'M' 'U' 'M' 'M' 'U' 'M' 'U' 'U' 'U' 'M' 'U' 'A' 'U' 'U' 'U'
 'U' 'U' 'M' 'A' 'U' 'M' 'M' 'M' 'U' 'M' 'A' 'A' 'A' 'M' 'A' 'A' 'U' 'U']"
26401,0,114,49,65,84,0,0,"['A' 'A' 'U' 'U' 'M' 'U' 'A' 'A' 'M' 'U' 'U' 'A' 'A' 'M' 'A' 'U' 'U' 'U'
 'M' 'M' 'U' 'U' 'M' 'M' 'U' 'A' 'M' 'U' 'A' 'U' 'U' 'A' 'M' 'A' 'A' 'A'
 'U' 'A' 'U' 'U' 'M' 'A' 'U' 'M' 'U' 'U' 'U' 'M' 'U' 'M' 'M' 'U' 'U' 'M'
 'M' 'A' 'M' 'U' 'M' 'U' 'U' 'M' 'A' 'M' 'U' 'M' 'M' 'M' 'M' 'M' 'U' 'M'
 'M' 'M' 'M' 'M' 'U' 'M' 'U' 'U' 'U' 'M' 'U' 'U' 'A' 'A' 'U' 'A' 'M' 'U'
 'U' 'A' 'M' 'A' 'U' 'U' 'U' 'M' 'U' 'U' 'U' 'U' 'U' 'U' 'U' 'M' 'M' 'M'
 'A' 'M' 'M' 'M' 'U' 'U' 'M' 'M' 'A' 'A' 'A' 'M' 'M' 'U' 'A' 'U' 'U' 'M'
 'A' 'A' 'M' 'U' 'U' 'A' 'A' 'U' 'A' 'A' 'A' 'A' 'A' 'A' 'A' 'A' 'U' 'M'
 'A' 'A' 'U' 'A' 'A' 'M' 'U' 'A' 'A' 'M' 'U' 'U' 'U' 'U' 'U' 'U' 'M' 'M'
 'U' 'M' 'U' 'M' 'U' 'M' 'M' 'U' 'M' 'U' 'U' 'U' 'M' 'U' 'U' 'U' 'M' 'U'
 'U' 'U' 'M' 'A' 'M' 'M' 'M' 'M' 'U' 'M' 'A' 'A' 'U' 'U' 'U' 'A' 'U' 'U']"
26501,1,114,50,64,84,0,0,"['A' 'U' 'U' 'U' 'U' 'U' 'A' 'U' 'M' 'U' 'U' 'U' 'A' 'M' 'U' 'U' 'M' 'U'
 'M' 'M' 'U' 'U' 'A' 'M' 'U' 'A' 'U' 'A' 'A' 'A' 'U' 'A' 'M' 'U' 'A' 'A'
 'U' 'U' 'U' 'M' 'M' 'A' 'U' 'M' 'M' 'U' 'A' 'M' 'U' 'M' 'M' 'U' 'U' 'M'
 'M' 'A' 'M' 'U' 'M' 'U' 'U' 'M' 'A' 'M' 'U' 'M' 'M' 'M' 'M' 'M' 'M' 'M'
 'M' 'M' 'U' 'U' 'U' 'A' 'U' 'U' 'A' 'M' 'U' 'U' 'A' 'A' 'M' 'A' 'M' 'U'
 'U' 'A' 'U' 'U' 'U' 'U' 'A' 'M' 'U' 'U' 'U' 'U' 'A' 'U' 'U' 'M' 'M' 'M'
 'A' 'U' 'M' 'U' 'M' 'U' 'U' 'U' 'A' 'A' 'A' 'M' 'M' 'U' 'M' 'M' 'U' 'M'
 'A' 'A' 'M' 'U' 'M' 'U' 'A' 'A' 'A' 'A' 'A' 'A' 'A' 'U' 'U' 'A' 'U' 'M'
 'U' 'U' 'M' 'A' 'A' 'M' 'M' 'A' 'A' 'M' 'U' 'A' 'U' 'U' 'U' 'U' 'M' 'M'
 'U' 'M' 'M' 'M' 'U' 'M' 'M' 'U' 'U' 'A' 'U' 'U' 'M' 'U' 'U' 'A' 'M' 'U'
 'U' 'U' 'M' 'A' 'M' 'M' 'M' 'U' 'A' 'U' 'A' 'A' 'U' 'A' 'U' 'A' 'M' 'U']"
26601,2,115,55,60,83,1,0,"['A' 'U' 'U' 'U' 'U' 'U' 'A' 'A' 'M' 'U' 'U' 'U' 'A' 'M' 'U' 'U' 'A' 'U'
 'U' 'U' 'U' 'A' 'A' 'M' 'U' 'A' 'U' 'A' 'A' 'U' 'U' 'A' 'U' 'U' 'A' 'U'
 'U' 'A' 'U' 'M' 'M' 'A' 'U' 'A' 'M' 'U' 'A' 'M' 'U' 'M' 'M' 'U' 'U' 'M'
 'U' 'A' 'M' 'M' 'U' 'U' 'A' 'M' 'A' 'M' 'M' 'M' 'M' 'M' 'M' 'M' 'M' 'U'
 'M' 'M' 'M' 'M' 'M' 'U' 'A' 'M' 'A' 'M' 'M' 'A' 'A' 'A' 'U' 'A' 'M' 'U'
 'A' 'A' 'U' 'U' 'U' 'U' 'M' 'M' 'U' 'U' 'U' 'U' 'A' 'U' 'A' 'M' 'M' 'U'
 'A' 'U' 'M' 'U' 'M' 'A' 'U' 'U' 'U' 'A' 'A' 'M' 'M' 'U' 'U' 'M' 'U' 'M'
 'A' 'A' 'M' 'A' 'U' 'A' 'U' 'A' 'A' 'A' 'A' 'A' 'A' 'U' 'U' 'A' 'U' 'M'
 'U' 'U' 'U' 'M' 'U' 'M' 'M' 'U' 'A' 'U' 'U' 'A' 'U' 'M' 'U' 'U' 'M' 'A'
 'U' 'M' 'M' 'M' 'U' 'M' 'M' 'A' 'U' 'A' 'U' 'U' 'M' 'U' 'M' 'U' 'M' 'A'
 'U' 'U' 'M' 'A' 'M' 'M' 'M' 'U' 'A' 'U' 'U' 'U' 'A' 'A' 'U' 'A' 'M' 'U']"
26701,3,120,62,58,78,0,0,"['A' 'U' 'U' 'U' 'U' 'U' 'A' 'U' 'M' 'U' 'A' 'M' 'A' 'M' 'A' 'U' 'A' 'U'
 'A' 'U' 'U' 'A' 'A' 'U' 'U' 'A' 'A' 'A' 'A' 'U' 'U' 'A' 'U' 'A' 'A' 'U'
 'U' 'A' 'U' 'M' 'M' 'A' 'U' 'U' 'M' 'M' 'A' 'U' 'U' 'U' 'U' 'U' 'U' 'M'
 'M' 'A' 'M' 'U' 'U' 'U' 'A' 'M' 'A' 'M' 'U' 'M' 'M' 'M' 'U' 'M' 'M' 'M'
 'M' 'M' 'M' 'M' 'M' 'M' 'A' 'M' 'A' 'M' 'M' 'A' 'A' 'A' 'M' 'A' 'U' 'U'
 'A' 'A' 'U' 'U' 'A' 'A' 'M' 'M' 'U' 'U' 'U' 'U' 'A' 'M' 'A' 'M' 'M' 'U'
 'A' 'U' 'M' 'U' 'M' 'A' 'U' 'U' 'A' 'A' 'U' 'M' 'M' 'U' 'U' 'U' 'U' 'M'
 'U' 'A' 'M' 'U' 'U' 'A' 'A' 'A' 'A' 'A' 'A' 'A' 'A' 'U' 'U' 'A' 'U' 'U'
 'A' 'U' 'U' 'M' 'A' 'M' 'M' 'U' 'A' 'A' 'M' 'A' 'U' 'M' 'U' 'M' 'M' 'A'
 'U' 'M' 'M' 'M' 'U' 'M' 'M' 'A' 'U' 'A' 'U' 'U' 'U' 'U' 'M' 'U' 'U' 'A'
 'A' 'U' 'M' 'U' 'M' 'M' 'M' 'U' 'A' 'U' 'M' 'U' 'A' 'A' 'U' 'A' 'M' 'U']"
26801,3,119,66,53,79,0,0,"['A' 'U' 'U' 'U' 'U' 'U' 'A' 'A' 'M' 'U' 'A' 'M' 'A' 'M' 'A' 'U' 'A' 'A'
 'M' 'U' 'A' 'A' 'A' 'U' 'A' 'A' 'A' 'A' 'A' 'A' 'M' 'A' 'U' 'A' 'A' 'U'
 'U' 'U' 'U' 'M' 'M' 'U' 'U' 'U' 'M' 'M' 'A' 'U' 'A' 'U' 'U' 'M' 'M' 'U'
 'M' 'A' 'U' 'A' 'U' 'U' 'U' 'M' 'U' 'M' 'U' 'M' 'M' 'M' 'M' 'M' 'M' 'M'
 'U' 'M' 'M' 'M' 'A' 'U' 'A' 'M' 'A' 'M' 'M' 'A' 'A' 'A' 'U' 'A' 'U' 'M'
 'A' 'A' 'U' 'U' 'A' 'A' 'M' 'M' 'U' 'U' 'A' 'U' 'A' 'M' 'A' 'U' 'M' 'U'
 'A' 'U' 'M' 'U' 'M' 'A' 'U' 'U' 'A' 'A' 'U' 'A' 'U' 'M' 'U' 'U' 'M' 'M'
 'U' 'U' 'M' 'U' 'U' 'A' 'A' 'A' 'A' 'A' 'A' 'A' 'A' 'U' 'U' 'A' 'U' 'U'
 'A' 'U' 'U' 'M' 'A' 'U' 'U' 'U' 'A' 'A' 'M' 'A' 'U' 'M' 'U' 'U' 'M' 'A'
 'U' 'U' 'M' 'M' 'U' 'M' 'U' 'U' 'A' 'U' 'U' 'U' 'M' 'U' 'U' 'U' 'U' 'A'
 'A' 'A' 'M' 'U' 'M' 'M' 'M' 'U' 'A' 'U' 'M' 'U' 'A' 'A' 'M' 'A' 'M' 'U']"
26901,1,125,63,62,73,0,0,"['A' 'U' 'M' 'U' 'U' 'U' 'A' 'A' 'M' 'A' 'U' 'M' 'A' 'M' 'U' 'U' 'A' 'U'
 'M' 'U' 'U' 'U' 'A' 'U' 'U' 'A' 'A' 'A' 'A' 'A' 'M' 'A' 'U' 'A' 'A' 'U'
 'U' 'U' 'U' 'U' 'M' 'U' 'M' 'U' 'M' 'M' 'A' 'A' 'A' 'U' 'U' 'M' 'M' 'U'
 'M' 'U' 'U' 'A' 'M' 'U' 'A' 'M' 'A' 'M' 'A' 'M' 'M' 'M' 'M' 'M' 'M' 'M'
 'M' 'U' 'M' 'M' 'A' 'U' 'A' 'U' 'A' 'U' 'U' 'A' 'A' 'U' 'U' 'A' 'U' 'M'
 'A' 'A' 'A' 'A' 'A' 'M' 'M' 'U' 'U' 'U' 'A' 'U' 'A' 'M' 'A' 'M' 'M' 'U'
 'U' 'A' 'M' 'U' 'M' 'U' 'M' 'U' 'A' 'U' 'U' 'A' 'U' 'M' 'U' 'U' 'M' 'M'
 'U' 'A' 'M' 'U' 'M' 'A' 'A' 'A' 'A' 'A' 'A' 'A' 'A' 'U' 'U' 'A' 'U' 'M'
 'U' 'U' 'A' 'M' 'M' 'U' 'A' 'A' 'A' 'A' 'M' 'A' 'M' 'M' 'U' 'U' 'M' 'A'
 'U' 'U' 'M' 'U' 'U' 'M' 'M' 'U' 'U' 'M' 'U' 'M' 'M' 'M' 'M' 'U' 'A' 'U'
 'A' 'A' 'M' 'U' 'M' 'M' 'M' 'U' 'A' 'U' 'M' 'U' 'A' 'A' 'M' 'A' 'M' 'U']"
27001,2,117,56,61,81,1,0,"['A' 'U' 'M' 'U' 'U' 'A' 'A' 'U' 'M' 'U' 'U' 'U' 'A' 'M' 'U' 'M' 'A' 'U'
 'M' 'U' 'U' 'M' 'A' 'U' 'U' 'A' 'A' 'A' 'A' 'U' 'M' 'A' 'M' 'U' 'U' 'M'
 'U' 'U' 'U' 'U' 'M' 'U' 'M' 'U' 'U' 'M' 'A' 'A' 'U' 'U' 'U' 'M' 'M' 'U'
 'M' 'U' 'A' 'U' 'M' 'U' 'A' 'M' 'A' 'M' 'U' 'M' 'M' 'M' 'U' 'M' 'M' 'M'
 'M' 'M' 'M' 'U' 'U' 'U' 'A' 'A' 'A' 'M' 'U' 'U' 'A' 'U' 'U' 'M' 'U' 'M'
 'A' 'A' 'A' 'A' 'A' 'M' 'M' 'M' 'A' 'U' 'U' 'U' 'A' 'M' 'A' 'U' 'U' 'U'
 'M' 'A' 'M' 'U' 'M' 'U' 'M' 'U' 'A' 'U' 'U' 'A' 'M' 'U' 'U' 'U' 'M' 'M'
 'U' 'M' 'M' 'U' 'M' 'A' 'A' 'A' 'A' 'A' 'A' 'A' 'U' 'U' 'U' 'U' 'A' 'M'
 'U' 'A' 'A' 'M' 'U' 'U' 'A' 'A' 'A' 'A' 'M' 'A' 'U' 'U' 'U' 'A' 'M' 'A'
 'U' 'U' 'M' 'U' 'U' 'U' 'M' 'U' 'U' 'U' 'U' 'M' 'M' 'M' 'M' 'U' 'A' 'A'
 'A' 'A' 'M' 'U' 'M' 'U' 'M' 'M' 'A' 'M' 'U' 'A' 'A' 'U' 'M' 'A' 'M' 'U']"
27101,2,119,52,67,79,0,0,"['A' 'M' 'M' 'M' 'U' 'A' 'A' 'M' 'U' 'U' 'U' 'U' 'A' 'M' 'U' 'M' 'A' 'A'
 'U' 'U' 'U' 'M' 'A' 'U' 'U' 'U' 'A' 'A' 'U' 'U' 'M' 'A' 'M' 'U' 'U' 'M'
 'U' 'A' 'U' 'M' 'U' 'U' 'M' 'U' 'A' 'M' 'A' 'A' 'M' 'U' 'M' 'M' 'M' 'U'
 'M' 'A' 'U' 'U' 'M' 'U' 'A' 'M' 'A' 'M' 'U' 'M' 'M' 'M' 'M' 'M' 'M' 'M'
 'M' 'M' 'U' 'U' 'U' 'U' 'U' 'M' 'A' 'M' 'U' 'U' 'A' 'U' 'U' 'M' 'U' 'M'
 'U' 'A' 'A' 'A' 'A' 'U' 'M' 'M' 'U' 'U' 'U' 'A' 'A' 'M' 'A' 'U' 'U' 'A'
 'M' 'U' 'M' 'A' 'U' 'U' 'M' 'M' 'U' 'U' 'M' 'U' 'M' 'A' 'M' 'U' 'M' 'M'
 'M' 'U' 'M' 'U' 'M' 'U' 'A' 'A' 'A' 'A' 'A' 'A' 'A' 'U' 'U' 'U' 'A' 'M'
 'M' 'M' 'A' 'M' 'U' 'M' 'A' 'A' 'A' 'A' 'M' 'U' 'U' 'A' 'U' 'U' 'M' 'A'
 'M' 'U' 'U' 'U' 'U' 'M' 'M' 'U' 'A' 'U' 'U' 'M' 'M' 'U' 'M' 'U' 'A' 'A'
 'U' 'A' 'U' 'U' 'M' 'U' 'M' 'U' 'A' 'M' 'U' 'A' 'A' 'U' 'M' 'A' 'M' 'U']"
27201,1,128,60,68,70,0,0,"['A' 'M' 'M' 'U' 'U' 'A' 'U' 'M' 'A' 'U' 'U' 'U' 'A' 'M' 'U' 'M' 'A' 'A'
 'M' 'U' 'U' 'M' 'A' 'U' 'U' 'U' 'A' 'U' 'M' 'U' 'M' 'A' 'M' 'U' 'U' 'M'
 'U' 'A' 'U' 'M' 'U' 'A' 'M' 'M' 'U' 'U' 'U' 'A' 'M' 'U' 'M' 'M' 'M' 'U'
 'U' 'A' 'A' 'U' 'U' 'U' 'A' 'M' 'A' 'M' 'U' 'M' 'M' 'M' 'M' 'M' 'U' 'M'
 'M' 'M' 'M' 'M' 'A' 'A' 'U' 'U' 'A' 'M' 'A' 'U' 'M' 'U' 'A' 'M' 'A' 'M'
 'A' 'A' 'A' 'A' 'A' 'U' 'U' 'M' 'U' 'U' 'A' 'A' 'A' 'M' 'U' 'U' 'U' 'A'
 'M' 'U' 'M' 'A' 'U' 'U' 'M' 'M' 'U' 'U' 'M' 'U' 'M' 'A' 'M' 'A' 'U' 'M'
 'M' 'M' 'M' 'U' 'M' 'A' 'A' 'A' 'A' 'A' 'A' 'A' 'A' 'M' 'U' 'U' 'A' 'M'
 'A' 'M' 'A' 'M' 'U' 'M' 'U' 'A' 'A' 'A' 'M' 'U' 'M' 'A' 'M' 'U' 'M' 'A'
 'M' 'U' 'U' 'U' 'M' 'M' 'A' 'U' 'A' 'A' 'U' 'M' 'U' 'U' 'U' 'A' 'A' 'U'
 'U' 'A' 'U' 'A' 'M' 'U' 'M' 'M' 'A' 'M' 'U' 'A' 'U' 'M' 'M' 'A' 'M' 'U']"
27301,0,120,51,69,78,0,0,"['A' 'M' 'M' 'U' 'U' 'A' 'U' 'U' 'A' 'U' 'U' 'U' 'A' 'M' 'U' 'M' 'M' 'U'
 'M' 'U' 'U' 'U' 'A' 'U' 'U' 'U' 'U' 'U' 'U' 'M' 'M' 'A' 'U' 'U' 'U' 'M'
 'U' 'A' 'U' 'M' 'A' 'A' 'M' 'M' 'U' 'U' 'M' 'A' 'M' 'U' 'M' 'M' 'M' 'U'
 'U' 'A' 'A' 'M' 'A' 'U' 'A' 'M' 'A' 'U' 'U' 'M' 'M' 'U' 'M' 'M' 'M' 'M'
 'M' 'M' 'M' 'M' 'A' 'A' 'U' 'U' 'U' 'M' 'A' 'U' 'U' 'U' 'A' 'M' 'A' 'M'
 'U' 'A' 'U' 'A' 'A' 'U' 'U' 'M' 'U' 'M' 'A' 'U' 'A' 'M' 'A' 'M' 'U' 'U'
 'M' 'M' 'U' 'U' 'U' 'U' 'M' 'M' 'U' 'U' 'M' 'U' 'M' 'A' 'M' 'U' 'U' 'A'
 'M' 'M' 'M' 'M' 'M' 'A' 'A' 'A' 'A' 'A' 'A' 'U' 'U' 'U' 'M' 'M' 'A' 'M'
 'A' 'M' 'A' 'M' 'U' 'M' 'U' 'A' 'A' 'A' 'M' 'U' 'M' 'U' 'U' 'A' 'M' 'A'
 'M' 'U' 'U' 'M' 'M' 'M' 'A' 'U' 'A' 'A' 'U' 'M' 'U' 'U' 'M' 'A' 'A' 'U'
 'U' 'A' 'U' 'A' 'U' 'U' 'M' 'M' 'U' 'M' 'U' 'A' 'U' 'M' 'M' 'A' 'M' 'U']"
27401,0,118,46,72,80,0,1,"['A' 'U' 'U' 'U' 'U' 'U' 'U' 'U' 'M' 'U' 'U' 'A' 'A' 'M' 'U' 'M' 'U' 'U'
 'M' 'U' 'U' 'U' 'U' 'M' 'U' 'U' 'U' 'M' 'A' 'M' 'M' 'U' 'U' 'U' 'U' 'M'
 'U' 'A' 'U' 'M' 'A' 'A' 'M' 'U' 'U' 'M' 'M' 'A' 'M' 'U' 'M' 'M' 'M' 'A'
 'M' 'A' 'A' 'M' 'A' 'U' 'A' 'U' 'A' 'U' 'U' 'M' 'M' 'M' 'M' 'M' 'M' 'M'
 'M' 'U' 'M' 'M' 'A' 'A' 'U' 'U' 'A' 'M' 'A' 'U' 'U' 'U' 'A' 'M' 'A' 'M'
 'U' 'A' 'U' 'A' 'A' 'U' 'M' 'M' 'U' 'M' 'A' 'U' 'A' 'M' 'A' 'M' 'U' 'U'
 'M' 'M' 'U' 'M' 'U' 'M' 'M' 'M' 'U' 'U' 'M' 'U' 'U' 'A' 'M' 'U' 'M' 'A'
 'M' 'A' 'M' 'M' 'M' 'A' 'A' 'U' 'U' 'A' 'U' 'M' 'U' 'U' 'M' 'M' 'U' 'M'
 'U' 'M' 'U' 'M' 'U' 'M' 'U' 'A' 'A' 'A' 'M' 'U' 'U' 'M' 'U' 'U' 'M' 'U'
 'M' 'U' 'U' 'M' 'U' 'M' 'A' 'A' 'A' 'A' 'A' 'M' 'U' 'M' 'M' 'A' 'A' 'U'
 'M' 'A' 'U' 'A' 'U' 'U' 'U' 'M' 'U' 'M' 'U' 'A' 'U' 'M' 'M' 'A' 'M' 'U']"
27501,1,125,50,75,73,0,0,"['A' 'U' 'M' 'U' 'U' 'U' 'A' 'U' 'M' 'U' 'U' 'A' 'A' 'M' 'U' 'M' 'U' 'M'
 'M' 'U' 'M' 'U' 'A' 'M' 'U' 'U' 'U' 'M' 'A' 'U' 'U' 'U' 'M' 'U' 'U' 'M'
 'U' 'U' 'U' 'U' 'A' 'A' 'M' 'A' 'U' 'M' 'M' 'A' 'M' 'U' 'M' 'M' 'M' 'A'
 'M' 'A' 'U' 'M' 'A' 'M' 'A' 'U' 'A' 'U' 'U' 'M' 'M' 'M' 'M' 'M' 'M' 'M'
 'U' 'M' 'M' 'M' 'A' 'A' 'U' 'U' 'A' 'M' 'A' 'U' 'U' 'M' 'A' 'M' 'A' 'M'
 'M' 'A' 'U' 'A' 'A' 'M' 'M' 'M' 'U' 'M' 'A' 'U' 'A' 'M' 'U' 'M' 'U' 'U'
 'M' 'U' 'U' 'A' 'U' 'M' 'M' 'M' 'U' 'U' 'M' 'U' 'U' 'U' 'U' 'M' 'M' 'U'
 'M' 'A' 'M' 'M' 'U' 'A' 'A' 'A' 'U' 'A' 'A' 'A' 'A' 'U' 'M' 'M' 'U' 'M'
 'U' 'M' 'U' 'M' 'U' 'M' 'M' 'A' 'A' 'A' 'M' 'U' 'A' 'M' 'U' 'M' 'M' 'U'
 'M' 'A' 'U' 'U' 'U' 'M' 'A' 'A' 'A' 'A' 'A' 'M' 'U' 'M' 'M' 'U' 'A' 'U'
 'A' 'M' 'U' 'A' 'U' 'M' 'M' 'M' 'U' 'U' 'U' 'A' 'U' 'M' 'M' 'A' 'M' 'U']"
27601,1,122,50,72,76,0,0,"['A' 'U' 'M' 'U' 'M' 'A' 'A' 'U' 'A' 'U' 'U' 'U' 'A' 'M' 'U' 'M' 'U' 'A'
 'U' 'U' 'M' 'M' 'A' 'M' 'U' 'A' 'U' 'M' 'A' 'M' 'U' 'M' 'M' 'A' 'M' 'M'
 'U' 'A' 'M' 'M' 'A' 'A' 'M' 'A' 'U' 'U' 'M' 'A' 'M' 'U' 'U' 'M' 'M' 'A'
 'M' 'U' 'A' 'M' 'A' 'M' 'U' 'M' 'A' 'U' 'U' 'M' 'U' 'M' 'M' 'M' 'M' 'M'
 'M' 'M' 'M' 'M' 'A' 'U' 'U' 'U' 'A' 'U' 'A' 'M' 'M' 'M' 'A' 'M' 'U' 'M'
 'M' 'U' 'U' 'A' 'U' 'M' 'M' 'U' 'U' 'M' 'A' 'U' 'A' 'M' 'U' 'M' 'M' 'U'
 'U' 'U' 'U' 'A' 'U' 'M' 'M' 'M' 'A' 'U' 'M' 'U' 'U' 'U' 'U' 'M' 'M' 'U'
 'M' 'U' 'M' 'M' 'A' 'A' 'A' 'A' 'A' 'A' 'A' 'U' 'A' 'U' 'M' 'M' 'U' 'U'
 'U' 'M' 'U' 'M' 'M' 'M' 'M' 'U' 'A' 'M' 'U' 'U' 'A' 'M' 'U' 'M' 'M' 'U'
 'U' 'A' 'U' 'U' 'U' 'M' 'A' 'U' 'A' 'A' 'A' 'A' 'U' 'M' 'M' 'U' 'A' 'U'
 'A' 'U' 'U' 'A' 'U' 'M' 'A' 'M' 'A' 'U' 'U' 'A' 'U' 'U' 'M' 'U' 'U' 'U']"
27701,3,129,49,80,69,0,1,"['A' 'M' 'M' 'U' 'M' 'U' 'A' 'U' 'A' 'M' 'U' 'U' 'A' 'U' 'M' 'M' 'U' 'U'
 'U' 'U' 'M' 'U' 'A' 'M' 'U' 'A' 'U' 'M' 'A' 'M' 'A' 'M' 'M' 'A' 'M' 'M'
 'U' 'A' 'M' 'M' 'U' 'A' 'M' 'A' 'M' 'M' 'M' 'A' 'M' 'U' 'U' 'M' 'M' 'A'
 'M' 'M' 'U' 'M' 'A' 'M' 'M' 'A' 'A' 'U' 'U' 'M' 'M' 'U' 'M' 'M' 'M' 'M'
 'M' 'M' 'M' 'M' 'A' 'U' 'M' 'M' 'M' 'U' 'A' 'M' 'U' 'M' 'A' 'M' 'U' 'M'
 'M' 'U' 'M' 'A' 'U' 'M' 'M' 'U' 'U' 'M' 'A' 'U' 'A' 'M' 'U' 'U' 'M' 'U'
 'M' 'M' 'U' 'A' 'U' 'M' 'U' 'U' 'U' 'A' 'M' 'U' 'U' 'U' 'U' 'M' 'M' 'U'
 'U' 'U' 'M' 'M' 'A' 'A' 'A' 'A' 'A' 'U' 'A' 'A' 'A' 'M' 'M' 'M' 'M' 'U'
 'M' 'M' 'U' 'M' 'U' 'M' 'U' 'M' 'A' 'M' 'U' 'M' 'A' 'M' 'U' 'M' 'M' 'U'
 'U' 'A' 'U' 'A' 'U' 'M' 'A' 'U' 'A' 'A' 'U' 'A' 'U' 'M' 'M' 'U' 'U' 'U'
 'A' 'U' 'U' 'A' 'U' 'M' 'A' 'M' 'A' 'A' 'U' 'A' 'U' 'A' 'M' 'U' 'U' 'A']"
27801,3,123,45,78,75,0,0,"['A' 'M' 'M' 'U' 'M' 'A' 'A' 'U' 'A' 'M' 'U' 'U' 'A' 'A' 'M' 'M' 'U' 'M'
 'U' 'M' 'U' 'U' 'A' 'M' 'U' 'U' 'U' 'M' 'A' 'M' 'A' 'M' 'M' 'U' 'M' 'U'
 'A' 'U' 'M' 'M' 'U' 'A' 'M' 'A' 'M' 'U' 'U' 'A' 'M' 'U' 'U' 'M' 'M' 'A'
 'M' 'M' 'M' 'M' 'A' 'M' 'M' 'U' 'A' 'U' 'U' 'M' 'M' 'M' 'M' 'M' 'M' 'U'
 'M' 'M' 'M' 'M' 'U' 'U' 'M' 'A' 'M' 'U' 'A' 'M' 'M' 'A' 'U' 'M' 'U' 'M'
 'M' 'M' 'U' 'A' 'U' 'M' 'M' 'M' 'U' 'M' 'A' 'U' 'A' 'M' 'U' 'U' 'M' 'U'
 'M' 'M' 'U' 'A' 'U' 'M' 'U' 'U' 'M' 'U' 'U' 'U' 'U' 'A' 'U' 'M' 'M' 'M'
 'U' 'U' 'M' 'M' 'U' 'A' 'A' 'A' 'A' 'A' 'A' 'A' 'A' 'M' 'M' 'M' 'M' 'U'
 'U' 'U' 'U' 'M' 'U' 'M' 'U' 'M' 'A' 'M' 'U' 'M' 'A' 'M' 'U' 'M' 'M' 'U'
 'U' 'A' 'U' 'A' 'U' 'U' 'M' 'U' 'A' 'A' 'U' 'U' 'A' 'M' 'M' 'U' 'U' 'U'
 'A' 'U' 'U' 'A' 'U' 'U' 'A' 'M' 'U' 'U' 'U' 'A' 'M' 'A' 'M' 'U' 'U' 'A']"
27901,4,137,50,87,61,1,0,"['A' 'M' 'U' 'M' 'M' 'A' 'A' 'M' 'A' 'M' 'U' 'U' 'A' 'A' 'M' 'M' 'A' 'M'
 'M' 'M' 'A' 'U' 'A' 'M' 'U' 'A' 'U' 'M' 'A' 'M' 'A' 'M' 'M' 'A' 'M' 'U'
 'A' 'U' 'M' 'U' 'U' 'A' 'M' 'A' 'M' 'U' 'M' 'U' 'M' 'M' 'U' 'M' 'M' 'A'
 'M' 'M' 'M' 'M' 'A' 'M' 'U' 'A' 'A' 'A' 'U' 'M' 'M' 'M' 'M' 'M' 'M' 'U'
 'M' 'M' 'M' 'M' 'U' 'U' 'M' 'A' 'M' 'U' 'U' 'M' 'U' 'A' 'U' 'M' 'M' 'M'
 'U' 'M' 'M' 'A' 'U' 'M' 'M' 'M' 'U' 'M' 'A' 'M' 'A' 'M' 'U' 'A' 'M' 'U'
 'M' 'M' 'U' 'A' 'U' 'U' 'U' 'U' 'U' 'U' 'U' 'U' 'M' 'A' 'U' 'M' 'M' 'M'
 'U' 'A' 'M' 'M' 'U' 'A' 'A' 'A' 'A' 'A' 'A' 'A' 'A' 'M' 'A' 'M' 'M' 'U'
 'M' 'U' 'M' 'M' 'U' 'U' 'A' 'M' 'A' 'M' 'M' 'M' 'A' 'M' 'U' 'M' 'M' 'U'
 'U' 'A' 'U' 'A' 'U' 'U' 'U' 'M' 'A' 'A' 'M' 'U' 'A' 'U' 'M' 'M' 'M' 'M'
 'U' 'U' 'U' 'U' 'U' 'M' 'U' 'M' 'M' 'U' 'M' 'A' 'M' 'A' 'M' 'U' 'U' 'A']"
28001,0,124,44,80,74,0,0,"['A' 'M' 'M' 'M' 'M' 'A' 'A' 'U' 'A' 'M' 'U' 'U' 'A' 'A' 'M' 'M' 'A' 'M'
 'M' 'M' 'M' 'M' 'U' 'M' 'U' 'A' 'U' 'M' 'A' 'M' 'A' 'U' 'U' 'A' 'M' 'U'
 'U' 'U' 'U' 'U' 'U' 'A' 'U' 'A' 'M' 'A' 'M' 'U' 'M' 'M' 'U' 'M' 'M' 'A'
 'U' 'M' 'M' 'M' 'A' 'M' 'U' 'M' 'U' 'U' 'U' 'M' 'M' 'M' 'M' 'M' 'M' 'M'
 'U' 'M' 'M' 'M' 'U' 'U' 'U' 'A' 'M' 'M' 'M' 'M' 'U' 'A' 'U' 'M' 'M' 'M'
 'U' 'M' 'M' 'A' 'U' 'U' 'M' 'M' 'U' 'M' 'A' 'M' 'A' 'M' 'U' 'U' 'U' 'U'
 'U' 'M' 'U' 'M' 'U' 'U' 'U' 'U' 'M' 'U' 'U' 'U' 'M' 'A' 'U' 'U' 'A' 'M'
 'U' 'A' 'M' 'M' 'M' 'U' 'A' 'A' 'A' 'A' 'A' 'A' 'A' 'U' 'U' 'M' 'M' 'A'
 'M' 'U' 'U' 'M' 'A' 'U' 'A' 'M' 'A' 'U' 'M' 'U' 'A' 'M' 'A' 'M' 'U' 'U'
 'U' 'A' 'U' 'U' 'U' 'U' 'U' 'M' 'A' 'A' 'M' 'U' 'A' 'U' 'M' 'M' 'M' 'M'
 'M' 'U' 'U' 'U' 'U' 'M' 'U' 'M' 'M' 'U' 'M' 'A' 'M' 'A' 'M' 'U' 'U' 'A']"
28101,0,125,49,76,73,0,0,"['A' 'M' 'M' 'M' 'M' 'U' 'A' 'M' 'A' 'M' 'A' 'U' 'A' 'A' 'M' 'U' 'A' 'M'
 'M' 'M' 'M' 'M' 'A' 'U' 'U' 'A' 'U' 'M' 'U' 'M' 'U' 'A' 'U' 'A' 'M' 'A'
 'M' 'U' 'U' 'U' 'U' 'A' 'A' 'A' 'M' 'A' 'U' 'A' 'M' 'M' 'A' 'M' 'M' 'A'
 'U' 'M' 'M' 'M' 'M' 'M' 'U' 'U' 'A' 'U' 'U' 'M' 'M' 'M' 'M' 'M' 'M' 'M'
 'M' 'M' 'U' 'A' 'M' 'U' 'U' 'A' 'M' 'M' 'M' 'M' 'U' 'A' 'U' 'U' 'M' 'M'
 'M' 'M' 'M' 'A' 'U' 'M' 'M' 'M' 'U' 'M' 'U' 'U' 'A' 'M' 'U' 'U' 'U' 'U'
 'M' 'M' 'U' 'M' 'M' 'U' 'U' 'U' 'U' 'U' 'U' 'U' 'M' 'A' 'U' 'U' 'A' 'M'
 'U' 'A' 'M' 'U' 'M' 'U' 'A' 'U' 'A' 'A' 'U' 'A' 'A' 'U' 'A' 'M' 'M' 'A'
 'M' 'U' 'U' 'M' 'A' 'U' 'A' 'M' 'A' 'U' 'U' 'U' 'A' 'U' 'A' 'M' 'U' 'U'
 'U' 'A' 'U' 'A' 'U' 'U' 'U' 'U' 'A' 'A' 'M' 'U' 'A' 'U' 'U' 'M' 'U' 'U'
 'M' 'U' 'M' 'A' 'M' 'M' 'M' 'M' 'M' 'M' 'U' 'A' 'M' 'A' 'M' 'U' 'U' 'A']"
28201,0,125,49,76,73,0,0,"['A' 'M' 'M' 'M' 'M' 'M' 'A' 'M' 'U' 'M' 'A' 'U' 'A' 'A' 'M' 'U' 'A' 'M'
 'U' 'M' 'M' 'M' 'A' 'U' 'U' 'A' 'U' 'M' 'U' 'M' 'U' 'A' 'U' 'U' 'M' 'A'
 'M' 'U' 'U' 'U' 'A' 'U' 'U' 'A' 'M' 'A' 'U' 'A' 'M' 'M' 'A' 'M' 'M' 'U'
 'U' 'M' 'M' 'M' 'M' 'M' 'A' 'A' 'A' 'U' 'U' 'M' 'M' 'U' 'M' 'M' 'M' 'M'
 'M' 'M' 'M' 'U' 'M' 'M' 'U' 'U' 'U' 'M' 'M' 'M' 'U' 'A' 'U' 'U' 'U' 'M'
 'M' 'U' 'M' 'A' 'U' 'U' 'M' 'M' 'U' 'M' 'A' 'U' 'A' 'M' 'M' 'M' 'U' 'M'
 'M' 'U' 'U' 'M' 'M' 'U' 'U' 'U' 'U' 'U' 'U' 'U' 'M' 'A' 'U' 'U' 'A' 'M'
 'U' 'A' 'M' 'U' 'M' 'A' 'A' 'A' 'A' 'A' 'A' 'A' 'A' 'U' 'A' 'M' 'M' 'U'
 'M' 'M' 'U' 'M' 'A' 'A' 'U' 'M' 'A' 'M' 'U' 'U' 'U' 'A' 'A' 'M' 'U' 'A'
 'M' 'U' 'U' 'A' 'U' 'U' 'U' 'U' 'A' 'A' 'M' 'M' 'U' 'U' 'U' 'M' 'U' 'M'
 'M' 'A' 'M' 'A' 'M' 'A' 'U' 'U' 'M' 'U' 'U' 'A' 'M' 'A' 'U' 'U' 'M' 'A']"
28301,1,125,51,74,73,0,0,"['A' 'M' 'M' 'M' 'U' 'M' 'A' 'M' 'U' 'M' 'A' 'U' 'A' 'A' 'M' 'U' 'A' 'M'
 'U' 'M' 'M' 'M' 'A' 'U' 'U' 'A' 'M' 'U' 'U' 'U' 'U' 'A' 'U' 'U' 'M' 'A'
 'M' 'U' 'U' 'U' 'A' 'A' 'U' 'A' 'M' 'A' 'U' 'A' 'M' 'M' 'A' 'M' 'M' 'U'
 'U' 'M' 'M' 'M' 'M' 'M' 'A' 'A' 'U' 'U' 'U' 'M' 'M' 'U' 'M' 'M' 'M' 'M'
 'M' 'M' 'M' 'A' 'M' 'M' 'U' 'A' 'U' 'U' 'U' 'U' 'U' 'U' 'U' 'U' 'A' 'M'
 'M' 'U' 'M' 'A' 'A' 'U' 'M' 'U' 'U' 'M' 'A' 'M' 'A' 'M' 'M' 'M' 'A' 'M'
 'M' 'U' 'U' 'M' 'M' 'U' 'U' 'A' 'U' 'A' 'U' 'U' 'M' 'A' 'U' 'M' 'A' 'U'
 'U' 'A' 'M' 'M' 'U' 'A' 'A' 'A' 'A' 'A' 'A' 'A' 'A' 'M' 'A' 'M' 'U' 'U'
 'M' 'M' 'U' 'U' 'A' 'M' 'U' 'M' 'A' 'M' 'U' 'M' 'M' 'A' 'A' 'A' 'U' 'U'
 'M' 'U' 'M' 'A' 'M' 'U' 'U' 'U' 'A' 'U' 'M' 'M' 'M' 'U' 'U' 'M' 'M' 'M'
 'U' 'A' 'U' 'U' 'M' 'A' 'A' 'U' 'M' 'U' 'U' 'A' 'M' 'U' 'U' 'U' 'M' 'U']"
28401,3,137,57,80,61,0,0,"['A' 'M' 'M' 'U' 'A' 'M' 'A' 'M' 'M' 'M' 'A' 'M' 'A' 'A' 'M' 'U' 'A' 'U'
 'U' 'M' 'M' 'M' 'U' 'U' 'U' 'A' 'M' 'M' 'A' 'U' 'M' 'A' 'U' 'A' 'M' 'A'
 'M' 'U' 'A' 'A' 'A' 'A' 'M' 'U' 'M' 'A' 'U' 'A' 'U' 'M' 'A' 'M' 'M' 'U'
 'U' 'M' 'M' 'M' 'M' 'M' 'U' 'A' 'U' 'U' 'A' 'U' 'M' 'M' 'M' 'M' 'M' 'M'
 'M' 'M' 'M' 'A' 'M' 'U' 'M' 'U' 'U' 'U' 'U' 'U' 'U' 'U' 'U' 'U' 'A' 'M'
 'M' 'U' 'M' 'A' 'A' 'A' 'M' 'U' 'U' 'M' 'A' 'M' 'A' 'M' 'M' 'M' 'A' 'M'
 'M' 'A' 'U' 'M' 'M' 'M' 'M' 'A' 'U' 'U' 'U' 'U' 'M' 'A' 'U' 'M' 'A' 'M'
 'U' 'A' 'M' 'M' 'A' 'A' 'A' 'A' 'A' 'A' 'A' 'A' 'A' 'M' 'A' 'M' 'U' 'U'
 'M' 'M' 'U' 'U' 'A' 'M' 'U' 'U' 'A' 'M' 'U' 'M' 'M' 'U' 'A' 'A' 'U' 'U'
 'M' 'M' 'U' 'A' 'M' 'U' 'U' 'M' 'M' 'U' 'M' 'M' 'M' 'U' 'A' 'U' 'M' 'M'
 'A' 'A' 'A' 'U' 'M' 'A' 'A' 'U' 'M' 'U' 'U' 'A' 'M' 'M' 'U' 'U' 'M' 'A']"
28501,0,127,51,76,71,0,0,"['A' 'M' 'M' 'U' 'A' 'U' 'U' 'M' 'M' 'M' 'M' 'M' 'U' 'A' 'M' 'U' 'A' 'U'
 'U' 'M' 'M' 'M' 'U' 'U' 'U' 'U' 'M' 'M' 'U' 'A' 'M' 'A' 'M' 'A' 'M' 'A'
 'M' 'M' 'U' 'A' 'U' 'A' 'U' 'U' 'M' 'A' 'U' 'A' 'U' 'M' 'A' 'M' 'M' 'M'
 'U' 'M' 'U' 'M' 'M' 'M' 'M' 'A' 'U' 'U' 'A' 'M' 'M' 'M' 'M' 'M' 'M' 'M'
 'M' 'M' 'U' 'A' 'M' 'U' 'M' 'U' 'A' 'U' 'U' 'U' 'U' 'M' 'M' 'M' 'A' 'M'
 'U' 'A' 'M' 'U' 'A' 'A' 'M' 'U' 'U' 'M' 'A' 'M' 'A' 'M' 'M' 'M' 'U' 'U'
 'M' 'U' 'U' 'U' 'U' 'M' 'U' 'A' 'U' 'A' 'U' 'M' 'M' 'A' 'U' 'M' 'A' 'M'
 'U' 'A' 'M' 'U' 'A' 'U' 'A' 'U' 'A' 'A' 'A' 'A' 'A' 'M' 'A' 'M' 'U' 'U'
 'M' 'M' 'U' 'U' 'U' 'M' 'U' 'M' 'A' 'U' 'U' 'M' 'M' 'U' 'A' 'A' 'U' 'U'
 'M' 'M' 'U' 'A' 'U' 'U' 'A' 'U' 'M' 'A' 'M' 'M' 'M' 'A' 'A' 'U' 'M' 'U'
 'U' 'A' 'U' 'U' 'M' 'A' 'A' 'U' 'M' 'A' 'U' 'A' 'U' 'M' 'A' 'U' 'M' 'A']"
28601,3,124,52,72,74,0,1,"['A' 'U' 'M' 'U' 'A' 'M' 'A' 'M' 'M' 'M' 'M' 'M' 'U' 'A' 'M' 'U' 'U' 'U'
 'A' 'M' 'M' 'M' 'A' 'U' 'U' 'U' 'M' 'M' 'A' 'A' 'M' 'A' 'M' 'A' 'M' 'A'
 'U' 'M' 'A' 'A' 'U' 'A' 'U' 'U' 'U' 'U' 'U' 'U' 'U' 'M' 'A' 'M' 'U' 'M'
 'U' 'M' 'A' 'U' 'M' 'M' 'M' 'A' 'U' 'U' 'A' 'M' 'M' 'M' 'U' 'M' 'M' 'M'
 'M' 'M' 'M' 'A' 'M' 'U' 'M' 'U' 'U' 'U' 'U' 'U' 'M' 'U' 'M' 'M' 'A' 'M'
 'U' 'A' 'M' 'A' 'A' 'A' 'M' 'U' 'U' 'U' 'A' 'M' 'A' 'M' 'M' 'M' 'M' 'U'
 'U' 'A' 'M' 'U' 'U' 'M' 'U' 'A' 'U' 'A' 'U' 'M' 'M' 'A' 'U' 'U' 'U' 'U'
 'U' 'A' 'M' 'U' 'A' 'A' 'A' 'A' 'A' 'A' 'A' 'A' 'A' 'M' 'U' 'M' 'A' 'U'
 'M' 'U' 'U' 'U' 'U' 'M' 'U' 'U' 'U' 'M' 'U' 'M' 'U' 'M' 'A' 'A' 'M' 'M'
 'M' 'M' 'M' 'U' 'U' 'A' 'A' 'U' 'M' 'U' 'M' 'M' 'M' 'A' 'U' 'U' 'M' 'U'
 'U' 'A' 'U' 'U' 'M' 'A' 'A' 'U' 'M' 'A' 'U' 'A' 'U' 'M' 'U' 'U' 'M' 'A']"
28701,0,122,48,74,76,0,0,"['A' 'U' 'M' 'U' 'A' 'U' 'A' 'M' 'M' 'M' 'M' 'M' 'U' 'A' 'M' 'U' 'U' 'U'
 'A' 'M' 'M' 'M' 'A' 'U' 'U' 'U' 'U' 'A' 'U' 'A' 'M' 'A' 'M' 'M' 'M' 'A'
 'U' 'M' 'A' 'U' 'U' 'A' 'A' 'U' 'M' 'U' 'M' 'U' 'U' 'M' 'A' 'U' 'U' 'U'
 'U' 'M' 'A' 'U' 'M' 'M' 'M' 'U' 'U' 'U' 'A' 'M' 'M' 'M' 'M' 'M' 'M' 'M'
 'M' 'U' 'M' 'A' 'M' 'M' 'M' 'U' 'U' 'U' 'U' 'U' 'M' 'A' 'U' 'U' 'A' 'M'
 'U' 'A' 'U' 'A' 'U' 'A' 'U' 'U' 'M' 'U' 'U' 'M' 'U' 'M' 'M' 'M' 'M' 'A'
 'U' 'A' 'M' 'U' 'U' 'M' 'U' 'A' 'U' 'U' 'M' 'M' 'M' 'A' 'U' 'A' 'A' 'U'
 'U' 'U' 'M' 'U' 'U' 'A' 'A' 'A' 'A' 'A' 'A' 'A' 'U' 'M' 'U' 'M' 'U' 'U'
 'U' 'M' 'M' 'U' 'U' 'M' 'U' 'A' 'U' 'M' 'U' 'M' 'U' 'M' 'A' 'A' 'M' 'M'
 'U' 'M' 'M' 'A' 'M' 'A' 'M' 'M' 'M' 'M' 'M' 'U' 'U' 'A' 'U' 'U' 'M' 'U'
 'U' 'A' 'U' 'M' 'M' 'A' 'A' 'U' 'M' 'A' 'M' 'A' 'M' 'M' 'A' 'M' 'U' 'A']"
28801,2,127,43,84,71,1,0,"['A' 'M' 'M' 'U' 'A' 'M' 'U' 'M' 'M' 'M' 'M' 'M' 'M' 'A' 'M' 'U' 'U' 'U'
 'A' 'M' 'M' 'M' 'U' 'U' 'M' 'U' 'M' 'A' 'U' 'A' 'M' 'A' 'M' 'M' 'U' 'A'
 'M' 'M' 'U' 'M' 'U' 'U' 'A' 'A' 'M' 'U' 'M' 'U' 'M' 'M' 'A' 'M' 'U' 'U'
 'A' 'M' 'A' 'M' 'M' 'U' 'M' 'A' 'A' 'U' 'U' 'U' 'M' 'M' 'M' 'M' 'M' 'M'
 'M' 'M' 'M' 'A' 'U' 'M' 'U' 'M' 'U' 'U' 'U' 'U' 'M' 'A' 'U' 'M' 'U' 'M'
 'U' 'U' 'M' 'A' 'A' 'U' 'U' 'U' 'M' 'U' 'M' 'M' 'U' 'M' 'M' 'M' 'M' 'U'
 'U' 'A' 'M' 'U' 'A' 'M' 'U' 'A' 'U' 'M' 'M' 'M' 'M' 'A' 'U' 'A' 'A' 'U'
 'U' 'M' 'U' 'M' 'U' 'A' 'A' 'A' 'A' 'A' 'A' 'A' 'A' 'M' 'U' 'M' 'U' 'U'
 'U' 'M' 'U' 'U' 'U' 'M' 'M' 'A' 'U' 'M' 'U' 'M' 'M' 'M' 'A' 'A' 'M' 'M'
 'U' 'U' 'M' 'M' 'M' 'A' 'U' 'M' 'M' 'M' 'U' 'U' 'U' 'A' 'U' 'U' 'M' 'U'
 'U' 'U' 'U' 'M' 'U' 'A' 'A' 'U' 'M' 'A' 'M' 'U' 'M' 'M' 'A' 'M' 'U' 'A']"
28901,2,133,47,86,65,0,0,"['A' 'M' 'M' 'U' 'A' 'M' 'U' 'M' 'M' 'U' 'M' 'M' 'U' 'U' 'M' 'U' 'M' 'U'
 'A' 'A' 'M' 'M' 'U' 'U' 'M' 'U' 'M' 'U' 'U' 'M' 'M' 'A' 'M' 'U' 'U' 'A'
 'M' 'A' 'U' 'M' 'U' 'U' 'A' 'A' 'U' 'U' 'M' 'A' 'M' 'M' 'A' 'M' 'U' 'A'
 'A' 'M' 'A' 'U' 'M' 'U' 'M' 'U' 'A' 'U' 'M' 'M' 'M' 'M' 'U' 'M' 'M' 'M'
 'M' 'M' 'M' 'A' 'U' 'M' 'A' 'M' 'M' 'U' 'U' 'M' 'M' 'A' 'U' 'U' 'U' 'M'
 'M' 'U' 'M' 'A' 'A' 'M' 'U' 'U' 'M' 'M' 'M' 'M' 'U' 'M' 'M' 'M' 'M' 'M'
 'U' 'A' 'M' 'A' 'U' 'U' 'U' 'A' 'U' 'M' 'U' 'M' 'M' 'A' 'U' 'A' 'A' 'U'
 'A' 'U' 'U' 'M' 'U' 'A' 'A' 'A' 'A' 'A' 'A' 'A' 'A' 'M' 'U' 'M' 'U' 'U'
 'U' 'M' 'M' 'U' 'A' 'M' 'U' 'A' 'U' 'M' 'M' 'M' 'M' 'M' 'A' 'A' 'M' 'M'
 'U' 'A' 'M' 'M' 'M' 'U' 'U' 'M' 'M' 'M' 'M' 'U' 'U' 'U' 'U' 'A' 'M' 'M'
 'U' 'M' 'U' 'M' 'U' 'A' 'A' 'U' 'U' 'A' 'M' 'M' 'M' 'M' 'A' 'M' 'A' 'A']"
29001,2,127,48,79,71,1,0,"['A' 'U' 'M' 'U' 'U' 'M' 'U' 'M' 'U' 'U' 'M' 'U' 'U' 'U' 'U' 'A' 'M' 'U'
 'A' 'U' 'M' 'M' 'U' 'U' 'M' 'M' 'M' 'U' 'U' 'M' 'M' 'A' 'M' 'U' 'U' 'M'
 'M' 'A' 'U' 'M' 'M' 'U' 'A' 'U' 'U' 'M' 'M' 'A' 'M' 'M' 'A' 'M' 'U' 'A'
 'A' 'U' 'U' 'U' 'M' 'A' 'M' 'A' 'A' 'U' 'U' 'U' 'M' 'M' 'M' 'M' 'M' 'M'
 'M' 'M' 'M' 'A' 'U' 'M' 'A' 'U' 'M' 'U' 'U' 'M' 'M' 'A' 'M' 'U' 'A' 'M'
 'U' 'U' 'U' 'A' 'A' 'M' 'A' 'U' 'U' 'M' 'M' 'M' 'A' 'M' 'M' 'M' 'M' 'M'
 'U' 'U' 'U' 'U' 'U' 'U' 'U' 'A' 'U' 'A' 'A' 'M' 'M' 'A' 'U' 'A' 'A' 'U'
 'A' 'U' 'U' 'M' 'U' 'A' 'A' 'U' 'A' 'A' 'A' 'U' 'A' 'M' 'U' 'U' 'M' 'U'
 'U' 'M' 'M' 'M' 'U' 'M' 'U' 'A' 'U' 'M' 'M' 'M' 'M' 'M' 'A' 'A' 'M' 'M'
 'A' 'A' 'U' 'M' 'M' 'U' 'U' 'M' 'A' 'M' 'M' 'U' 'A' 'U' 'U' 'A' 'M' 'M'
 'A' 'M' 'A' 'M' 'U' 'U' 'A' 'U' 'A' 'A' 'M' 'M' 'M' 'M' 'M' 'M' 'U' 'A']"
29101,2,122,45,77,76,0,1,"['A' 'U' 'M' 'M' 'A' 'M' 'U' 'M' 'U' 'U' 'M' 'U' 'U' 'A' 'U' 'A' 'M' 'U'
 'A' 'M' 'U' 'U' 'U' 'U' 'M' 'M' 'U' 'U' 'U' 'M' 'M' 'U' 'M' 'U' 'U' 'M'
 'U' 'U' 'M' 'U' 'M' 'M' 'U' 'U' 'U' 'M' 'M' 'A' 'M' 'M' 'A' 'M' 'U' 'A'
 'A' 'M' 'M' 'M' 'M' 'A' 'M' 'U' 'A' 'U' 'A' 'M' 'M' 'M' 'M' 'M' 'M' 'M'
 'M' 'M' 'U' 'A' 'U' 'M' 'A' 'U' 'M' 'U' 'U' 'M' 'M' 'A' 'U' 'U' 'A' 'U'
 'U' 'U' 'U' 'A' 'A' 'M' 'M' 'U' 'U' 'M' 'M' 'U' 'A' 'U' 'M' 'M' 'M' 'M'
 'U' 'U' 'U' 'U' 'U' 'U' 'U' 'A' 'U' 'U' 'M' 'M' 'M' 'A' 'U' 'A' 'A' 'U'
 'A' 'U' 'U' 'M' 'M' 'A' 'A' 'A' 'A' 'A' 'A' 'A' 'A' 'M' 'U' 'M' 'M' 'U'
 'U' 'U' 'M' 'M' 'M' 'A' 'U' 'A' 'U' 'M' 'M' 'M' 'M' 'M' 'A' 'M' 'U' 'U'
 'A' 'A' 'A' 'M' 'U' 'U' 'A' 'M' 'U' 'M' 'M' 'U' 'U' 'U' 'U' 'A' 'M' 'M'
 'U' 'M' 'A' 'M' 'U' 'M' 'A' 'U' 'A' 'A' 'U' 'M' 'M' 'M' 'U' 'M' 'U' 'A']"
29201,2,120,50,70,78,1,0,"['A' 'A' 'U' 'M' 'A' 'M' 'U' 'M' 'U' 'M' 'M' 'A' 'A' 'A' 'U' 'A' 'M' 'U'
 'A' 'U' 'U' 'U' 'U' 'U' 'M' 'M' 'A' 'U' 'U' 'M' 'M' 'U' 'M' 'A' 'U' 'M'
 'U' 'U' 'U' 'A' 'M' 'M' 'U' 'M' 'U' 'M' 'M' 'A' 'M' 'A' 'U' 'M' 'U' 'A'
 'U' 'U' 'M' 'M' 'M' 'U' 'M' 'U' 'U' 'U' 'A' 'M' 'U' 'M' 'M' 'M' 'M' 'M'
 'M' 'M' 'M' 'A' 'U' 'M' 'A' 'U' 'U' 'M' 'U' 'M' 'M' 'A' 'U' 'U' 'A' 'U'
 'U' 'U' 'U' 'A' 'A' 'M' 'U' 'U' 'U' 'U' 'M' 'U' 'A' 'A' 'U' 'M' 'M' 'M'
 'U' 'U' 'U' 'M' 'M' 'A' 'U' 'A' 'U' 'A' 'M' 'U' 'U' 'M' 'U' 'A' 'A' 'U'
 'A' 'U' 'U' 'M' 'U' 'A' 'A' 'A' 'A' 'A' 'A' 'A' 'A' 'M' 'U' 'U' 'M' 'U'
 'U' 'U' 'M' 'M' 'M' 'A' 'M' 'M' 'U' 'M' 'M' 'M' 'M' 'M' 'U' 'U' 'U' 'U'
 'A' 'A' 'A' 'M' 'A' 'A' 'A' 'M' 'U' 'M' 'M' 'U' 'U' 'U' 'M' 'A' 'M' 'A'
 'U' 'U' 'A' 'M' 'U' 'U' 'A' 'M' 'U' 'A' 'U' 'M' 'M' 'M' 'U' 'U' 'M' 'A']"
29301,1,114,52,62,84,0,0,"['A' 'A' 'U' 'M' 'A' 'M' 'U' 'U' 'U' 'M' 'M' 'A' 'A' 'U' 'U' 'A' 'M' 'M'
 'A' 'M' 'A' 'U' 'U' 'U' 'M' 'U' 'U' 'U' 'U' 'M' 'M' 'U' 'M' 'A' 'U' 'U'
 'U' 'U' 'M' 'A' 'M' 'U' 'A' 'M' 'A' 'M' 'M' 'A' 'M' 'U' 'U' 'M' 'A' 'A'
 'U' 'U' 'U' 'U' 'M' 'U' 'M' 'U' 'M' 'U' 'U' 'M' 'M' 'M' 'M' 'U' 'M' 'M'
 'M' 'M' 'M' 'U' 'U' 'M' 'A' 'A' 'U' 'M' 'U' 'M' 'M' 'A' 'U' 'U' 'U' 'U'
 'A' 'U' 'U' 'A' 'U' 'U' 'A' 'U' 'U' 'U' 'U' 'U' 'A' 'U' 'U' 'M' 'M' 'M'
 'U' 'U' 'U' 'U' 'A' 'A' 'U' 'A' 'U' 'A' 'U' 'U' 'U' 'M' 'U' 'A' 'A' 'U'
 'A' 'U' 'U' 'M' 'M' 'A' 'U' 'A' 'A' 'A' 'A' 'A' 'A' 'M' 'U' 'M' 'U' 'U'
 'U' 'U' 'M' 'M' 'M' 'A' 'M' 'M' 'M' 'M' 'U' 'U' 'A' 'M' 'U' 'A' 'M' 'M'
 'A' 'A' 'A' 'M' 'A' 'A' 'A' 'M' 'U' 'M' 'M' 'U' 'U' 'U' 'U' 'A' 'M' 'A'
 'A' 'U' 'A' 'M' 'U' 'M' 'A' 'U' 'U' 'A' 'U' 'U' 'M' 'M' 'U' 'M' 'U' 'A']"
29401,0,122,50,72,76,0,1,"['A' 'M' 'M' 'M' 'A' 'M' 'A' 'M' 'U' 'M' 'M' 'A' 'A' 'A' 'U' 'U' 'M' 'M'
 'A' 'M' 'U' 'U' 'U' 'U' 'M' 'U' 'U' 'M' 'U' 'M' 'M' 'U' 'M' 'A' 'U' 'U'
 'U' 'U' 'U' 'A' 'M' 'U' 'A' 'M' 'U' 'M' 'M' 'A' 'M' 'U' 'U' 'M' 'A' 'A'
 'M' 'U' 'U' 'A' 'M' 'U' 'U' 'U' 'M' 'U' 'U' 'M' 'M' 'M' 'U' 'M' 'M' 'M'
 'M' 'M' 'M' 'U' 'A' 'M' 'A' 'M' 'U' 'M' 'U' 'M' 'M' 'A' 'U' 'A' 'U' 'M'
 'A' 'M' 'U' 'A' 'U' 'A' 'A' 'U' 'U' 'U' 'U' 'A' 'A' 'U' 'U' 'M' 'M' 'M'
 'A' 'M' 'M' 'U' 'A' 'A' 'U' 'A' 'M' 'A' 'A' 'U' 'U' 'M' 'U' 'A' 'A' 'U'
 'A' 'U' 'U' 'M' 'M' 'U' 'A' 'A' 'A' 'A' 'U' 'A' 'A' 'U' 'U' 'M' 'U' 'M'
 'U' 'U' 'M' 'M' 'M' 'U' 'M' 'M' 'U' 'M' 'U' 'M' 'A' 'U' 'A' 'U' 'U' 'M'
 'U' 'U' 'A' 'U' 'A' 'A' 'A' 'M' 'U' 'M' 'M' 'U' 'M' 'A' 'U' 'A' 'M' 'M'
 'M' 'U' 'U' 'M' 'A' 'M' 'U' 'U' 'U' 'A' 'U' 'M' 'M' 'M' 'A' 'M' 'U' 'U']"
29501,1,124,56,68,74,0,0,"['A' 'U' 'M' 'M' 'A' 'U' 'A' 'U' 'U' 'M' 'M' 'A' 'A' 'U' 'A' 'U' 'U' 'M'
 'A' 'M' 'U' 'M' 'U' 'M' 'M' 'M' 'M' 'M' 'U' 'M' 'M' 'U' 'M' 'U' 'A' 'U'
 'A' 'U' 'M' 'A' 'M' 'U' 'A' 'M' 'M' 'M' 'M' 'A' 'U' 'U' 'U' 'M' 'U' 'A'
 'M' 'A' 'U' 'A' 'M' 'U' 'U' 'U' 'M' 'U' 'U' 'M' 'M' 'M' 'M' 'U' 'M' 'M'
 'M' 'M' 'M' 'U' 'A' 'U' 'A' 'M' 'U' 'M' 'M' 'U' 'M' 'A' 'U' 'A' 'U' 'U'
 'U' 'M' 'U' 'A' 'U' 'A' 'A' 'A' 'U' 'U' 'U' 'U' 'A' 'U' 'U' 'U' 'M' 'M'
 'A' 'M' 'M' 'U' 'U' 'A' 'U' 'A' 'M' 'A' 'A' 'U' 'U' 'M' 'U' 'A' 'A' 'U'
 'A' 'A' 'A' 'U' 'M' 'A' 'A' 'A' 'A' 'A' 'A' 'A' 'A' 'A' 'U' 'M' 'U' 'U'
 'U' 'A' 'M' 'M' 'M' 'U' 'U' 'M' 'M' 'U' 'U' 'M' 'A' 'M' 'A' 'A' 'A' 'M'
 'U' 'U' 'A' 'U' 'U' 'A' 'U' 'M' 'A' 'M' 'A' 'U' 'M' 'A' 'A' 'A' 'M' 'M'
 'M' 'U' 'U' 'M' 'A' 'M' 'U' 'M' 'U' 'U' 'U' 'M' 'M' 'M' 'U' 'M' 'U' 'U']"
29601,0,120,57,63,78,0,1,"['A' 'U' 'M' 'M' 'A' 'U' 'A' 'M' 'U' 'M' 'M' 'A' 'A' 'U' 'A' 'A' 'U' 'U'
 'A' 'M' 'U' 'M' 'A' 'M' 'M' 'M' 'M' 'M' 'A' 'M' 'M' 'M' 'U' 'U' 'U' 'A'
 'A' 'U' 'M' 'A' 'M' 'M' 'A' 'M' 'M' 'U' 'U' 'A' 'U' 'U' 'U' 'M' 'U' 'U'
 'M' 'A' 'U' 'A' 'M' 'U' 'U' 'U' 'M' 'U' 'U' 'U' 'M' 'M' 'M' 'M' 'M' 'M'
 'M' 'M' 'M' 'U' 'A' 'U' 'A' 'M' 'A' 'U' 'M' 'U' 'M' 'M' 'U' 'A' 'U' 'U'
 'U' 'M' 'U' 'A' 'U' 'A' 'A' 'A' 'A' 'U' 'M' 'A' 'U' 'U' 'U' 'M' 'M' 'M'
 'A' 'M' 'M' 'U' 'U' 'A' 'U' 'U' 'U' 'U' 'A' 'U' 'A' 'U' 'A' 'A' 'A' 'U'
 'U' 'A' 'A' 'U' 'M' 'A' 'A' 'A' 'A' 'A' 'A' 'A' 'A' 'U' 'U' 'U' 'M' 'U'
 'M' 'A' 'U' 'M' 'M' 'U' 'U' 'M' 'M' 'U' 'U' 'M' 'A' 'U' 'A' 'A' 'A' 'M'
 'A' 'U' 'U' 'A' 'U' 'A' 'U' 'M' 'A' 'M' 'A' 'U' 'M' 'A' 'U' 'A' 'U' 'M'
 'U' 'U' 'U' 'M' 'A' 'M' 'U' 'M' 'U' 'U' 'U' 'M' 'M' 'M' 'U' 'U' 'U' 'U']"
29701,2,113,45,68,85,0,0,"['A' 'A' 'M' 'M' 'A' 'A' 'A' 'M' 'M' 'M' 'M' 'A' 'U' 'A' 'U' 'U' 'U' 'U'
 'U' 'M' 'U' 'M' 'A' 'M' 'U' 'M' 'M' 'M' 'A' 'M' 'M' 'M' 'U' 'U' 'U' 'M'
 'U' 'A' 'M' 'A' 'M' 'M' 'A' 'M' 'M' 'U' 'U' 'A' 'U' 'U' 'U' 'U' 'U' 'M'
 'M' 'A' 'A' 'A' 'M' 'U' 'U' 'U' 'U' 'U' 'U' 'M' 'U' 'M' 'M' 'M' 'M' 'M'
 'M' 'M' 'M' 'U' 'A' 'U' 'A' 'M' 'A' 'M' 'M' 'U' 'M' 'M' 'U' 'U' 'M' 'U'
 'U' 'M' 'U' 'U' 'U' 'A' 'A' 'A' 'A' 'U' 'M' 'U' 'U' 'A' 'U' 'M' 'M' 'M'
 'A' 'M' 'U' 'U' 'U' 'A' 'U' 'U' 'U' 'M' 'M' 'U' 'M' 'U' 'A' 'M' 'A' 'U'
 'U' 'A' 'U' 'U' 'M' 'A' 'A' 'U' 'A' 'A' 'A' 'A' 'A' 'U' 'U' 'U' 'M' 'U'
 'U' 'U' 'M' 'U' 'M' 'U' 'U' 'M' 'M' 'U' 'U' 'M' 'U' 'U' 'A' 'U' 'A' 'M'
 'U' 'U' 'A' 'A' 'U' 'A' 'M' 'U' 'A' 'M' 'U' 'U' 'M' 'A' 'U' 'A' 'U' 'M'
 'U' 'U' 'U' 'M' 'A' 'M' 'U' 'U' 'U' 'M' 'U' 'M' 'M' 'M' 'U' 'U' 'U' 'M']"
29801,1,107,46,61,91,0,0,"['A' 'M' 'M' 'U' 'A' 'A' 'U' 'M' 'U' 'M' 'M' 'U' 'U' 'A' 'U' 'M' 'U' 'M'
 'M' 'U' 'U' 'M' 'A' 'M' 'U' 'M' 'U' 'U' 'U' 'M' 'M' 'U' 'A' 'U' 'U' 'M'
 'U' 'U' 'M' 'U' 'M' 'M' 'A' 'U' 'M' 'U' 'U' 'A' 'U' 'U' 'U' 'A' 'A' 'U'
 'M' 'A' 'A' 'A' 'M' 'U' 'U' 'U' 'A' 'A' 'U' 'M' 'U' 'M' 'M' 'M' 'M' 'M'
 'M' 'M' 'M' 'U' 'U' 'U' 'A' 'M' 'A' 'M' 'M' 'A' 'U' 'M' 'U' 'M' 'M' 'U'
 'A' 'M' 'U' 'U' 'U' 'A' 'A' 'U' 'A' 'M' 'U' 'U' 'U' 'A' 'U' 'M' 'M' 'U'
 'A' 'M' 'U' 'U' 'U' 'A' 'U' 'U' 'U' 'M' 'M' 'U' 'M' 'U' 'A' 'U' 'A' 'U'
 'U' 'A' 'U' 'M' 'U' 'A' 'A' 'A' 'U' 'A' 'A' 'A' 'A' 'U' 'U' 'U' 'M' 'U'
 'U' 'U' 'M' 'U' 'U' 'U' 'M' 'M' 'M' 'U' 'U' 'M' 'A' 'U' 'A' 'U' 'U' 'M'
 'U' 'U' 'A' 'U' 'A' 'A' 'U' 'U' 'A' 'M' 'U' 'U' 'M' 'A' 'U' 'U' 'A' 'U'
 'U' 'U' 'U' 'M' 'A' 'M' 'U' 'U' 'A' 'M' 'M' 'M' 'M' 'M' 'A' 'U' 'U' 'M']"
29901,1,113,48,65,85,0,0,"['A' 'M' 'U' 'A' 'A' 'U' 'A' 'M' 'U' 'U' 'U' 'U' 'M' 'A' 'U' 'U' 'M' 'M'
 'M' 'A' 'U' 'M' 'A' 'M' 'U' 'U' 'U' 'M' 'A' 'M' 'M' 'U' 'U' 'U' 'U' 'M'
 'A' 'U' 'U' 'A' 'M' 'M' 'U' 'U' 'M' 'U' 'M' 'U' 'U' 'M' 'A' 'U' 'U' 'U'
 'M' 'U' 'U' 'A' 'M' 'M' 'U' 'U' 'A' 'A' 'U' 'M' 'M' 'M' 'M' 'M' 'U' 'M'
 'M' 'M' 'M' 'U' 'U' 'M' 'A' 'M' 'A' 'M' 'M' 'A' 'U' 'M' 'M' 'M' 'M' 'M'
 'A' 'M' 'U' 'U' 'A' 'A' 'A' 'A' 'A' 'M' 'U' 'U' 'M' 'A' 'M' 'M' 'M' 'U'
 'U' 'U' 'U' 'U' 'U' 'A' 'U' 'U' 'U' 'M' 'M' 'U' 'M' 'U' 'U' 'A' 'U' 'U'
 'U' 'A' 'U' 'M' 'U' 'A' 'A' 'A' 'A' 'A' 'A' 'A' 'A' 'U' 'U' 'U' 'M' 'U'
 'U' 'U' 'U' 'U' 'U' 'U' 'M' 'M' 'U' 'U' 'U' 'M' 'A' 'U' 'A' 'M' 'U' 'M'
 'U' 'U' 'A' 'U' 'A' 'A' 'M' 'U' 'A' 'M' 'U' 'U' 'M' 'A' 'U' 'U' 'U' 'A'
 'A' 'U' 'U' 'M' 'U' 'M' 'M' 'A' 'A' 'M' 'U' 'M' 'M' 'M' 'A' 'A' 'U' 'M']"
30001,3,120,49,71,78,0,0,"['A' 'M' 'A' 'A' 'U' 'U' 'A' 'M' 'U' 'U' 'U' 'A' 'M' 'U' 'U' 'A' 'U' 'M'
 'M' 'A' 'M' 'U' 'A' 'M' 'U' 'U' 'U' 'M' 'A' 'M' 'M' 'M' 'U' 'U' 'U' 'A'
 'A' 'U' 'U' 'A' 'M' 'M' 'M' 'M' 'M' 'U' 'M' 'U' 'U' 'M' 'U' 'U' 'U' 'U'
 'M' 'U' 'U' 'A' 'M' 'M' 'U' 'U' 'U' 'A' 'M' 'M' 'M' 'M' 'M' 'M' 'M' 'M'
 'U' 'M' 'M' 'U' 'U' 'M' 'A' 'M' 'A' 'M' 'M' 'A' 'U' 'M' 'M' 'M' 'M' 'M'
 'U' 'M' 'U' 'U' 'A' 'A' 'U' 'A' 'A' 'M' 'U' 'U' 'U' 'A' 'M' 'M' 'M' 'M'
 'U' 'U' 'U' 'U' 'U' 'M' 'U' 'U' 'M' 'M' 'M' 'U' 'M' 'A' 'U' 'U' 'U' 'U'
 'A' 'A' 'A' 'M' 'U' 'A' 'A' 'A' 'A' 'A' 'A' 'A' 'A' 'A' 'A' 'U' 'M' 'M'
 'A' 'U' 'U' 'U' 'U' 'U' 'M' 'M' 'U' 'U' 'U' 'M' 'U' 'U' 'A' 'M' 'U' 'M'
 'M' 'A' 'A' 'M' 'A' 'A' 'U' 'M' 'A' 'U' 'U' 'A' 'M' 'M' 'U' 'U' 'M' 'A'
 'A' 'M' 'U' 'M' 'U' 'U' 'M' 'A' 'A' 'M' 'U' 'M' 'M' 'U' 'U' 'A' 'U' 'U']"
30101,0,116,43,73,82,1,0,"['A' 'M' 'A' 'M' 'U' 'U' 'A' 'M' 'A' 'U' 'M' 'U' 'M' 'A' 'U' 'A' 'U' 'U'
 'M' 'U' 'M' 'U' 'A' 'M' 'M' 'U' 'U' 'M' 'A' 'M' 'M' 'M' 'U' 'U' 'U' 'U'
 'A' 'M' 'U' 'A' 'M' 'M' 'M' 'U' 'M' 'U' 'U' 'U' 'U' 'M' 'M' 'U' 'U' 'U'
 'M' 'U' 'U' 'U' 'M' 'M' 'M' 'U' 'U' 'A' 'M' 'M' 'M' 'M' 'M' 'U' 'M' 'M'
 'M' 'M' 'M' 'U' 'U' 'M' 'A' 'M' 'A' 'M' 'U' 'A' 'A' 'M' 'M' 'M' 'M' 'M'
 'M' 'U' 'U' 'A' 'A' 'A' 'U' 'A' 'A' 'M' 'U' 'U' 'U' 'A' 'U' 'M' 'A' 'M'
 'U' 'U' 'U' 'U' 'U' 'M' 'M' 'U' 'M' 'M' 'M' 'M' 'M' 'U' 'M' 'U' 'U' 'U'
 'A' 'A' 'A' 'U' 'U' 'U' 'A' 'A' 'A' 'U' 'A' 'A' 'A' 'A' 'A' 'U' 'U' 'M'
 'A' 'M' 'U' 'A' 'U' 'U' 'M' 'U' 'U' 'U' 'U' 'U' 'U' 'U' 'U' 'M' 'A' 'M'
 'M' 'U' 'A' 'M' 'M' 'U' 'U' 'U' 'A' 'U' 'U' 'M' 'M' 'M' 'U' 'U' 'M' 'A'
 'A' 'M' 'U' 'M' 'U' 'U' 'M' 'U' 'A' 'M' 'M' 'M' 'M' 'A' 'U' 'A' 'U' 'U']"
30201,1,121,49,72,77,0,0,"['A' 'M' 'A' 'M' 'A' 'M' 'M' 'M' 'A' 'U' 'M' 'A' 'M' 'A' 'U' 'A' 'U' 'U'
 'U' 'M' 'U' 'U' 'A' 'U' 'M' 'U' 'U' 'M' 'A' 'M' 'M' 'M' 'U' 'U' 'U' 'M'
 'U' 'M' 'A' 'A' 'M' 'M' 'U' 'U' 'M' 'U' 'U' 'M' 'U' 'M' 'M' 'U' 'U' 'U'
 'M' 'U' 'U' 'U' 'M' 'M' 'U' 'U' 'U' 'U' 'M' 'M' 'M' 'U' 'M' 'M' 'M' 'M'
 'M' 'M' 'M' 'U' 'U' 'M' 'U' 'M' 'A' 'M' 'U' 'A' 'A' 'M' 'U' 'M' 'M' 'M'
 'M' 'U' 'A' 'A' 'A' 'A' 'U' 'A' 'A' 'M' 'A' 'U' 'U' 'A' 'M' 'M' 'A' 'U'
 'U' 'U' 'U' 'U' 'U' 'U' 'M' 'A' 'U' 'M' 'U' 'M' 'M' 'U' 'M' 'U' 'U' 'U'
 'A' 'A' 'A' 'U' 'U' 'A' 'A' 'A' 'A' 'A' 'A' 'A' 'A' 'A' 'A' 'M' 'U' 'M'
 'A' 'M' 'U' 'A' 'U' 'M' 'M' 'U' 'A' 'U' 'U' 'U' 'U' 'U' 'U' 'M' 'A' 'M'
 'M' 'A' 'A' 'M' 'M' 'U' 'U' 'A' 'A' 'U' 'U' 'U' 'M' 'M' 'U' 'U' 'M' 'A'
 'A' 'M' 'U' 'U' 'M' 'M' 'M' 'M' 'A' 'M' 'M' 'M' 'M' 'U' 'U' 'A' 'U' 'U']"
30301,1,123,49,74,75,0,0,"['A' 'U' 'A' 'M' 'A' 'M' 'M' 'M' 'A' 'M' 'M' 'A' 'U' 'A' 'U' 'A' 'U' 'U'
 'U' 'M' 'M' 'U' 'U' 'U' 'U' 'A' 'U' 'M' 'U' 'U' 'M' 'M' 'U' 'U' 'U' 'M'
 'U' 'M' 'A' 'A' 'M' 'M' 'U' 'M' 'M' 'M' 'U' 'M' 'U' 'M' 'M' 'U' 'U' 'U'
 'U' 'M' 'A' 'U' 'U' 'M' 'U' 'M' 'U' 'U' 'U' 'M' 'M' 'M' 'M' 'M' 'M' 'M'
 'U' 'M' 'M' 'A' 'U' 'M' 'U' 'M' 'A' 'M' 'A' 'A' 'A' 'M' 'M' 'M' 'U' 'M'
 'M' 'U' 'A' 'A' 'A' 'A' 'U' 'A' 'U' 'M' 'A' 'U' 'A' 'A' 'M' 'M' 'A' 'M'
 'U' 'M' 'U' 'U' 'M' 'U' 'M' 'A' 'A' 'M' 'U' 'M' 'M' 'U' 'M' 'U' 'U' 'M'
 'A' 'U' 'U' 'U' 'U' 'A' 'A' 'A' 'A' 'A' 'A' 'A' 'A' 'U' 'A' 'M' 'A' 'M'
 'A' 'M' 'U' 'M' 'U' 'U' 'M' 'U' 'A' 'U' 'M' 'U' 'U' 'M' 'U' 'M' 'U' 'M'
 'M' 'U' 'A' 'M' 'M' 'U' 'U' 'A' 'A' 'U' 'A' 'A' 'M' 'M' 'U' 'A' 'U' 'A'
 'U' 'U' 'U' 'U' 'M' 'M' 'M' 'U' 'A' 'M' 'M' 'U' 'M' 'U' 'M' 'A' 'U' 'U']"
30401,2,119,51,68,79,1,0,"['A' 'U' 'A' 'M' 'A' 'U' 'M' 'M' 'A' 'M' 'U' 'A' 'U' 'A' 'U' 'A' 'U' 'A'
 'U' 'M' 'U' 'U' 'U' 'M' 'U' 'A' 'U' 'U' 'A' 'A' 'M' 'M' 'U' 'U' 'M' 'U'
 'U' 'M' 'A' 'A' 'M' 'M' 'U' 'M' 'M' 'M' 'U' 'M' 'A' 'M' 'M' 'U' 'U' 'M'
 'U' 'M' 'A' 'U' 'A' 'M' 'M' 'M' 'U' 'M' 'U' 'M' 'M' 'U' 'M' 'M' 'M' 'M'
 'M' 'M' 'M' 'A' 'U' 'M' 'U' 'U' 'U' 'U' 'A' 'A' 'A' 'M' 'M' 'M' 'U' 'M'
 'U' 'U' 'A' 'A' 'A' 'A' 'A' 'U' 'U' 'M' 'A' 'U' 'U' 'U' 'M' 'M' 'U' 'M'
 'U' 'M' 'U' 'U' 'U' 'U' 'M' 'A' 'U' 'M' 'M' 'M' 'M' 'M' 'M' 'M' 'U' 'U'
 'A' 'U' 'A' 'M' 'U' 'A' 'A' 'A' 'A' 'A' 'A' 'A' 'A' 'U' 'A' 'M' 'U' 'M'
 'A' 'M' 'U' 'M' 'U' 'U' 'M' 'U' 'U' 'A' 'A' 'U' 'U' 'U' 'A' 'M' 'U' 'M'
 'M' 'U' 'A' 'M' 'M' 'U' 'U' 'U' 'A' 'A' 'A' 'A' 'U' 'M' 'U' 'A' 'M' 'A'
 'U' 'U' 'U' 'U' 'M' 'M' 'U' 'U' 'U' 'U' 'M' 'U' 'U' 'U' 'M' 'A' 'U' 'A']"
30501,1,119,50,69,79,0,1,"['A' 'M' 'A' 'M' 'A' 'U' 'M' 'M' 'A' 'M' 'M' 'U' 'U' 'U' 'U' 'U' 'U' 'A'
 'U' 'M' 'A' 'U' 'U' 'M' 'U' 'A' 'U' 'M' 'U' 'A' 'U' 'U' 'U' 'U' 'M' 'A'
 'U' 'M' 'A' 'A' 'M' 'U' 'U' 'U' 'M' 'M' 'U' 'M' 'A' 'M' 'M' 'U' 'M' 'U'
 'U' 'M' 'A' 'U' 'A' 'M' 'U' 'M' 'M' 'M' 'A' 'M' 'M' 'M' 'M' 'M' 'M' 'M'
 'U' 'M' 'M' 'U' 'U' 'M' 'A' 'A' 'M' 'A' 'U' 'A' 'A' 'U' 'M' 'M' 'U' 'M'
 'M' 'U' 'U' 'A' 'A' 'A' 'A' 'U' 'U' 'M' 'A' 'U' 'U' 'U' 'M' 'U' 'A' 'M'
 'U' 'M' 'U' 'U' 'U' 'U' 'M' 'A' 'A' 'M' 'M' 'M' 'M' 'U' 'M' 'M' 'A' 'M'
 'U' 'U' 'A' 'M' 'A' 'A' 'U' 'A' 'A' 'A' 'A' 'A' 'A' 'U' 'A' 'M' 'U' 'M'
 'U' 'M' 'U' 'M' 'U' 'U' 'M' 'M' 'U' 'A' 'U' 'M' 'U' 'U' 'A' 'M' 'A' 'A'
 'M' 'U' 'U' 'M' 'M' 'U' 'U' 'U' 'A' 'U' 'A' 'A' 'U' 'M' 'U' 'A' 'U' 'U'
 'U' 'M' 'U' 'M' 'U' 'M' 'M' 'U' 'U' 'U' 'M' 'U' 'U' 'A' 'M' 'A' 'U' 'A']"
30601,3,122,48,74,76,0,0,"['A' 'M' 'A' 'M' 'A' 'A' 'M' 'M' 'A' 'U' 'M' 'U' 'A' 'U' 'U' 'A' 'M' 'U'
 'U' 'M' 'A' 'M' 'U' 'M' 'U' 'A' 'U' 'U' 'M' 'A' 'U' 'M' 'U' 'M' 'M' 'A'
 'U' 'U' 'U' 'M' 'M' 'A' 'A' 'U' 'M' 'M' 'U' 'M' 'A' 'M' 'M' 'U' 'M' 'U'
 'U' 'M' 'A' 'U' 'A' 'M' 'U' 'M' 'M' 'M' 'A' 'M' 'M' 'M' 'M' 'M' 'M' 'M'
 'M' 'U' 'M' 'U' 'M' 'U' 'A' 'M' 'U' 'A' 'M' 'M' 'A' 'U' 'M' 'M' 'U' 'M'
 'M' 'U' 'M' 'U' 'A' 'A' 'U' 'U' 'U' 'A' 'U' 'U' 'U' 'U' 'U' 'U' 'U' 'M'
 'U' 'M' 'U' 'U' 'U' 'M' 'M' 'A' 'A' 'M' 'M' 'M' 'M' 'U' 'U' 'M' 'A' 'M'
 'U' 'U' 'A' 'M' 'A' 'U' 'A' 'A' 'A' 'A' 'A' 'A' 'A' 'A' 'A' 'M' 'U' 'U'
 'U' 'M' 'M' 'U' 'U' 'U' 'M' 'M' 'U' 'A' 'U' 'M' 'M' 'A' 'A' 'M' 'A' 'A'
 'M' 'U' 'U' 'M' 'U' 'U' 'U' 'U' 'A' 'U' 'A' 'A' 'M' 'M' 'U' 'A' 'U' 'U'
 'U' 'U' 'U' 'M' 'U' 'M' 'M' 'U' 'U' 'M' 'M' 'U' 'U' 'A' 'M' 'M' 'U' 'A']"
30701,0,128,51,77,70,0,1,"['A' 'M' 'A' 'M' 'A' 'A' 'M' 'M' 'M' 'U' 'M' 'M' 'A' 'U' 'U' 'A' 'U' 'U'
 'M' 'M' 'A' 'U' 'U' 'M' 'U' 'A' 'M' 'U' 'M' 'A' 'U' 'M' 'U' 'U' 'M' 'A'
 'U' 'M' 'U' 'M' 'U' 'A' 'A' 'U' 'U' 'M' 'U' 'M' 'M' 'M' 'M' 'U' 'M' 'M'
 'U' 'M' 'A' 'U' 'A' 'A' 'U' 'U' 'M' 'M' 'A' 'M' 'M' 'U' 'M' 'M' 'M' 'M'
 'M' 'M' 'M' 'M' 'M' 'U' 'A' 'M' 'U' 'A' 'M' 'M' 'A' 'A' 'M' 'M' 'U' 'U'
 'M' 'U' 'U' 'U' 'U' 'A' 'U' 'A' 'U' 'A' 'U' 'U' 'U' 'A' 'U' 'A' 'M' 'M'
 'U' 'M' 'U' 'U' 'U' 'U' 'M' 'A' 'A' 'M' 'M' 'M' 'M' 'U' 'M' 'M' 'A' 'M'
 'M' 'A' 'U' 'M' 'A' 'A' 'A' 'A' 'A' 'A' 'A' 'A' 'A' 'A' 'A' 'M' 'U' 'U'
 'U' 'M' 'M' 'U' 'U' 'U' 'M' 'M' 'U' 'U' 'M' 'M' 'M' 'U' 'A' 'M' 'A' 'A'
 'M' 'U' 'U' 'M' 'U' 'U' 'M' 'M' 'A' 'M' 'A' 'M' 'U' 'U' 'A' 'A' 'M' 'A'
 'U' 'U' 'A' 'M' 'U' 'M' 'U' 'U' 'U' 'M' 'U' 'U' 'U' 'A' 'M' 'M' 'U' 'A']"
30801,1,130,46,84,68,1,0,"['A' 'M' 'U' 'M' 'A' 'M' 'M' 'M' 'U' 'A' 'M' 'M' 'A' 'M' 'U' 'A' 'U' 'M'
 'M' 'M' 'A' 'U' 'U' 'M' 'U' 'U' 'A' 'U' 'M' 'A' 'U' 'M' 'M' 'U' 'M' 'A'
 'U' 'M' 'U' 'M' 'U' 'U' 'A' 'U' 'A' 'M' 'U' 'M' 'U' 'U' 'M' 'U' 'M' 'M'
 'M' 'M' 'M' 'M' 'U' 'M' 'U' 'U' 'U' 'M' 'A' 'M' 'M' 'M' 'M' 'M' 'U' 'M'
 'M' 'M' 'M' 'M' 'M' 'U' 'U' 'U' 'U' 'A' 'M' 'M' 'A' 'A' 'U' 'M' 'M' 'M'
 'M' 'U' 'U' 'M' 'U' 'A' 'U' 'A' 'U' 'U' 'U' 'U' 'A' 'A' 'U' 'U' 'M' 'M'
 'U' 'M' 'M' 'M' 'U' 'U' 'M' 'A' 'A' 'U' 'M' 'M' 'M' 'U' 'M' 'M' 'A' 'M'
 'U' 'A' 'A' 'M' 'A' 'A' 'A' 'A' 'A' 'A' 'A' 'A' 'A' 'A' 'A' 'M' 'U' 'A'
 'U' 'M' 'M' 'M' 'A' 'U' 'M' 'M' 'M' 'U' 'U' 'M' 'M' 'U' 'A' 'M' 'A' 'A'
 'M' 'M' 'A' 'U' 'U' 'M' 'M' 'M' 'M' 'M' 'A' 'M' 'U' 'M' 'U' 'A' 'M' 'U'
 'U' 'U' 'A' 'M' 'U' 'U' 'A' 'U' 'U' 'M' 'U' 'A' 'U' 'M' 'M' 'U' 'U' 'U']"
30901,0,128,41,87,70,0,0,"['A' 'M' 'U' 'M' 'A' 'M' 'M' 'M' 'U' 'U' 'M' 'M' 'A' 'A' 'U' 'U' 'U' 'M'
 'M' 'M' 'A' 'M' 'U' 'M' 'U' 'U' 'A' 'U' 'M' 'A' 'U' 'M' 'M' 'U' 'M' 'A'
 'U' 'U' 'U' 'M' 'U' 'U' 'U' 'M' 'U' 'U' 'U' 'M' 'U' 'U' 'M' 'A' 'M' 'U'
 'M' 'M' 'M' 'M' 'U' 'U' 'U' 'M' 'M' 'M' 'A' 'M' 'M' 'M' 'M' 'M' 'M' 'M'
 'U' 'M' 'M' 'M' 'M' 'A' 'U' 'U' 'U' 'A' 'M' 'M' 'A' 'A' 'U' 'M' 'M' 'M'
 'M' 'U' 'M' 'M' 'U' 'A' 'U' 'U' 'U' 'U' 'U' 'U' 'M' 'A' 'M' 'U' 'U' 'M'
 'U' 'M' 'M' 'M' 'U' 'U' 'M' 'A' 'U' 'M' 'M' 'M' 'M' 'A' 'M' 'M' 'A' 'M'
 'U' 'U' 'A' 'M' 'U' 'A' 'A' 'A' 'A' 'A' 'A' 'A' 'A' 'U' 'U' 'U' 'M' 'A'
 'M' 'M' 'M' 'M' 'A' 'A' 'M' 'M' 'M' 'A' 'U' 'M' 'M' 'U' 'A' 'M' 'M' 'A'
 'M' 'U' 'A' 'A' 'U' 'M' 'M' 'M' 'M' 'M' 'A' 'U' 'U' 'M' 'M' 'A' 'U' 'U'
 'U' 'U' 'A' 'M' 'U' 'A' 'A' 'U' 'M' 'M' 'U' 'U' 'U' 'M' 'U' 'U' 'U' 'M']"
31001,2,120,40,80,78,0,0,"['A' 'M' 'U' 'M' 'A' 'M' 'U' 'U' 'M' 'M' 'M' 'M' 'A' 'A' 'U' 'U' 'U' 'M'
 'M' 'M' 'A' 'M' 'U' 'M' 'A' 'U' 'A' 'U' 'U' 'A' 'U' 'M' 'U' 'U' 'M' 'A'
 'U' 'U' 'A' 'M' 'M' 'U' 'M' 'M' 'A' 'M' 'U' 'M' 'U' 'U' 'M' 'U' 'M' 'A'
 'M' 'M' 'M' 'U' 'U' 'U' 'U' 'M' 'M' 'M' 'A' 'M' 'M' 'M' 'M' 'M' 'M' 'M'
 'M' 'U' 'M' 'M' 'M' 'A' 'U' 'M' 'A' 'A' 'U' 'M' 'U' 'A' 'U' 'M' 'U' 'M'
 'M' 'M' 'M' 'M' 'U' 'A' 'U' 'U' 'U' 'U' 'U' 'U' 'M' 'A' 'U' 'U' 'U' 'U'
 'U' 'M' 'M' 'M' 'U' 'U' 'U' 'A' 'U' 'M' 'U' 'M' 'M' 'A' 'U' 'M' 'U' 'M'
 'U' 'U' 'A' 'M' 'U' 'A' 'A' 'A' 'A' 'A' 'A' 'A' 'A' 'U' 'U' 'M' 'M' 'U'
 'U' 'M' 'U' 'U' 'M' 'U' 'M' 'M' 'U' 'U' 'U' 'M' 'U' 'A' 'U' 'M' 'U' 'M'
 'M' 'U' 'U' 'A' 'U' 'M' 'M' 'M' 'U' 'M' 'A' 'A' 'A' 'M' 'M' 'A' 'U' 'U'
 'U' 'U' 'A' 'M' 'M' 'A' 'A' 'A' 'M' 'M' 'U' 'M' 'U' 'M' 'U' 'U' 'U' 'M']"
31101,3,117,40,77,81,1,0,"['A' 'U' 'U' 'A' 'A' 'U' 'U' 'U' 'M' 'M' 'M' 'U' 'A' 'A' 'A' 'U' 'M' 'M'
 'M' 'M' 'A' 'M' 'U' 'M' 'A' 'U' 'A' 'M' 'A' 'A' 'M' 'M' 'U' 'M' 'M' 'A'
 'M' 'U' 'A' 'M' 'M' 'U' 'M' 'M' 'U' 'M' 'U' 'M' 'M' 'U' 'M' 'M' 'M' 'A'
 'U' 'M' 'M' 'U' 'U' 'U' 'U' 'U' 'M' 'M' 'A' 'M' 'M' 'M' 'M' 'U' 'M' 'M'
 'M' 'M' 'M' 'M' 'M' 'U' 'M' 'M' 'U' 'U' 'A' 'M' 'A' 'A' 'U' 'M' 'A' 'M'
 'U' 'U' 'U' 'M' 'U' 'A' 'U' 'A' 'U' 'U' 'U' 'U' 'M' 'A' 'U' 'U' 'U' 'U'
 'U' 'M' 'M' 'M' 'M' 'U' 'U' 'A' 'M' 'U' 'U' 'U' 'U' 'U' 'M' 'M' 'U' 'M'
 'U' 'M' 'A' 'U' 'U' 'A' 'A' 'A' 'A' 'A' 'A' 'A' 'A' 'U' 'U' 'M' 'M' 'U'
 'M' 'U' 'U' 'U' 'M' 'U' 'M' 'M' 'U' 'U' 'U' 'M' 'U' 'U' 'U' 'M' 'U' 'M'
 'M' 'U' 'U' 'A' 'U' 'M' 'M' 'U' 'U' 'M' 'A' 'U' 'A' 'M' 'M' 'A' 'U' 'U'
 'U' 'A' 'A' 'A' 'M' 'A' 'U' 'U' 'M' 'U' 'M' 'M' 'U' 'U' 'M' 'U' 'U' 'M']"
31201,4,122,48,74,76,1,0,"['A' 'M' 'M' 'A' 'A' 'U' 'U' 'U' 'U' 'U' 'M' 'A' 'U' 'U' 'A' 'U' 'M' 'M'
 'M' 'M' 'A' 'M' 'M' 'M' 'A' 'U' 'A' 'M' 'A' 'A' 'M' 'M' 'A' 'M' 'M' 'A'
 'M' 'U' 'A' 'M' 'M' 'U' 'U' 'U' 'U' 'M' 'U' 'U' 'M' 'U' 'M' 'M' 'U' 'U'
 'U' 'M' 'M' 'U' 'A' 'U' 'U' 'U' 'M' 'M' 'A' 'M' 'M' 'M' 'M' 'M' 'M' 'M'
 'M' 'U' 'M' 'M' 'M' 'A' 'M' 'M' 'U' 'A' 'A' 'M' 'A' 'A' 'U' 'M' 'A' 'M'
 'U' 'A' 'U' 'M' 'U' 'U' 'U' 'A' 'U' 'U' 'U' 'U' 'M' 'A' 'U' 'U' 'U' 'M'
 'U' 'A' 'U' 'M' 'M' 'U' 'U' 'U' 'M' 'A' 'U' 'M' 'M' 'U' 'M' 'M' 'U' 'M'
 'U' 'M' 'A' 'A' 'U' 'A' 'U' 'A' 'A' 'A' 'A' 'A' 'A' 'U' 'U' 'M' 'M' 'U'
 'M' 'M' 'U' 'U' 'M' 'A' 'U' 'M' 'M' 'U' 'U' 'U' 'A' 'U' 'M' 'M' 'U' 'M'
 'U' 'U' 'U' 'A' 'A' 'U' 'M' 'U' 'U' 'M' 'A' 'U' 'A' 'M' 'M' 'U' 'U' 'U'
 'A' 'A' 'A' 'A' 'M' 'A' 'A' 'U' 'M' 'U' 'M' 'M' 'U' 'U' 'M' 'U' 'A' 'M']"
31301,0,120,52,68,78,1,0,"['A' 'M' 'U' 'U' 'A' 'U' 'U' 'M' 'U' 'M' 'M' 'A' 'U' 'U' 'A' 'A' 'U' 'M'
 'M' 'M' 'A' 'M' 'M' 'U' 'A' 'A' 'A' 'M' 'A' 'A' 'M' 'M' 'U' 'U' 'M' 'A'
 'M' 'A' 'U' 'M' 'M' 'A' 'U' 'U' 'U' 'M' 'M' 'M' 'M' 'U' 'M' 'M' 'U' 'A'
 'U' 'M' 'M' 'U' 'A' 'A' 'U' 'M' 'M' 'M' 'A' 'M' 'M' 'M' 'M' 'M' 'M' 'U'
 'M' 'M' 'M' 'M' 'M' 'A' 'M' 'M' 'U' 'U' 'A' 'M' 'A' 'A' 'U' 'U' 'A' 'U'
 'U' 'A' 'U' 'U' 'M' 'U' 'U' 'A' 'U' 'U' 'M' 'U' 'M' 'A' 'A' 'U' 'U' 'M'
 'M' 'A' 'U' 'M' 'U' 'U' 'U' 'U' 'U' 'A' 'U' 'M' 'M' 'U' 'M' 'M' 'A' 'U'
 'U' 'U' 'A' 'A' 'A' 'A' 'A' 'A' 'A' 'A' 'A' 'A' 'A' 'U' 'U' 'M' 'M' 'U'
 'M' 'M' 'U' 'U' 'U' 'U' 'U' 'M' 'M' 'U' 'U' 'U' 'A' 'M' 'U' 'U' 'U' 'M'
 'U' 'A' 'M' 'U' 'A' 'U' 'U' 'U' 'A' 'M' 'A' 'U' 'A' 'M' 'M' 'U' 'M' 'U'
 'U' 'A' 'U' 'A' 'M' 'A' 'A' 'U' 'U' 'U' 'M' 'M' 'U' 'U' 'U' 'A' 'U' 'M']"
31401,1,124,53,71,74,0,1,"['A' 'M' 'U' 'U' 'A' 'U' 'U' 'U' 'U' 'U' 'M' 'A' 'U' 'U' 'A' 'U' 'U' 'M'
 'M' 'U' 'A' 'M' 'M' 'U' 'U' 'A' 'A' 'M' 'A' 'A' 'M' 'M' 'U' 'U' 'U' 'U'
 'M' 'A' 'A' 'M' 'M' 'A' 'U' 'M' 'U' 'U' 'M' 'M' 'M' 'U' 'M' 'U' 'A' 'A'
 'M' 'M' 'M' 'U' 'A' 'A' 'A' 'M' 'M' 'M' 'A' 'M' 'M' 'U' 'M' 'M' 'M' 'M'
 'M' 'M' 'M' 'M' 'M' 'A' 'U' 'M' 'U' 'U' 'A' 'M' 'A' 'A' 'U' 'A' 'A' 'U'
 'M' 'A' 'M' 'U' 'M' 'U' 'U' 'A' 'U' 'U' 'M' 'U' 'M' 'A' 'U' 'U' 'U' 'U'
 'M' 'A' 'U' 'M' 'M' 'U' 'U' 'U' 'U' 'A' 'M' 'M' 'M' 'U' 'M' 'M' 'A' 'A'
 'U' 'U' 'U' 'U' 'A' 'A' 'A' 'A' 'U' 'U' 'A' 'A' 'A' 'U' 'A' 'M' 'M' 'U'
 'M' 'M' 'U' 'U' 'M' 'U' 'A' 'M' 'U' 'U' 'U' 'M' 'U' 'M' 'U' 'A' 'U' 'M'
 'M' 'A' 'M' 'A' 'A' 'U' 'M' 'U' 'A' 'M' 'A' 'U' 'A' 'M' 'M' 'A' 'M' 'U'
 'U' 'A' 'U' 'A' 'M' 'A' 'A' 'M' 'U' 'M' 'M' 'M' 'U' 'U' 'U' 'U' 'A' 'M']"
31501,3,121,60,61,77,0,1,"['A' 'M' 'U' 'U' 'A' 'U' 'U' 'U' 'M' 'U' 'U' 'U' 'U' 'U' 'A' 'A' 'M' 'U'
 'M' 'U' 'A' 'M' 'M' 'U' 'U' 'A' 'A' 'M' 'U' 'U' 'M' 'M' 'U' 'A' 'U' 'A'
 'M' 'A' 'A' 'M' 'U' 'A' 'U' 'U' 'U' 'U' 'U' 'M' 'M' 'U' 'M' 'A' 'M' 'A'
 'M' 'M' 'M' 'U' 'A' 'A' 'U' 'M' 'M' 'U' 'A' 'M' 'M' 'M' 'U' 'M' 'M' 'M'
 'M' 'M' 'M' 'M' 'M' 'A' 'A' 'U' 'U' 'U' 'A' 'M' 'A' 'A' 'U' 'A' 'A' 'U'
 'M' 'A' 'M' 'U' 'M' 'U' 'A' 'A' 'U' 'U' 'U' 'A' 'M' 'A' 'U' 'U' 'U' 'U'
 'M' 'U' 'U' 'M' 'M' 'U' 'A' 'U' 'A' 'A' 'M' 'A' 'U' 'U' 'M' 'M' 'A' 'A'
 'U' 'U' 'U' 'A' 'A' 'A' 'A' 'A' 'A' 'A' 'A' 'A' 'U' 'U' 'A' 'M' 'M' 'U'
 'U' 'M' 'U' 'A' 'M' 'U' 'A' 'A' 'U' 'U' 'U' 'M' 'U' 'U' 'A' 'A' 'A' 'U'
 'M' 'U' 'M' 'A' 'A' 'U' 'M' 'U' 'A' 'M' 'A' 'U' 'U' 'M' 'M' 'A' 'M' 'U'
 'A' 'A' 'U' 'U' 'M' 'A' 'U' 'M' 'M' 'M' 'M' 'U' 'U' 'U' 'U' 'M' 'A' 'M']"
31601,3,122,54,68,76,1,0,"['A' 'M' 'U' 'U' 'A' 'U' 'U' 'U' 'M' 'U' 'U' 'A' 'U' 'U' 'U' 'A' 'M' 'M'
 'M' 'M' 'U' 'M' 'M' 'U' 'U' 'U' 'A' 'M' 'U' 'M' 'M' 'M' 'U' 'A' 'U' 'A'
 'M' 'A' 'A' 'U' 'U' 'M' 'U' 'M' 'U' 'U' 'U' 'M' 'M' 'M' 'M' 'U' 'M' 'U'
 'M' 'M' 'M' 'A' 'A' 'A' 'U' 'U' 'M' 'A' 'U' 'M' 'M' 'M' 'M' 'M' 'U' 'M'
 'M' 'M' 'M' 'M' 'M' 'A' 'A' 'M' 'U' 'U' 'A' 'M' 'A' 'A' 'M' 'A' 'A' 'U'
 'M' 'A' 'M' 'U' 'M' 'U' 'U' 'A' 'U' 'U' 'U' 'A' 'M' 'U' 'U' 'U' 'U' 'U'
 'M' 'U' 'U' 'M' 'M' 'U' 'A' 'U' 'A' 'U' 'M' 'U' 'U' 'U' 'M' 'M' 'U' 'A'
 'M' 'M' 'A' 'A' 'A' 'A' 'A' 'A' 'A' 'A' 'A' 'A' 'A' 'M' 'U' 'M' 'U' 'U'
 'U' 'M' 'A' 'A' 'U' 'U' 'A' 'A' 'U' 'U' 'A' 'M' 'U' 'U' 'A' 'A' 'A' 'U'
 'M' 'A' 'M' 'A' 'A' 'U' 'M' 'U' 'M' 'U' 'A' 'U' 'A' 'M' 'M' 'U' 'M' 'U'
 'U' 'A' 'A' 'U' 'M' 'A' 'U' 'M' 'M' 'M' 'M' 'U' 'U' 'M' 'M' 'U' 'A' 'U']"
31701,1,121,56,65,77,1,0,"['A' 'M' 'M' 'U' 'A' 'U' 'U' 'U' 'M' 'U' 'U' 'A' 'U' 'U' 'U' 'A' 'M' 'M'
 'U' 'M' 'U' 'M' 'M' 'U' 'A' 'U' 'A' 'M' 'A' 'U' 'M' 'U' 'U' 'A' 'U' 'A'
 'U' 'A' 'M' 'U' 'U' 'M' 'A' 'M' 'U' 'U' 'U' 'U' 'A' 'M' 'U' 'M' 'M' 'A'
 'M' 'U' 'U' 'A' 'A' 'A' 'U' 'U' 'M' 'U' 'U' 'U' 'M' 'M' 'M' 'M' 'M' 'M'
 'M' 'M' 'M' 'M' 'M' 'M' 'A' 'M' 'U' 'U' 'A' 'M' 'A' 'A' 'M' 'A' 'A' 'M'
 'U' 'A' 'M' 'M' 'M' 'U' 'U' 'U' 'U' 'U' 'A' 'A' 'M' 'M' 'A' 'U' 'U' 'U'
 'M' 'U' 'U' 'M' 'M' 'M' 'A' 'A' 'A' 'M' 'U' 'U' 'U' 'M' 'U' 'M' 'U' 'A'
 'U' 'U' 'A' 'A' 'A' 'U' 'A' 'A' 'A' 'A' 'A' 'A' 'A' 'U' 'U' 'M' 'U' 'U'
 'U' 'M' 'A' 'U' 'U' 'U' 'U' 'A' 'U' 'U' 'A' 'M' 'U' 'A' 'A' 'A' 'A' 'U'
 'M' 'A' 'M' 'A' 'A' 'A' 'M' 'M' 'M' 'U' 'U' 'M' 'A' 'M' 'M' 'U' 'M' 'U'
 'M' 'A' 'A' 'U' 'M' 'A' 'U' 'M' 'M' 'U' 'U' 'M' 'U' 'M' 'M' 'U' 'A' 'U']"
31801,4,121,58,63,77,1,0,"['A' 'M' 'M' 'U' 'A' 'U' 'U' 'U' 'M' 'U' 'A' 'A' 'M' 'U' 'U' 'A' 'M' 'M'
 'U' 'U' 'U' 'M' 'M' 'A' 'A' 'U' 'A' 'U' 'A' 'U' 'M' 'U' 'U' 'A' 'U' 'A'
 'U' 'A' 'M' 'U' 'U' 'U' 'U' 'M' 'M' 'U' 'U' 'U' 'A' 'M' 'A' 'M' 'M' 'A'
 'U' 'A' 'A' 'A' 'A' 'A' 'U' 'U' 'M' 'A' 'M' 'M' 'U' 'M' 'M' 'M' 'M' 'M'
 'M' 'M' 'M' 'M' 'M' 'M' 'A' 'U' 'U' 'U' 'A' 'M' 'A' 'A' 'M' 'A' 'U' 'M'
 'U' 'A' 'M' 'U' 'A' 'M' 'U' 'U' 'U' 'M' 'A' 'A' 'U' 'M' 'A' 'U' 'U' 'U'
 'M' 'M' 'U' 'M' 'M' 'U' 'A' 'U' 'A' 'M' 'U' 'A' 'U' 'U' 'U' 'M' 'U' 'A'
 'U' 'M' 'A' 'M' 'A' 'A' 'A' 'A' 'A' 'A' 'A' 'A' 'A' 'U' 'U' 'M' 'U' 'U'
 'A' 'U' 'A' 'U' 'U' 'M' 'U' 'U' 'U' 'U' 'U' 'M' 'U' 'U' 'A' 'A' 'A' 'U'
 'M' 'A' 'U' 'U' 'A' 'A' 'M' 'M' 'M' 'U' 'U' 'M' 'A' 'M' 'M' 'U' 'M' 'A'
 'M' 'A' 'M' 'U' 'M' 'A' 'U' 'M' 'U' 'U' 'U' 'M' 'U' 'M' 'M' 'M' 'A' 'U']"
31901,0,132,61,71,66,0,0,"['A' 'M' 'U' 'U' 'A' 'M' 'U' 'U' 'U' 'A' 'A' 'A' 'M' 'U' 'U' 'A' 'M' 'M'
 'M' 'U' 'U' 'M' 'M' 'U' 'A' 'M' 'A' 'M' 'A' 'U' 'M' 'U' 'M' 'A' 'U' 'A'
 'A' 'A' 'M' 'M' 'U' 'U' 'U' 'M' 'M' 'U' 'U' 'U' 'A' 'M' 'A' 'M' 'U' 'A'
 'U' 'A' 'A' 'A' 'A' 'A' 'A' 'A' 'M' 'A' 'M' 'U' 'M' 'M' 'M' 'M' 'M' 'M'
 'M' 'M' 'M' 'U' 'M' 'M' 'A' 'M' 'U' 'U' 'U' 'M' 'A' 'A' 'M' 'U' 'U' 'U'
 'U' 'A' 'M' 'U' 'A' 'M' 'U' 'U' 'U' 'M' 'A' 'A' 'M' 'M' 'A' 'A' 'U' 'M'
 'M' 'M' 'U' 'M' 'M' 'U' 'A' 'U' 'A' 'M' 'M' 'M' 'U' 'U' 'U' 'M' 'A' 'U'
 'A' 'U' 'A' 'M' 'A' 'A' 'A' 'A' 'A' 'A' 'A' 'A' 'A' 'U' 'U' 'M' 'U' 'U'
 'A' 'A' 'A' 'M' 'U' 'M' 'A' 'U' 'U' 'M' 'U' 'M' 'U' 'U' 'U' 'A' 'A' 'M'
 'U' 'A' 'U' 'M' 'A' 'A' 'M' 'M' 'M' 'U' 'U' 'M' 'U' 'M' 'M' 'M' 'M' 'U'
 'M' 'U' 'M' 'A' 'M' 'A' 'U' 'M' 'A' 'U' 'U' 'M' 'U' 'M' 'A' 'U' 'A' 'M']"
32001,2,123,52,71,75,0,0,"['A' 'M' 'A' 'U' 'A' 'M' 'U' 'M' 'M' 'A' 'U' 'A' 'M' 'U' 'U' 'A' 'M' 'M'
 'M' 'U' 'U' 'M' 'M' 'U' 'A' 'U' 'U' 'M' 'A' 'U' 'U' 'M' 'M' 'A' 'U' 'A'
 'A' 'A' 'M' 'M' 'U' 'U' 'U' 'M' 'U' 'U' 'A' 'U' 'A' 'M' 'A' 'M' 'U' 'A'
 'U' 'A' 'U' 'A' 'A' 'U' 'U' 'A' 'M' 'A' 'M' 'M' 'M' 'M' 'M' 'M' 'U' 'M'
 'M' 'M' 'M' 'U' 'M' 'U' 'A' 'U' 'U' 'U' 'U' 'M' 'A' 'A' 'U' 'U' 'U' 'U'
 'U' 'A' 'M' 'U' 'A' 'M' 'U' 'U' 'U' 'M' 'A' 'A' 'M' 'M' 'A' 'A' 'U' 'M'
 'M' 'U' 'U' 'M' 'U' 'M' 'U' 'M' 'U' 'M' 'M' 'M' 'A' 'U' 'U' 'M' 'A' 'U'
 'M' 'U' 'A' 'U' 'U' 'A' 'A' 'A' 'A' 'A' 'A' 'A' 'A' 'U' 'U' 'M' 'U' 'M'
 'A' 'A' 'A' 'U' 'U' 'M' 'U' 'U' 'U' 'M' 'U' 'M' 'U' 'M' 'U' 'M' 'A' 'M'
 'U' 'U' 'A' 'M' 'A' 'A' 'U' 'M' 'U' 'M' 'U' 'M' 'U' 'M' 'M' 'M' 'M' 'M'
 'M' 'U' 'M' 'A' 'M' 'A' 'M' 'M' 'U' 'U' 'U' 'M' 'U' 'M' 'A' 'U' 'A' 'M']"
32101,1,117,43,74,81,1,0,"['A' 'M' 'U' 'M' 'A' 'M' 'U' 'M' 'M' 'A' 'U' 'A' 'U' 'U' 'M' 'A' 'U' 'M'
 'M' 'U' 'U' 'M' 'M' 'U' 'A' 'U' 'U' 'M' 'A' 'U' 'M' 'M' 'M' 'U' 'A' 'A'
 'U' 'A' 'M' 'M' 'U' 'U' 'M' 'M' 'U' 'U' 'A' 'U' 'A' 'M' 'A' 'U' 'U' 'A'
 'U' 'A' 'U' 'M' 'A' 'U' 'U' 'U' 'M' 'A' 'M' 'M' 'M' 'M' 'U' 'M' 'M' 'M'
 'M' 'M' 'M' 'U' 'M' 'U' 'A' 'U' 'U' 'U' 'U' 'M' 'A' 'U' 'U' 'U' 'U' 'U'
 'M' 'A' 'M' 'U' 'A' 'U' 'U' 'U' 'M' 'U' 'A' 'U' 'M' 'U' 'A' 'A' 'U' 'M'
 'M' 'M' 'A' 'U' 'U' 'U' 'U' 'M' 'M' 'M' 'U' 'M' 'A' 'U' 'U' 'M' 'U' 'M'
 'M' 'U' 'A' 'U' 'U' 'U' 'A' 'U' 'A' 'A' 'A' 'A' 'A' 'U' 'U' 'A' 'U' 'M'
 'A' 'U' 'A' 'U' 'U' 'M' 'U' 'M' 'M' 'M' 'U' 'M' 'M' 'M' 'M' 'M' 'A' 'U'
 'U' 'U' 'A' 'M' 'A' 'U' 'U' 'M' 'U' 'M' 'M' 'M' 'U' 'M' 'M' 'M' 'M' 'M'
 'M' 'A' 'M' 'U' 'M' 'U' 'M' 'M' 'U' 'U' 'U' 'M' 'A' 'U' 'A' 'U' 'A' 'M']"
32201,1,117,52,65,81,1,0,"['A' 'M' 'U' 'M' 'U' 'A' 'U' 'M' 'M' 'A' 'U' 'A' 'U' 'U' 'M' 'U' 'U' 'M'
 'M' 'U' 'U' 'U' 'M' 'A' 'U' 'U' 'U' 'M' 'A' 'U' 'M' 'M' 'M' 'A' 'U' 'A'
 'U' 'A' 'M' 'M' 'U' 'U' 'M' 'U' 'M' 'M' 'A' 'U' 'A' 'M' 'A' 'U' 'U' 'A'
 'A' 'A' 'A' 'M' 'A' 'U' 'A' 'U' 'U' 'A' 'M' 'U' 'M' 'M' 'M' 'M' 'M' 'M'
 'M' 'M' 'M' 'A' 'M' 'A' 'A' 'U' 'U' 'U' 'U' 'M' 'U' 'U' 'U' 'U' 'A' 'U'
 'M' 'A' 'U' 'U' 'A' 'A' 'M' 'A' 'M' 'U' 'A' 'U' 'U' 'M' 'U' 'A' 'U' 'M'
 'M' 'M' 'U' 'U' 'U' 'M' 'U' 'M' 'M' 'U' 'A' 'M' 'A' 'U' 'U' 'U' 'A' 'U'
 'M' 'U' 'A' 'U' 'U' 'A' 'A' 'A' 'A' 'A' 'A' 'A' 'A' 'U' 'U' 'A' 'U' 'M'
 'A' 'U' 'A' 'U' 'U' 'M' 'U' 'M' 'M' 'M' 'U' 'M' 'M' 'M' 'U' 'U' 'A' 'U'
 'A' 'U' 'A' 'M' 'U' 'U' 'U' 'M' 'U' 'U' 'M' 'M' 'A' 'M' 'M' 'M' 'M' 'M'
 'M' 'U' 'M' 'U' 'U' 'A' 'U' 'U' 'U' 'M' 'U' 'M' 'A' 'U' 'A' 'U' 'A' 'M']"
32301,2,130,62,68,68,0,1,"['A' 'M' 'U' 'M' 'U' 'U' 'U' 'M' 'M' 'A' 'U' 'A' 'M' 'A' 'M' 'U' 'A' 'U'
 'M' 'U' 'U' 'M' 'M' 'A' 'U' 'U' 'M' 'M' 'A' 'M' 'M' 'M' 'M' 'U' 'U' 'A'
 'A' 'A' 'M' 'M' 'U' 'U' 'M' 'A' 'M' 'M' 'A' 'A' 'A' 'M' 'A' 'A' 'U' 'A'
 'U' 'A' 'A' 'M' 'A' 'A' 'A' 'U' 'U' 'A' 'M' 'M' 'U' 'M' 'M' 'M' 'M' 'M'
 'M' 'M' 'M' 'A' 'M' 'A' 'A' 'U' 'U' 'U' 'A' 'M' 'A' 'U' 'U' 'U' 'U' 'U'
 'U' 'A' 'U' 'U' 'A' 'U' 'U' 'A' 'M' 'U' 'A' 'A' 'U' 'M' 'U' 'A' 'U' 'M'
 'M' 'M' 'M' 'U' 'U' 'U' 'U' 'M' 'M' 'A' 'A' 'M' 'A' 'U' 'U' 'U' 'A' 'M'
 'M' 'A' 'A' 'A' 'M' 'A' 'A' 'A' 'A' 'A' 'A' 'A' 'A' 'U' 'U' 'A' 'U' 'U'
 'A' 'U' 'A' 'U' 'U' 'M' 'U' 'M' 'M' 'M' 'M' 'M' 'M' 'U' 'U' 'M' 'A' 'U'
 'A' 'U' 'A' 'M' 'A' 'U' 'U' 'M' 'U' 'A' 'M' 'M' 'U' 'M' 'M' 'M' 'M' 'M'
 'M' 'U' 'M' 'A' 'U' 'A' 'U' 'M' 'U' 'M' 'A' 'U' 'A' 'U' 'A' 'U' 'U' 'M']"
32401,1,122,68,54,76,0,1,"['A' 'M' 'U' 'M' 'U' 'U' 'M' 'U' 'U' 'A' 'U' 'A' 'U' 'A' 'M' 'U' 'A' 'U'
 'M' 'U' 'U' 'M' 'U' 'A' 'U' 'U' 'M' 'M' 'A' 'M' 'M' 'M' 'U' 'U' 'M' 'A'
 'A' 'A' 'A' 'U' 'U' 'U' 'M' 'A' 'M' 'M' 'A' 'A' 'A' 'M' 'A' 'A' 'M' 'A'
 'U' 'A' 'A' 'M' 'U' 'A' 'A' 'U' 'U' 'A' 'M' 'M' 'U' 'M' 'M' 'M' 'M' 'M'
 'M' 'M' 'M' 'A' 'M' 'A' 'A' 'U' 'U' 'U' 'A' 'M' 'A' 'U' 'U' 'U' 'M' 'U'
 'U' 'A' 'A' 'U' 'A' 'U' 'U' 'A' 'M' 'U' 'A' 'A' 'U' 'M' 'U' 'A' 'A' 'M'
 'M' 'M' 'M' 'U' 'U' 'U' 'A' 'U' 'M' 'A' 'A' 'M' 'A' 'A' 'U' 'M' 'A' 'U'
 'U' 'A' 'A' 'U' 'M' 'U' 'A' 'A' 'A' 'A' 'U' 'A' 'A' 'A' 'U' 'A' 'U' 'U'
 'U' 'M' 'U' 'U' 'U' 'M' 'A' 'A' 'U' 'M' 'M' 'U' 'M' 'U' 'U' 'U' 'A' 'U'
 'A' 'A' 'A' 'M' 'A' 'U' 'U' 'M' 'A' 'A' 'U' 'U' 'U' 'M' 'M' 'U' 'U' 'M'
 'U' 'U' 'U' 'A' 'U' 'A' 'A' 'M' 'U' 'U' 'A' 'U' 'U' 'A' 'A' 'A' 'M' 'M']"
32501,1,131,79,52,67,0,0,"['A' 'M' 'U' 'A' 'U' 'A' 'M' 'U' 'U' 'A' 'A' 'A' 'M' 'U' 'M' 'U' 'A' 'A'
 'M' 'U' 'U' 'M' 'U' 'A' 'U' 'U' 'M' 'U' 'A' 'M' 'A' 'M' 'U' 'U' 'U' 'A'
 'A' 'U' 'A' 'U' 'U' 'U' 'M' 'A' 'M' 'M' 'A' 'U' 'A' 'M' 'A' 'A' 'U' 'A'
 'A' 'A' 'A' 'M' 'A' 'A' 'A' 'A' 'A' 'A' 'M' 'M' 'M' 'M' 'M' 'M' 'M' 'U'
 'M' 'M' 'M' 'U' 'M' 'A' 'A' 'U' 'U' 'U' 'A' 'U' 'A' 'U' 'U' 'A' 'M' 'U'
 'A' 'A' 'A' 'U' 'A' 'U' 'U' 'A' 'M' 'A' 'U' 'A' 'M' 'M' 'U' 'A' 'A' 'M'
 'M' 'M' 'M' 'U' 'A' 'U' 'A' 'U' 'U' 'A' 'U' 'M' 'A' 'A' 'U' 'U' 'A' 'A'
 'U' 'A' 'A' 'U' 'M' 'A' 'A' 'A' 'A' 'A' 'A' 'A' 'A' 'U' 'M' 'A' 'U' 'M'
 'U' 'M' 'A' 'U' 'A' 'M' 'A' 'A' 'U' 'M' 'M' 'U' 'M' 'U' 'U' 'U' 'A' 'U'
 'A' 'A' 'A' 'M' 'U' 'U' 'U' 'M' 'A' 'A' 'U' 'U' 'U' 'M' 'M' 'U' 'U' 'M'
 'A' 'U' 'U' 'A' 'U' 'A' 'A' 'M' 'M' 'U' 'A' 'M' 'U' 'A' 'A' 'A' 'M' 'M']"
32601,1,121,74,47,77,0,1,"['A' 'M' 'U' 'A' 'U' 'A' 'U' 'U' 'U' 'U' 'A' 'U' 'M' 'U' 'M' 'U' 'A' 'A'
 'U' 'A' 'U' 'M' 'A' 'A' 'A' 'U' 'M' 'U' 'A' 'M' 'U' 'M' 'U' 'A' 'A' 'A'
 'A' 'M' 'A' 'U' 'U' 'M' 'U' 'A' 'M' 'M' 'A' 'U' 'U' 'U' 'A' 'A' 'U' 'A'
 'A' 'A' 'A' 'M' 'A' 'A' 'U' 'A' 'A' 'A' 'M' 'U' 'M' 'M' 'M' 'M' 'M' 'M'
 'M' 'M' 'M' 'U' 'U' 'U' 'U' 'U' 'U' 'M' 'A' 'M' 'U' 'U' 'U' 'A' 'U' 'U'
 'A' 'A' 'A' 'U' 'A' 'A' 'A' 'A' 'M' 'A' 'U' 'A' 'M' 'M' 'A' 'A' 'A' 'M'
 'M' 'M' 'M' 'U' 'U' 'A' 'U' 'U' 'U' 'U' 'M' 'M' 'A' 'A' 'U' 'U' 'A' 'U'
 'U' 'U' 'A' 'U' 'U' 'A' 'A' 'A' 'A' 'A' 'A' 'A' 'A' 'U' 'U' 'A' 'U' 'M'
 'U' 'U' 'A' 'A' 'A' 'M' 'A' 'A' 'M' 'M' 'M' 'U' 'M' 'U' 'U' 'U' 'U' 'U'
 'U' 'U' 'A' 'U' 'U' 'U' 'U' 'M' 'A' 'U' 'U' 'U' 'U' 'U' 'M' 'U' 'U' 'M'
 'A' 'U' 'U' 'A' 'A' 'A' 'A' 'M' 'M' 'M' 'A' 'A' 'U' 'A' 'A' 'A' 'M' 'M']"
32701,1,124,78,46,74,1,0,"['A' 'M' 'U' 'A' 'M' 'U' 'A' 'U' 'U' 'U' 'A' 'M' 'U' 'U' 'M' 'M' 'A' 'U'
 'M' 'U' 'A' 'M' 'A' 'A' 'U' 'A' 'M' 'U' 'A' 'M' 'U' 'M' 'U' 'A' 'U' 'A'
 'U' 'M' 'A' 'U' 'U' 'U' 'U' 'A' 'M' 'U' 'A' 'U' 'A' 'U' 'A' 'U' 'U' 'A'
 'A' 'A' 'U' 'U' 'U' 'U' 'U' 'A' 'A' 'A' 'M' 'M' 'M' 'M' 'M' 'U' 'M' 'M'
 'M' 'M' 'M' 'U' 'A' 'U' 'U' 'A' 'A' 'U' 'A' 'M' 'U' 'U' 'A' 'A' 'M' 'U'
 'A' 'A' 'A' 'A' 'A' 'A' 'A' 'A' 'M' 'U' 'A' 'A' 'M' 'M' 'A' 'A' 'A' 'M'
 'U' 'U' 'M' 'U' 'U' 'U' 'U' 'U' 'A' 'A' 'M' 'M' 'A' 'A' 'U' 'U' 'A' 'A'
 'M' 'U' 'U' 'U' 'U' 'A' 'A' 'A' 'A' 'A' 'A' 'A' 'A' 'U' 'M' 'A' 'U' 'U'
 'U' 'U' 'A' 'A' 'A' 'M' 'A' 'A' 'M' 'M' 'U' 'U' 'M' 'U' 'A' 'U' 'U' 'U'
 'U' 'M' 'A' 'U' 'U' 'U' 'M' 'M' 'A' 'U' 'U' 'U' 'U' 'A' 'M' 'A' 'U' 'A'
 'A' 'U' 'U' 'A' 'A' 'A' 'A' 'M' 'M' 'M' 'U' 'A' 'A' 'A' 'A' 'A' 'M' 'M']"
32801,2,129,79,50,69,0,0,"['A' 'M' 'U' 'A' 'M' 'U' 'A' 'U' 'U' 'U' 'A' 'U' 'U' 'U' 'M' 'U' 'A' 'U'
 'M' 'U' 'A' 'A' 'A' 'A' 'A' 'A' 'M' 'U' 'A' 'M' 'U' 'U' 'U' 'A' 'U' 'A'
 'M' 'M' 'A' 'M' 'U' 'U' 'M' 'A' 'M' 'U' 'A' 'M' 'U' 'U' 'A' 'U' 'U' 'A'
 'U' 'U' 'U' 'U' 'U' 'U' 'A' 'A' 'A' 'A' 'U' 'M' 'M' 'M' 'M' 'M' 'M' 'M'
 'M' 'U' 'M' 'M' 'A' 'U' 'U' 'A' 'A' 'U' 'A' 'M' 'M' 'U' 'A' 'A' 'M' 'U'
 'U' 'A' 'A' 'A' 'A' 'U' 'U' 'U' 'M' 'U' 'A' 'A' 'M' 'M' 'A' 'A' 'A' 'M'
 'U' 'U' 'M' 'U' 'U' 'U' 'U' 'U' 'A' 'A' 'M' 'M' 'A' 'A' 'M' 'U' 'A' 'A'
 'M' 'U' 'M' 'U' 'A' 'A' 'U' 'A' 'A' 'A' 'A' 'A' 'A' 'M' 'M' 'A' 'A' 'U'
 'U' 'U' 'A' 'A' 'A' 'M' 'U' 'A' 'U' 'M' 'A' 'M' 'U' 'A' 'A' 'U' 'U' 'U'
 'A' 'M' 'A' 'U' 'U' 'U' 'M' 'M' 'M' 'U' 'U' 'A' 'U' 'A' 'A' 'A' 'A' 'A'
 'M' 'A' 'A' 'A' 'A' 'U' 'A' 'M' 'M' 'U' 'M' 'A' 'A' 'A' 'A' 'A' 'M' 'M']"
32901,1,125,77,48,73,1,0,"['A' 'M' 'A' 'U' 'M' 'U' 'A' 'U' 'M' 'U' 'A' 'M' 'U' 'U' 'M' 'A' 'A' 'M'
 'M' 'U' 'A' 'U' 'U' 'A' 'M' 'A' 'M' 'M' 'A' 'M' 'U' 'A' 'A' 'A' 'U' 'A'
 'M' 'M' 'A' 'M' 'U' 'U' 'M' 'A' 'M' 'U' 'A' 'M' 'A' 'U' 'A' 'A' 'M' 'A'
 'U' 'U' 'U' 'U' 'U' 'U' 'A' 'A' 'A' 'A' 'A' 'M' 'U' 'M' 'M' 'M' 'M' 'M'
 'M' 'M' 'M' 'M' 'A' 'U' 'U' 'U' 'A' 'A' 'A' 'M' 'M' 'U' 'A' 'A' 'M' 'U'
 'U' 'A' 'U' 'A' 'A' 'U' 'U' 'A' 'M' 'U' 'U' 'A' 'U' 'M' 'A' 'U' 'A' 'M'
 'U' 'U' 'M' 'A' 'U' 'U' 'U' 'U' 'U' 'A' 'M' 'A' 'U' 'A' 'M' 'U' 'A' 'A'
 'U' 'U' 'M' 'U' 'U' 'A' 'A' 'A' 'A' 'A' 'A' 'A' 'A' 'M' 'U' 'A' 'A' 'U'
 'U' 'U' 'A' 'A' 'A' 'M' 'U' 'A' 'A' 'U' 'A' 'M' 'A' 'A' 'A' 'M' 'M' 'U'
 'U' 'M' 'A' 'U' 'U' 'U' 'U' 'M' 'U' 'A' 'U' 'A' 'U' 'A' 'A' 'U' 'A' 'U'
 'U' 'U' 'A' 'U' 'A' 'U' 'A' 'M' 'U' 'U' 'M' 'U' 'A' 'U' 'A' 'A' 'M' 'A']"
33001,1,119,77,42,79,0,0,"['A' 'M' 'A' 'A' 'M' 'A' 'A' 'U' 'M' 'U' 'U' 'M' 'U' 'A' 'M' 'A' 'A' 'M'
 'U' 'U' 'A' 'M' 'U' 'A' 'U' 'U' 'U' 'U' 'A' 'U' 'A' 'A' 'A' 'A' 'U' 'U'
 'U' 'M' 'A' 'M' 'U' 'U' 'M' 'A' 'U' 'U' 'A' 'M' 'A' 'U' 'A' 'A' 'M' 'A'
 'U' 'U' 'U' 'U' 'U' 'U' 'U' 'A' 'A' 'A' 'U' 'M' 'M' 'M' 'M' 'M' 'M' 'M'
 'M' 'U' 'M' 'M' 'A' 'U' 'U' 'U' 'A' 'M' 'A' 'M' 'M' 'U' 'A' 'A' 'U' 'A'
 'A' 'A' 'U' 'A' 'A' 'A' 'U' 'A' 'M' 'U' 'M' 'A' 'U' 'U' 'A' 'U' 'A' 'U'
 'U' 'U' 'U' 'A' 'M' 'A' 'A' 'U' 'U' 'A' 'M' 'M' 'U' 'U' 'U' 'U' 'A' 'M'
 'U' 'U' 'M' 'A' 'U' 'A' 'A' 'A' 'A' 'A' 'U' 'A' 'U' 'M' 'U' 'A' 'A' 'U'
 'U' 'U' 'A' 'U' 'U' 'M' 'M' 'A' 'U' 'A' 'A' 'M' 'A' 'A' 'A' 'M' 'U' 'U'
 'U' 'U' 'A' 'U' 'U' 'U' 'U' 'M' 'U' 'A' 'A' 'A' 'U' 'A' 'A' 'U' 'A' 'U'
 'A' 'U' 'A' 'U' 'A' 'M' 'A' 'M' 'U' 'U' 'M' 'U' 'A' 'A' 'A' 'A' 'M' 'A']"
33101,2,119,75,44,79,0,0,"['A' 'U' 'A' 'A' 'M' 'A' 'U' 'M' 'M' 'U' 'U' 'M' 'U' 'M' 'M' 'A' 'A' 'U'
 'U' 'U' 'A' 'M' 'M' 'U' 'U' 'U' 'U' 'U' 'U' 'U' 'A' 'A' 'A' 'A' 'U' 'U'
 'U' 'M' 'A' 'M' 'U' 'U' 'M' 'A' 'U' 'A' 'U' 'M' 'A' 'U' 'A' 'A' 'M' 'U'
 'U' 'A' 'U' 'U' 'U' 'A' 'M' 'A' 'A' 'A' 'U' 'M' 'M' 'M' 'M' 'M' 'M' 'M'
 'M' 'U' 'M' 'A' 'A' 'U' 'U' 'U' 'A' 'M' 'A' 'U' 'M' 'U' 'A' 'U' 'U' 'A'
 'U' 'A' 'M' 'U' 'A' 'A' 'U' 'A' 'U' 'U' 'M' 'A' 'U' 'U' 'A' 'U' 'A' 'U'
 'M' 'U' 'M' 'U' 'M' 'A' 'A' 'U' 'A' 'A' 'U' 'M' 'U' 'A' 'U' 'A' 'A' 'M'
 'U' 'U' 'U' 'A' 'A' 'A' 'A' 'A' 'A' 'A' 'A' 'A' 'A' 'U' 'M' 'A' 'U' 'M'
 'U' 'U' 'U' 'U' 'U' 'M' 'M' 'A' 'U' 'A' 'A' 'M' 'U' 'A' 'A' 'M' 'M' 'M'
 'U' 'U' 'A' 'A' 'M' 'A' 'U' 'U' 'U' 'A' 'A' 'A' 'U' 'A' 'A' 'A' 'A' 'U'
 'A' 'U' 'A' 'U' 'A' 'M' 'A' 'U' 'U' 'U' 'M' 'U' 'A' 'U' 'A' 'U' 'M' 'A']"
33201,2,134,81,53,64,0,0,"['A' 'U' 'A' 'A' 'M' 'A' 'U' 'M' 'M' 'M' 'U' 'M' 'U' 'M' 'M' 'A' 'A' 'U'
 'A' 'U' 'A' 'U' 'M' 'A' 'U' 'A' 'M' 'A' 'A' 'A' 'A' 'A' 'A' 'U' 'M' 'U'
 'M' 'M' 'A' 'M' 'U' 'U' 'M' 'A' 'M' 'A' 'U' 'M' 'A' 'A' 'U' 'U' 'M' 'A'
 'U' 'A' 'A' 'M' 'A' 'A' 'M' 'U' 'A' 'U' 'U' 'M' 'M' 'M' 'M' 'M' 'M' 'U'
 'M' 'M' 'M' 'A' 'A' 'U' 'U' 'U' 'A' 'M' 'A' 'U' 'M' 'A' 'A' 'U' 'U' 'A'
 'U' 'A' 'M' 'U' 'A' 'A' 'U' 'A' 'U' 'U' 'M' 'A' 'U' 'A' 'A' 'M' 'A' 'A'
 'M' 'U' 'M' 'M' 'M' 'A' 'U' 'U' 'A' 'A' 'U' 'U' 'M' 'U' 'U' 'A' 'U' 'U'
 'A' 'M' 'U' 'A' 'A' 'A' 'A' 'A' 'A' 'A' 'A' 'A' 'A' 'U' 'M' 'M' 'A' 'U'
 'U' 'M' 'U' 'U' 'U' 'M' 'M' 'A' 'A' 'A' 'A' 'M' 'U' 'U' 'U' 'M' 'M' 'M'
 'U' 'A' 'A' 'A' 'M' 'A' 'U' 'U' 'M' 'A' 'A' 'A' 'U' 'A' 'A' 'U' 'A' 'U'
 'A' 'U' 'A' 'U' 'A' 'U' 'A' 'U' 'U' 'M' 'M' 'A' 'U' 'A' 'A' 'U' 'M' 'A']"
33301,1,133,86,47,65,0,0,"['A' 'A' 'A' 'A' 'M' 'A' 'U' 'U' 'U' 'M' 'A' 'M' 'U' 'M' 'M' 'A' 'M' 'U'
 'U' 'M' 'A' 'U' 'A' 'U' 'U' 'A' 'M' 'A' 'A' 'A' 'A' 'A' 'A' 'U' 'M' 'U'
 'U' 'M' 'A' 'U' 'U' 'U' 'A' 'A' 'M' 'A' 'U' 'A' 'U' 'A' 'U' 'M' 'M' 'A'
 'A' 'A' 'U' 'U' 'A' 'A' 'M' 'U' 'A' 'U' 'U' 'M' 'M' 'M' 'M' 'M' 'M' 'U'
 'M' 'M' 'M' 'A' 'A' 'U' 'U' 'U' 'A' 'U' 'U' 'U' 'A' 'A' 'A' 'U' 'U' 'A'
 'U' 'A' 'M' 'A' 'A' 'A' 'U' 'A' 'A' 'A' 'M' 'U' 'U' 'A' 'A' 'M' 'U' 'A'
 'M' 'U' 'M' 'M' 'M' 'A' 'U' 'U' 'A' 'M' 'U' 'U' 'M' 'A' 'U' 'A' 'U' 'U'
 'A' 'M' 'U' 'A' 'U' 'A' 'A' 'A' 'A' 'A' 'A' 'A' 'A' 'M' 'M' 'M' 'A' 'U'
 'M' 'U' 'A' 'A' 'U' 'M' 'U' 'A' 'U' 'A' 'A' 'M' 'U' 'U' 'U' 'M' 'M' 'M'
 'U' 'U' 'A' 'A' 'M' 'A' 'A' 'U' 'M' 'A' 'U' 'A' 'A' 'A' 'A' 'U' 'A' 'U'
 'A' 'U' 'A' 'M' 'A' 'A' 'A' 'A' 'U' 'U' 'M' 'A' 'A' 'A' 'A' 'U' 'M' 'A']"
33401,2,133,90,43,65,0,0,"['A' 'A' 'A' 'A' 'M' 'A' 'U' 'A' 'U' 'M' 'A' 'M' 'A' 'U' 'M' 'A' 'M' 'U'
 'A' 'M' 'A' 'M' 'A' 'U' 'U' 'U' 'M' 'A' 'A' 'A' 'A' 'A' 'A' 'U' 'M' 'A'
 'U' 'U' 'A' 'U' 'A' 'U' 'A' 'A' 'M' 'A' 'A' 'A' 'U' 'A' 'A' 'M' 'M' 'A'
 'A' 'U' 'U' 'U' 'A' 'A' 'M' 'U' 'A' 'U' 'U' 'M' 'M' 'M' 'M' 'M' 'M' 'M'
 'U' 'M' 'M' 'A' 'A' 'U' 'A' 'U' 'A' 'U' 'U' 'U' 'A' 'A' 'U' 'U' 'U' 'U'
 'A' 'A' 'U' 'A' 'A' 'A' 'U' 'M' 'A' 'A' 'U' 'U' 'A' 'A' 'A' 'M' 'U' 'U'
 'M' 'U' 'M' 'A' 'M' 'A' 'U' 'U' 'A' 'M' 'U' 'A' 'M' 'U' 'A' 'A' 'U' 'U'
 'U' 'M' 'U' 'A' 'U' 'A' 'A' 'A' 'A' 'A' 'A' 'A' 'A' 'M' 'M' 'M' 'A' 'M'
 'A' 'U' 'A' 'U' 'U' 'M' 'U' 'U' 'U' 'A' 'A' 'A' 'U' 'U' 'U' 'M' 'M' 'U'
 'U' 'U' 'A' 'A' 'M' 'A' 'A' 'A' 'U' 'A' 'U' 'A' 'A' 'A' 'A' 'M' 'A' 'M'
 'A' 'U' 'U' 'M' 'A' 'A' 'A' 'A' 'U' 'M' 'M' 'A' 'U' 'A' 'A' 'U' 'U' 'A']"
33501,1,128,84,44,70,0,0,"['A' 'U' 'A' 'A' 'M' 'A' 'U' 'A' 'U' 'M' 'A' 'M' 'A' 'U' 'U' 'U' 'M' 'M'
 'A' 'M' 'A' 'U' 'A' 'U' 'U' 'U' 'U' 'A' 'A' 'A' 'A' 'A' 'U' 'U' 'M' 'A'
 'U' 'U' 'A' 'U' 'A' 'U' 'A' 'A' 'M' 'A' 'A' 'A' 'M' 'A' 'U' 'M' 'M' 'U'
 'A' 'U' 'M' 'U' 'A' 'A' 'U' 'M' 'A' 'U' 'U' 'M' 'M' 'M' 'U' 'M' 'M' 'M'
 'M' 'M' 'M' 'A' 'A' 'U' 'A' 'M' 'A' 'A' 'U' 'U' 'U' 'A' 'U' 'M' 'A' 'U'
 'U' 'A' 'A' 'A' 'A' 'A' 'U' 'U' 'U' 'A' 'U' 'A' 'A' 'A' 'A' 'M' 'U' 'U'
 'M' 'U' 'M' 'A' 'U' 'A' 'U' 'A' 'A' 'M' 'M' 'U' 'M' 'U' 'A' 'A' 'U' 'A'
 'U' 'M' 'U' 'U' 'U' 'A' 'A' 'A' 'A' 'A' 'A' 'A' 'A' 'M' 'M' 'M' 'A' 'M'
 'A' 'U' 'A' 'U' 'U' 'M' 'U' 'U' 'U' 'A' 'M' 'A' 'U' 'U' 'M' 'U' 'M' 'U'
 'U' 'U' 'U' 'A' 'A' 'A' 'A' 'A' 'M' 'A' 'U' 'A' 'A' 'A' 'A' 'M' 'A' 'M'
 'U' 'U' 'U' 'U' 'A' 'A' 'A' 'A' 'U' 'M' 'M' 'U' 'U' 'U' 'A' 'A' 'A' 'A']"
33601,2,124,80,44,74,1,0,"['A' 'U' 'A' 'A' 'M' 'A' 'U' 'U' 'U' 'M' 'A' 'M' 'A' 'A' 'U' 'U' 'M' 'M'
 'U' 'M' 'U' 'A' 'A' 'U' 'U' 'U' 'M' 'U' 'A' 'A' 'A' 'A' 'U' 'U' 'M' 'A'
 'U' 'U' 'U' 'U' 'U' 'U' 'A' 'A' 'M' 'A' 'A' 'A' 'U' 'A' 'U' 'M' 'M' 'U'
 'A' 'A' 'M' 'A' 'A' 'A' 'U' 'M' 'A' 'U' 'U' 'M' 'M' 'M' 'M' 'M' 'M' 'M'
 'M' 'M' 'U' 'A' 'A' 'M' 'A' 'M' 'A' 'A' 'U' 'A' 'U' 'A' 'U' 'M' 'A' 'U'
 'U' 'A' 'A' 'A' 'A' 'A' 'U' 'U' 'U' 'A' 'U' 'A' 'A' 'M' 'U' 'U' 'U' 'U'
 'U' 'U' 'M' 'A' 'M' 'A' 'A' 'A' 'A' 'M' 'U' 'U' 'M' 'U' 'A' 'A' 'U' 'A'
 'U' 'M' 'U' 'U' 'M' 'A' 'A' 'A' 'A' 'A' 'A' 'A' 'A' 'U' 'M' 'M' 'A' 'U'
 'A' 'A' 'U' 'U' 'U' 'M' 'U' 'M' 'U' 'A' 'M' 'A' 'U' 'U' 'M' 'U' 'U' 'U'
 'A' 'U' 'M' 'A' 'A' 'A' 'A' 'A' 'M' 'U' 'U' 'U' 'A' 'A' 'U' 'M' 'A' 'M'
 'U' 'U' 'U' 'A' 'A' 'A' 'A' 'U' 'U' 'M' 'M' 'U' 'U' 'U' 'A' 'A' 'A' 'A']"
33701,1,120,81,39,78,0,1,"['A' 'U' 'A' 'A' 'M' 'U' 'U' 'U' 'U' 'U' 'A' 'M' 'A' 'A' 'U' 'U' 'U' 'U'
 'M' 'U' 'U' 'A' 'U' 'U' 'U' 'U' 'M' 'U' 'A' 'A' 'A' 'A' 'U' 'U' 'A' 'A'
 'M' 'U' 'M' 'U' 'A' 'U' 'A' 'U' 'A' 'A' 'A' 'A' 'A' 'A' 'U' 'M' 'U' 'U'
 'A' 'U' 'M' 'A' 'A' 'A' 'U' 'A' 'A' 'U' 'A' 'M' 'M' 'M' 'U' 'M' 'M' 'M'
 'M' 'M' 'M' 'A' 'U' 'M' 'A' 'M' 'A' 'A' 'U' 'A' 'U' 'A' 'U' 'U' 'U' 'U'
 'U' 'A' 'A' 'A' 'U' 'A' 'A' 'U' 'U' 'A' 'U' 'A' 'A' 'M' 'U' 'U' 'U' 'M'
 'U' 'U' 'M' 'A' 'M' 'A' 'A' 'A' 'A' 'M' 'M' 'U' 'U' 'U' 'A' 'A' 'M' 'A'
 'A' 'M' 'U' 'M' 'U' 'A' 'A' 'A' 'A' 'A' 'A' 'A' 'A' 'U' 'M' 'U' 'A' 'M'
 'A' 'U' 'A' 'U' 'U' 'M' 'U' 'M' 'U' 'U' 'M' 'A' 'U' 'U' 'U' 'U' 'U' 'U'
 'A' 'U' 'U' 'A' 'A' 'A' 'A' 'A' 'U' 'U' 'U' 'M' 'A' 'A' 'U' 'M' 'A' 'M'
 'U' 'M' 'A' 'A' 'A' 'A' 'A' 'M' 'M' 'U' 'U' 'U' 'U' 'A' 'A' 'A' 'U' 'A']"
33801,2,108,74,34,90,0,1,"['A' 'U' 'A' 'A' 'M' 'U' 'U' 'A' 'U' 'U' 'A' 'M' 'A' 'A' 'U' 'U' 'U' 'U'
 'U' 'U' 'U' 'A' 'U' 'U' 'U' 'U' 'M' 'A' 'A' 'U' 'U' 'A' 'U' 'U' 'U' 'A'
 'U' 'M' 'M' 'U' 'A' 'U' 'U' 'A' 'M' 'U' 'A' 'A' 'A' 'A' 'U' 'M' 'U' 'U'
 'A' 'M' 'M' 'U' 'A' 'A' 'A' 'A' 'A' 'U' 'A' 'M' 'M' 'M' 'U' 'M' 'M' 'M'
 'M' 'M' 'M' 'A' 'A' 'M' 'A' 'M' 'A' 'A' 'U' 'A' 'U' 'A' 'U' 'U' 'U' 'U'
 'U' 'A' 'A' 'U' 'U' 'U' 'U' 'U' 'U' 'U' 'M' 'A' 'A' 'M' 'U' 'U' 'U' 'U'
 'U' 'U' 'U' 'A' 'M' 'A' 'A' 'A' 'A' 'M' 'M' 'U' 'U' 'U' 'A' 'A' 'M' 'A'
 'A' 'M' 'A' 'U' 'U' 'A' 'A' 'A' 'A' 'A' 'A' 'A' 'A' 'A' 'U' 'U' 'U' 'M'
 'U' 'A' 'A' 'U' 'U' 'U' 'U' 'M' 'U' 'U' 'U' 'A' 'U' 'U' 'U' 'M' 'A' 'U'
 'A' 'U' 'U' 'A' 'U' 'U' 'A' 'A' 'U' 'U' 'A' 'U' 'A' 'A' 'U' 'M' 'A' 'U'
 'U' 'M' 'A' 'U' 'A' 'A' 'A' 'U' 'U' 'M' 'U' 'U' 'M' 'A' 'A' 'A' 'U' 'U']"
33901,4,122,80,42,76,1,0,"['A' 'U' 'A' 'A' 'M' 'U' 'M' 'A' 'U' 'M' 'A' 'M' 'A' 'A' 'U' 'U' 'U' 'U'
 'M' 'U' 'U' 'A' 'U' 'U' 'U' 'U' 'M' 'A' 'A' 'U' 'U' 'A' 'U' 'U' 'U' 'A'
 'U' 'M' 'M' 'A' 'A' 'A' 'U' 'A' 'M' 'U' 'A' 'A' 'A' 'A' 'U' 'M' 'A' 'A'
 'A' 'M' 'M' 'U' 'A' 'U' 'A' 'A' 'A' 'U' 'A' 'M' 'M' 'M' 'M' 'M' 'U' 'M'
 'M' 'M' 'M' 'A' 'M' 'M' 'U' 'M' 'U' 'A' 'A' 'A' 'U' 'A' 'U' 'U' 'U' 'U'
 'U' 'U' 'U' 'U' 'A' 'U' 'U' 'U' 'U' 'U' 'M' 'A' 'A' 'M' 'A' 'A' 'U' 'U'
 'U' 'A' 'U' 'U' 'M' 'U' 'A' 'A' 'A' 'M' 'M' 'U' 'M' 'U' 'A' 'A' 'M' 'A'
 'A' 'M' 'A' 'U' 'U' 'A' 'A' 'A' 'A' 'A' 'A' 'A' 'A' 'U' 'U' 'M' 'M' 'M'
 'A' 'A' 'U' 'U' 'A' 'U' 'U' 'U' 'A' 'A' 'U' 'A' 'U' 'U' 'U' 'U' 'A' 'M'
 'A' 'U' 'U' 'A' 'U' 'U' 'A' 'A' 'A' 'U' 'A' 'U' 'A' 'A' 'U' 'A' 'A' 'M'
 'U' 'M' 'A' 'A' 'M' 'A' 'A' 'U' 'U' 'M' 'U' 'M' 'M' 'A' 'A' 'A' 'U' 'A']"
34001,1,121,80,41,77,0,0,"['A' 'U' 'A' 'A' 'M' 'U' 'U' 'A' 'U' 'M' 'A' 'M' 'U' 'U' 'U' 'U' 'A' 'U'
 'M' 'U' 'U' 'A' 'U' 'U' 'U' 'U' 'M' 'A' 'A' 'U' 'U' 'A' 'U' 'U' 'U' 'A'
 'U' 'U' 'M' 'A' 'A' 'A' 'U' 'U' 'M' 'U' 'A' 'A' 'A' 'A' 'M' 'M' 'A' 'A'
 'A' 'M' 'M' 'U' 'A' 'U' 'A' 'A' 'A' 'M' 'U' 'M' 'M' 'M' 'M' 'M' 'M' 'M'
 'U' 'M' 'M' 'A' 'U' 'M' 'U' 'M' 'U' 'A' 'A' 'A' 'M' 'A' 'U' 'U' 'U' 'U'
 'U' 'U' 'U' 'U' 'A' 'A' 'A' 'U' 'M' 'A' 'M' 'A' 'A' 'U' 'A' 'A' 'A' 'A'
 'U' 'U' 'U' 'A' 'M' 'A' 'A' 'U' 'A' 'U' 'M' 'A' 'M' 'U' 'U' 'U' 'M' 'U'
 'A' 'U' 'A' 'A' 'A' 'A' 'A' 'A' 'A' 'U' 'A' 'A' 'A' 'U' 'U' 'M' 'M' 'M'
 'U' 'A' 'M' 'A' 'A' 'U' 'U' 'M' 'A' 'U' 'U' 'A' 'U' 'U' 'U' 'U' 'A' 'M'
 'U' 'U' 'U' 'A' 'A' 'A' 'A' 'A' 'U' 'M' 'A' 'U' 'U' 'A' 'U' 'A' 'A' 'A'
 'U' 'M' 'A' 'A' 'A' 'A' 'U' 'U' 'U' 'M' 'U' 'M' 'M' 'A' 'A' 'A' 'U' 'A']"
34101,1,122,78,44,76,0,0,"['A' 'U' 'A' 'A' 'U' 'U' 'A' 'A' 'U' 'M' 'A' 'M' 'U' 'A' 'U' 'U' 'U' 'M'
 'A' 'U' 'M' 'U' 'U' 'A' 'U' 'U' 'M' 'A' 'U' 'A' 'U' 'U' 'U' 'U' 'U' 'A'
 'U' 'M' 'M' 'A' 'A' 'U' 'U' 'U' 'M' 'M' 'A' 'A' 'U' 'A' 'U' 'M' 'A' 'A'
 'A' 'M' 'U' 'U' 'A' 'U' 'A' 'M' 'A' 'U' 'U' 'M' 'U' 'M' 'M' 'M' 'M' 'M'
 'M' 'M' 'M' 'A' 'A' 'M' 'U' 'M' 'A' 'A' 'A' 'A' 'U' 'A' 'U' 'U' 'A' 'U'
 'U' 'A' 'M' 'U' 'A' 'A' 'A' 'A' 'M' 'A' 'U' 'A' 'A' 'U' 'M' 'U' 'U' 'A'
 'U' 'U' 'U' 'A' 'M' 'A' 'A' 'U' 'A' 'U' 'M' 'A' 'M' 'A' 'U' 'U' 'M' 'U'
 'A' 'U' 'A' 'U' 'A' 'A' 'A' 'A' 'A' 'A' 'A' 'A' 'A' 'U' 'U' 'M' 'M' 'M'
 'U' 'A' 'M' 'A' 'A' 'A' 'U' 'U' 'A' 'U' 'U' 'A' 'U' 'U' 'U' 'M' 'U' 'M'
 'U' 'A' 'U' 'A' 'A' 'A' 'U' 'A' 'M' 'M' 'U' 'U' 'U' 'A' 'U' 'A' 'A' 'A'
 'U' 'M' 'A' 'A' 'U' 'M' 'U' 'M' 'A' 'M' 'U' 'M' 'M' 'A' 'U' 'A' 'U' 'A']"
34201,0,126,79,47,72,1,0,"['A' 'M' 'U' 'A' 'U' 'U' 'U' 'U' 'U' 'M' 'A' 'U' 'M' 'U' 'U' 'M' 'U' 'M'
 'A' 'U' 'U' 'U' 'U' 'A' 'U' 'U' 'M' 'A' 'M' 'A' 'U' 'U' 'U' 'U' 'U' 'A'
 'U' 'M' 'M' 'A' 'A' 'U' 'U' 'U' 'M' 'M' 'A' 'A' 'U' 'U' 'U' 'M' 'A' 'A'
 'A' 'M' 'M' 'A' 'A' 'U' 'A' 'M' 'A' 'A' 'M' 'M' 'M' 'M' 'M' 'M' 'M' 'M'
 'U' 'M' 'M' 'A' 'A' 'M' 'U' 'M' 'A' 'A' 'A' 'A' 'U' 'A' 'U' 'U' 'A' 'U'
 'U' 'A' 'M' 'M' 'A' 'A' 'A' 'A' 'U' 'A' 'U' 'U' 'A' 'U' 'M' 'A' 'A' 'A'
 'U' 'M' 'A' 'A' 'M' 'A' 'A' 'M' 'U' 'U' 'M' 'A' 'U' 'A' 'U' 'U' 'U' 'U'
 'A' 'U' 'A' 'M' 'A' 'A' 'A' 'A' 'U' 'A' 'A' 'A' 'A' 'U' 'U' 'M' 'M' 'M'
 'A' 'A' 'U' 'A' 'A' 'U' 'U' 'M' 'A' 'A' 'U' 'A' 'U' 'U' 'U' 'M' 'U' 'M'
 'A' 'A' 'U' 'U' 'A' 'A' 'U' 'A' 'U' 'U' 'U' 'A' 'U' 'U' 'M' 'A' 'A' 'A'
 'A' 'M' 'A' 'A' 'U' 'U' 'U' 'M' 'A' 'M' 'A' 'M' 'M' 'A' 'A' 'A' 'U' 'A']"
34301,2,123,81,42,75,1,0,"['A' 'U' 'U' 'A' 'U' 'U' 'U' 'U' 'U' 'A' 'A' 'U' 'M' 'M' 'U' 'M' 'U' 'M'
 'A' 'U' 'M' 'U' 'U' 'A' 'U' 'A' 'M' 'A' 'M' 'U' 'U' 'U' 'A' 'A' 'U' 'A'
 'U' 'M' 'M' 'A' 'A' 'A' 'U' 'A' 'M' 'U' 'U' 'U' 'U' 'U' 'A' 'M' 'A' 'A'
 'A' 'M' 'M' 'A' 'A' 'A' 'A' 'U' 'U' 'A' 'U' 'M' 'M' 'M' 'M' 'M' 'U' 'M'
 'M' 'M' 'M' 'U' 'A' 'M' 'U' 'M' 'A' 'A' 'A' 'A' 'U' 'A' 'M' 'U' 'A' 'U'
 'U' 'A' 'M' 'U' 'A' 'U' 'A' 'A' 'U' 'U' 'U' 'U' 'A' 'U' 'M' 'A' 'A' 'U'
 'U' 'M' 'U' 'A' 'M' 'A' 'A' 'U' 'A' 'U' 'M' 'A' 'U' 'A' 'U' 'U' 'U' 'U'
 'A' 'U' 'A' 'U' 'A' 'A' 'A' 'A' 'A' 'A' 'A' 'A' 'A' 'U' 'U' 'U' 'M' 'M'
 'A' 'A' 'U' 'A' 'A' 'U' 'M' 'U' 'A' 'A' 'U' 'A' 'A' 'M' 'A' 'M' 'A' 'M'
 'A' 'A' 'U' 'M' 'A' 'A' 'U' 'A' 'U' 'U' 'U' 'A' 'U' 'M' 'M' 'A' 'A' 'A'
 'A' 'M' 'A' 'A' 'U' 'U' 'U' 'U' 'U' 'A' 'A' 'M' 'U' 'A' 'U' 'U' 'M' 'A']"
34401,1,124,75,49,74,0,0,"['A' 'U' 'U' 'A' 'U' 'U' 'U' 'U' 'U' 'A' 'A' 'U' 'M' 'M' 'U' 'M' 'U' 'M'
 'A' 'U' 'M' 'U' 'U' 'A' 'M' 'A' 'M' 'A' 'M' 'U' 'U' 'U' 'U' 'A' 'U' 'A'
 'A' 'M' 'M' 'A' 'U' 'A' 'M' 'U' 'M' 'M' 'U' 'U' 'A' 'U' 'A' 'U' 'A' 'A'
 'A' 'U' 'M' 'A' 'A' 'A' 'A' 'A' 'U' 'A' 'U' 'M' 'M' 'M' 'M' 'U' 'M' 'M'
 'M' 'M' 'M' 'U' 'A' 'U' 'U' 'M' 'A' 'A' 'U' 'A' 'U' 'A' 'M' 'A' 'U' 'U'
 'M' 'A' 'M' 'U' 'A' 'U' 'U' 'A' 'U' 'U' 'U' 'U' 'U' 'A' 'M' 'A' 'A' 'U'
 'A' 'M' 'U' 'A' 'M' 'A' 'U' 'M' 'A' 'U' 'M' 'A' 'U' 'A' 'U' 'U' 'A' 'U'
 'A' 'M' 'A' 'U' 'A' 'A' 'A' 'A' 'A' 'A' 'A' 'A' 'A' 'M' 'U' 'U' 'M' 'M'
 'A' 'A' 'U' 'A' 'U' 'U' 'M' 'U' 'A' 'A' 'U' 'A' 'A' 'M' 'A' 'M' 'A' 'M'
 'U' 'A' 'U' 'U' 'U' 'A' 'U' 'A' 'U' 'M' 'U' 'U' 'U' 'M' 'M' 'A' 'A' 'A'
 'U' 'M' 'A' 'A' 'M' 'U' 'U' 'U' 'U' 'A' 'U' 'M' 'M' 'A' 'A' 'M' 'M' 'A']"
34501,0,125,71,54,73,0,0,"['A' 'A' 'U' 'U' 'U' 'U' 'U' 'U' 'A' 'A' 'A' 'U' 'M' 'M' 'U' 'M' 'U' 'M'
 'A' 'U' 'M' 'A' 'M' 'A' 'M' 'A' 'U' 'A' 'U' 'U' 'U' 'U' 'U' 'A' 'U' 'A'
 'U' 'M' 'M' 'A' 'U' 'A' 'U' 'M' 'M' 'M' 'U' 'M' 'A' 'U' 'U' 'A' 'A' 'A'
 'U' 'U' 'M' 'A' 'A' 'A' 'U' 'A' 'A' 'A' 'M' 'M' 'M' 'U' 'M' 'M' 'M' 'M'
 'M' 'M' 'M' 'U' 'U' 'U' 'U' 'M' 'U' 'U' 'A' 'A' 'M' 'A' 'U' 'A' 'U' 'A'
 'M' 'A' 'M' 'U' 'A' 'M' 'M' 'A' 'U' 'U' 'U' 'U' 'U' 'A' 'M' 'A' 'A' 'U'
 'A' 'M' 'U' 'U' 'M' 'A' 'U' 'M' 'U' 'U' 'M' 'A' 'M' 'A' 'A' 'U' 'A' 'U'
 'A' 'M' 'A' 'A' 'A' 'A' 'A' 'A' 'A' 'A' 'A' 'A' 'A' 'A' 'U' 'U' 'M' 'M'
 'A' 'A' 'U' 'U' 'M' 'U' 'M' 'U' 'U' 'U' 'U' 'A' 'A' 'U' 'U' 'M' 'A' 'M'
 'A' 'A' 'U' 'U' 'U' 'U' 'U' 'M' 'U' 'M' 'M' 'U' 'U' 'M' 'M' 'U' 'A' 'A'
 'A' 'M' 'A' 'A' 'M' 'U' 'U' 'U' 'A' 'A' 'U' 'M' 'M' 'A' 'A' 'M' 'M' 'A']"
34601,2,126,69,57,72,1,0,"['A' 'A' 'A' 'M' 'U' 'U' 'A' 'M' 'A' 'A' 'A' 'A' 'M' 'M' 'M' 'U' 'U' 'M'
 'A' 'U' 'U' 'A' 'M' 'U' 'M' 'A' 'A' 'A' 'U' 'U' 'A' 'M' 'U' 'A' 'U' 'A'
 'A' 'M' 'M' 'A' 'U' 'A' 'U' 'U' 'M' 'M' 'U' 'M' 'A' 'U' 'U' 'A' 'U' 'A'
 'U' 'A' 'M' 'A' 'U' 'A' 'U' 'A' 'A' 'A' 'M' 'M' 'M' 'U' 'M' 'M' 'M' 'M'
 'M' 'M' 'M' 'U' 'U' 'U' 'U' 'M' 'U' 'U' 'A' 'U' 'M' 'A' 'U' 'U' 'M' 'A'
 'M' 'A' 'M' 'U' 'A' 'M' 'M' 'A' 'A' 'U' 'U' 'U' 'U' 'A' 'M' 'A' 'A' 'U'
 'A' 'M' 'U' 'U' 'M' 'A' 'A' 'M' 'M' 'U' 'M' 'A' 'M' 'U' 'A' 'U' 'U' 'U'
 'A' 'U' 'A' 'A' 'U' 'U' 'A' 'A' 'A' 'A' 'A' 'A' 'A' 'A' 'M' 'U' 'M' 'M'
 'U' 'U' 'U' 'U' 'M' 'A' 'M' 'A' 'U' 'U' 'U' 'A' 'A' 'U' 'M' 'M' 'A' 'M'
 'A' 'A' 'U' 'U' 'U' 'M' 'U' 'M' 'U' 'M' 'U' 'A' 'U' 'M' 'M' 'U' 'A' 'U'
 'A' 'U' 'A' 'U' 'M' 'M' 'U' 'U' 'A' 'A' 'U' 'M' 'U' 'U' 'A' 'M' 'M' 'A']"
34701,1,131,71,60,67,0,1,"['A' 'A' 'A' 'M' 'U' 'A' 'A' 'M' 'A' 'A' 'U' 'A' 'M' 'U' 'M' 'U' 'U' 'M'
 'A' 'U' 'M' 'A' 'M' 'M' 'M' 'A' 'A' 'A' 'U' 'M' 'A' 'M' 'U' 'A' 'U' 'U'
 'A' 'M' 'U' 'A' 'U' 'A' 'U' 'A' 'M' 'M' 'M' 'M' 'A' 'U' 'A' 'U' 'A' 'U'
 'A' 'A' 'M' 'U' 'M' 'U' 'U' 'A' 'A' 'A' 'M' 'M' 'M' 'M' 'M' 'M' 'M' 'M'
 'M' 'M' 'U' 'U' 'U' 'U' 'A' 'M' 'U' 'U' 'A' 'M' 'M' 'A' 'U' 'M' 'M' 'U'
 'M' 'A' 'M' 'M' 'A' 'M' 'M' 'A' 'A' 'U' 'U' 'M' 'U' 'A' 'M' 'A' 'A' 'M'
 'U' 'M' 'U' 'A' 'M' 'A' 'A' 'M' 'M' 'U' 'M' 'A' 'M' 'A' 'U' 'U' 'U' 'U'
 'U' 'A' 'U' 'A' 'U' 'A' 'A' 'A' 'A' 'A' 'A' 'A' 'A' 'U' 'M' 'U' 'M' 'M'
 'U' 'U' 'U' 'U' 'A' 'A' 'M' 'A' 'U' 'A' 'U' 'U' 'A' 'U' 'M' 'U' 'A' 'U'
 'A' 'A' 'U' 'U' 'A' 'M' 'U' 'M' 'U' 'M' 'U' 'A' 'U' 'M' 'M' 'U' 'A' 'U'
 'A' 'U' 'A' 'A' 'U' 'M' 'U' 'U' 'U' 'A' 'A' 'M' 'U' 'A' 'A' 'M' 'U' 'A']"
34801,3,129,71,58,69,1,0,"['A' 'A' 'A' 'U' 'U' 'A' 'A' 'U' 'A' 'A' 'U' 'A' 'M' 'U' 'M' 'U' 'U' 'M'
 'A' 'M' 'M' 'A' 'M' 'M' 'U' 'A' 'A' 'A' 'U' 'U' 'A' 'M' 'M' 'A' 'U' 'U'
 'U' 'U' 'M' 'A' 'U' 'U' 'U' 'A' 'U' 'M' 'M' 'U' 'A' 'U' 'A' 'U' 'A' 'U'
 'A' 'A' 'U' 'U' 'M' 'A' 'M' 'A' 'A' 'A' 'U' 'U' 'M' 'M' 'M' 'M' 'M' 'M'
 'M' 'M' 'M' 'M' 'U' 'M' 'A' 'M' 'U' 'M' 'A' 'M' 'M' 'A' 'U' 'M' 'M' 'A'
 'U' 'A' 'M' 'U' 'A' 'M' 'M' 'U' 'U' 'U' 'U' 'M' 'U' 'A' 'M' 'A' 'A' 'M'
 'A' 'M' 'U' 'A' 'M' 'A' 'A' 'M' 'M' 'M' 'A' 'A' 'M' 'A' 'U' 'U' 'A' 'A'
 'M' 'U' 'U' 'A' 'U' 'A' 'A' 'A' 'A' 'A' 'A' 'A' 'A' 'A' 'M' 'M' 'M' 'U'
 'M' 'U' 'A' 'U' 'A' 'A' 'U' 'A' 'A' 'A' 'U' 'U' 'A' 'U' 'M' 'U' 'U' 'U'
 'A' 'A' 'U' 'U' 'A' 'M' 'U' 'U' 'M' 'M' 'U' 'U' 'M' 'M' 'M' 'U' 'A' 'U'
 'A' 'M' 'U' 'A' 'M' 'U' 'U' 'U' 'U' 'A' 'A' 'M' 'A' 'U' 'U' 'U' 'U' 'A']"
34901,2,122,66,56,76,0,1,"['A' 'A' 'A' 'U' 'U' 'A' 'U' 'U' 'A' 'A' 'U' 'U' 'M' 'U' 'U' 'U' 'U' 'M'
 'A' 'M' 'U' 'A' 'U' 'M' 'U' 'A' 'A' 'A' 'U' 'U' 'A' 'M' 'M' 'A' 'U' 'M'
 'U' 'U' 'M' 'U' 'U' 'U' 'U' 'A' 'U' 'M' 'M' 'U' 'U' 'U' 'U' 'M' 'A' 'A'
 'A' 'A' 'U' 'U' 'M' 'A' 'M' 'A' 'A' 'A' 'U' 'M' 'M' 'M' 'M' 'M' 'U' 'M'
 'M' 'M' 'M' 'M' 'U' 'M' 'U' 'M' 'U' 'U' 'A' 'U' 'M' 'M' 'U' 'U' 'M' 'U'
 'U' 'A' 'M' 'M' 'A' 'M' 'M' 'U' 'U' 'U' 'A' 'M' 'U' 'A' 'M' 'A' 'A' 'M'
 'U' 'M' 'M' 'A' 'M' 'U' 'A' 'U' 'U' 'U' 'A' 'A' 'M' 'A' 'U' 'U' 'A' 'A'
 'M' 'A' 'A' 'A' 'U' 'A' 'A' 'A' 'A' 'A' 'A' 'A' 'A' 'A' 'M' 'M' 'U' 'U'
 'M' 'U' 'U' 'U' 'A' 'A' 'U' 'U' 'U' 'A' 'U' 'M' 'A' 'U' 'U' 'M' 'U' 'M'
 'A' 'A' 'U' 'M' 'A' 'M' 'U' 'M' 'U' 'M' 'U' 'U' 'U' 'M' 'M' 'U' 'A' 'U'
 'A' 'M' 'U' 'A' 'M' 'A' 'U' 'M' 'A' 'A' 'A' 'A' 'A' 'U' 'A' 'U' 'M' 'A']"
35001,1,130,68,62,68,0,0,"['A' 'A' 'A' 'U' 'U' 'A' 'U' 'U' 'A' 'A' 'A' 'U' 'M' 'M' 'U' 'U' 'A' 'M'
 'A' 'M' 'U' 'A' 'A' 'M' 'U' 'A' 'A' 'A' 'U' 'M' 'A' 'M' 'U' 'A' 'U' 'M'
 'U' 'U' 'M' 'U' 'U' 'U' 'U' 'A' 'U' 'M' 'U' 'U' 'U' 'U' 'U' 'M' 'A' 'U'
 'A' 'A' 'U' 'U' 'M' 'A' 'M' 'A' 'A' 'A' 'U' 'M' 'M' 'M' 'M' 'M' 'M' 'M'
 'M' 'M' 'U' 'M' 'U' 'M' 'U' 'M' 'M' 'M' 'A' 'U' 'M' 'M' 'U' 'U' 'M' 'U'
 'A' 'A' 'U' 'M' 'A' 'M' 'M' 'A' 'M' 'U' 'U' 'M' 'M' 'A' 'M' 'A' 'U' 'M'
 'U' 'M' 'M' 'U' 'M' 'M' 'A' 'U' 'U' 'U' 'A' 'A' 'M' 'A' 'U' 'U' 'A' 'U'
 'M' 'U' 'A' 'A' 'U' 'A' 'A' 'A' 'A' 'A' 'A' 'A' 'A' 'A' 'M' 'M' 'U' 'U'
 'M' 'A' 'U' 'M' 'A' 'A' 'U' 'U' 'U' 'A' 'U' 'M' 'U' 'M' 'U' 'M' 'U' 'M'
 'A' 'A' 'U' 'M' 'A' 'A' 'U' 'M' 'U' 'A' 'M' 'U' 'U' 'M' 'M' 'U' 'A' 'U'
 'A' 'M' 'A' 'A' 'M' 'A' 'M' 'M' 'A' 'A' 'A' 'A' 'A' 'U' 'A' 'U' 'M' 'A']"
35101,3,122,68,54,76,0,1,"['A' 'A' 'U' 'U' 'U' 'A' 'U' 'M' 'A' 'U' 'A' 'U' 'U' 'U' 'U' 'U' 'A' 'M'
 'A' 'M' 'A' 'A' 'A' 'M' 'U' 'A' 'U' 'A' 'U' 'M' 'A' 'M' 'M' 'U' 'U' 'M'
 'U' 'U' 'U' 'U' 'M' 'A' 'U' 'A' 'U' 'M' 'U' 'U' 'U' 'U' 'U' 'U' 'A' 'A'
 'U' 'A' 'U' 'U' 'M' 'A' 'M' 'A' 'A' 'A' 'A' 'M' 'U' 'M' 'M' 'M' 'M' 'M'
 'M' 'M' 'M' 'M' 'U' 'M' 'U' 'M' 'M' 'M' 'A' 'M' 'M' 'M' 'A' 'M' 'U' 'A'
 'A' 'A' 'A' 'U' 'A' 'U' 'M' 'A' 'M' 'M' 'U' 'M' 'M' 'U' 'M' 'A' 'M' 'M'
 'U' 'U' 'M' 'M' 'M' 'M' 'A' 'A' 'U' 'U' 'A' 'A' 'U' 'A' 'A' 'U' 'A' 'U'
 'M' 'U' 'A' 'U' 'U' 'A' 'A' 'A' 'A' 'A' 'A' 'A' 'A' 'A' 'U' 'M' 'U' 'U'
 'U' 'U' 'U' 'U' 'A' 'A' 'U' 'A' 'U' 'U' 'U' 'M' 'U' 'M' 'M' 'U' 'U' 'M'
 'A' 'A' 'U' 'M' 'A' 'A' 'A' 'U' 'U' 'A' 'M' 'U' 'U' 'M' 'M' 'U' 'A' 'A'
 'U' 'U' 'A' 'U' 'M' 'A' 'U' 'U' 'U' 'A' 'A' 'A' 'A' 'U' 'U' 'A' 'M' 'A']"
35201,0,135,68,67,63,1,0,"['A' 'A' 'U' 'U' 'U' 'A' 'U' 'A' 'A' 'U' 'A' 'A' 'U' 'A' 'U' 'M' 'A' 'A'
 'A' 'M' 'A' 'A' 'A' 'M' 'U' 'A' 'A' 'A' 'U' 'M' 'U' 'M' 'M' 'U' 'U' 'M'
 'U' 'A' 'M' 'U' 'M' 'A' 'U' 'U' 'U' 'M' 'U' 'A' 'U' 'A' 'U' 'M' 'U' 'A'
 'M' 'A' 'U' 'U' 'M' 'A' 'M' 'A' 'A' 'A' 'U' 'M' 'M' 'M' 'M' 'M' 'M' 'M'
 'M' 'M' 'U' 'M' 'U' 'M' 'U' 'M' 'M' 'M' 'U' 'M' 'M' 'M' 'A' 'M' 'U' 'A'
 'A' 'A' 'U' 'A' 'M' 'U' 'M' 'A' 'M' 'M' 'U' 'M' 'M' 'U' 'M' 'U' 'M' 'M'
 'U' 'U' 'M' 'U' 'M' 'M' 'A' 'A' 'A' 'M' 'A' 'A' 'U' 'U' 'M' 'A' 'A' 'M'
 'M' 'U' 'A' 'U' 'U' 'A' 'A' 'A' 'U' 'A' 'A' 'A' 'A' 'A' 'U' 'M' 'U' 'U'
 'U' 'U' 'A' 'U' 'U' 'A' 'U' 'A' 'M' 'M' 'M' 'M' 'A' 'M' 'M' 'U' 'U' 'M'
 'A' 'A' 'A' 'M' 'A' 'A' 'A' 'M' 'M' 'A' 'U' 'U' 'U' 'M' 'M' 'M' 'A' 'A'
 'M' 'U' 'U' 'U' 'M' 'A' 'M' 'U' 'U' 'A' 'A' 'A' 'A' 'M' 'U' 'U' 'M' 'A']"
35301,3,122,63,59,76,1,0,"['A' 'A' 'U' 'U' 'U' 'U' 'U' 'A' 'U' 'A' 'A' 'A' 'U' 'A' 'U' 'U' 'A' 'A'
 'A' 'M' 'A' 'A' 'A' 'M' 'U' 'U' 'A' 'A' 'U' 'U' 'U' 'M' 'U' 'U' 'U' 'U'
 'U' 'U' 'M' 'U' 'M' 'U' 'U' 'U' 'U' 'M' 'U' 'A' 'U' 'A' 'U' 'M' 'M' 'A'
 'U' 'A' 'U' 'U' 'M' 'U' 'U' 'U' 'A' 'A' 'M' 'M' 'M' 'M' 'M' 'M' 'M' 'M'
 'U' 'M' 'M' 'M' 'U' 'M' 'U' 'M' 'M' 'M' 'A' 'M' 'M' 'M' 'U' 'M' 'U' 'A'
 'M' 'U' 'M' 'A' 'M' 'U' 'M' 'A' 'M' 'M' 'U' 'M' 'M' 'U' 'M' 'M' 'A' 'U'
 'A' 'U' 'U' 'M' 'M' 'M' 'A' 'U' 'A' 'M' 'A' 'U' 'U' 'U' 'U' 'A' 'A' 'M'
 'M' 'A' 'A' 'U' 'A' 'A' 'A' 'A' 'A' 'A' 'A' 'A' 'A' 'A' 'U' 'M' 'U' 'U'
 'U' 'A' 'A' 'U' 'U' 'A' 'U' 'A' 'M' 'M' 'M' 'U' 'A' 'U' 'M' 'U' 'U' 'M'
 'U' 'A' 'A' 'M' 'U' 'A' 'A' 'M' 'M' 'A' 'U' 'A' 'M' 'U' 'M' 'M' 'A' 'A'
 'M' 'U' 'U' 'U' 'U' 'A' 'M' 'U' 'U' 'A' 'A' 'A' 'A' 'U' 'U' 'U' 'M' 'A']"
35401,0,125,57,68,73,1,0,"['A' 'A' 'U' 'U' 'U' 'U' 'U' 'A' 'M' 'A' 'A' 'A' 'A' 'A' 'U' 'U' 'A' 'A'
 'U' 'M' 'A' 'U' 'A' 'M' 'U' 'M' 'A' 'A' 'U' 'U' 'U' 'M' 'M' 'A' 'A' 'U'
 'U' 'U' 'M' 'U' 'M' 'U' 'U' 'U' 'U' 'M' 'U' 'U' 'M' 'A' 'U' 'M' 'M' 'U'
 'M' 'A' 'U' 'U' 'M' 'U' 'U' 'U' 'U' 'U' 'M' 'M' 'M' 'M' 'U' 'M' 'M' 'M'
 'M' 'M' 'M' 'M' 'U' 'M' 'U' 'M' 'M' 'M' 'A' 'M' 'U' 'M' 'U' 'M' 'M' 'A'
 'U' 'A' 'M' 'U' 'M' 'U' 'M' 'U' 'M' 'M' 'M' 'M' 'M' 'U' 'M' 'M' 'U' 'U'
 'A' 'U' 'M' 'M' 'M' 'M' 'A' 'A' 'A' 'M' 'M' 'M' 'U' 'M' 'U' 'A' 'A' 'M'
 'M' 'U' 'A' 'U' 'U' 'A' 'A' 'A' 'A' 'A' 'A' 'A' 'A' 'A' 'M' 'M' 'U' 'A'
 'U' 'A' 'U' 'U' 'U' 'A' 'U' 'A' 'M' 'M' 'M' 'U' 'A' 'U' 'U' 'U' 'M' 'M'
 'U' 'A' 'A' 'M' 'U' 'A' 'A' 'M' 'M' 'A' 'U' 'A' 'M' 'U' 'M' 'U' 'A' 'A'
 'M' 'U' 'U' 'A' 'U' 'A' 'M' 'U' 'A' 'A' 'A' 'U' 'A' 'U' 'U' 'U' 'M' 'A']"
35501,4,125,52,73,73,0,0,"['A' 'A' 'U' 'U' 'U' 'U' 'U' 'A' 'M' 'A' 'A' 'U' 'A' 'A' 'U' 'M' 'A' 'A'
 'U' 'M' 'A' 'U' 'U' 'M' 'A' 'M' 'U' 'A' 'U' 'U' 'A' 'M' 'U' 'U' 'A' 'U'
 'U' 'U' 'M' 'U' 'U' 'M' 'M' 'U' 'A' 'U' 'U' 'U' 'M' 'A' 'M' 'M' 'M' 'A'
 'U' 'A' 'M' 'A' 'M' 'M' 'U' 'U' 'U' 'M' 'M' 'U' 'M' 'M' 'M' 'M' 'M' 'M'
 'M' 'M' 'M' 'M' 'U' 'M' 'M' 'M' 'U' 'U' 'A' 'M' 'M' 'M' 'A' 'M' 'M' 'A'
 'U' 'A' 'M' 'U' 'M' 'U' 'M' 'U' 'M' 'M' 'U' 'M' 'M' 'U' 'M' 'M' 'U' 'M'
 'A' 'U' 'M' 'M' 'M' 'A' 'U' 'A' 'A' 'M' 'M' 'M' 'M' 'U' 'U' 'A' 'U' 'U'
 'U' 'U' 'U' 'U' 'U' 'A' 'A' 'A' 'A' 'A' 'A' 'A' 'A' 'A' 'M' 'M' 'U' 'U'
 'U' 'A' 'U' 'U' 'U' 'A' 'U' 'U' 'M' 'M' 'M' 'U' 'U' 'U' 'U' 'U' 'M' 'M'
 'M' 'A' 'M' 'M' 'U' 'A' 'A' 'M' 'M' 'A' 'U' 'A' 'M' 'U' 'M' 'U' 'A' 'U'
 'M' 'U' 'U' 'A' 'M' 'A' 'M' 'U' 'A' 'A' 'A' 'M' 'A' 'M' 'U' 'U' 'M' 'A']"
35601,4,122,50,72,76,0,0,"['A' 'A' 'U' 'U' 'U' 'U' 'A' 'U' 'M' 'A' 'A' 'U' 'U' 'A' 'M' 'M' 'U' 'U'
 'M' 'M' 'A' 'U' 'A' 'M' 'A' 'M' 'A' 'A' 'M' 'U' 'A' 'M' 'U' 'U' 'A' 'U'
 'U' 'U' 'M' 'M' 'A' 'U' 'M' 'U' 'A' 'U' 'U' 'U' 'M' 'U' 'M' 'M' 'M' 'A'
 'U' 'M' 'M' 'A' 'U' 'M' 'A' 'U' 'U' 'U' 'M' 'M' 'M' 'M' 'M' 'M' 'M' 'M'
 'M' 'M' 'U' 'M' 'M' 'M' 'M' 'M' 'U' 'U' 'A' 'M' 'M' 'M' 'A' 'M' 'M' 'A'
 'U' 'A' 'M' 'M' 'U' 'U' 'M' 'U' 'M' 'M' 'A' 'M' 'M' 'U' 'M' 'M' 'U' 'M'
 'A' 'U' 'M' 'U' 'M' 'A' 'U' 'A' 'U' 'M' 'U' 'M' 'M' 'U' 'U' 'A' 'U' 'M'
 'U' 'A' 'U' 'U' 'U' 'A' 'A' 'A' 'A' 'A' 'A' 'A' 'A' 'A' 'U' 'U' 'U' 'U'
 'U' 'U' 'U' 'A' 'U' 'A' 'U' 'U' 'M' 'M' 'M' 'U' 'U' 'U' 'A' 'U' 'M' 'M'
 'M' 'A' 'M' 'M' 'U' 'U' 'A' 'U' 'M' 'A' 'U' 'A' 'M' 'U' 'U' 'U' 'A' 'M'
 'U' 'U' 'U' 'U' 'M' 'A' 'M' 'M' 'U' 'A' 'A' 'M' 'A' 'M' 'U' 'U' 'M' 'A']"
35701,3,118,51,67,80,0,0,"['A' 'U' 'A' 'U' 'U' 'M' 'A' 'U' 'M' 'A' 'A' 'U' 'U' 'U' 'M' 'M' 'A' 'M'
 'M' 'M' 'A' 'U' 'A' 'U' 'A' 'M' 'A' 'U' 'M' 'A' 'A' 'M' 'U' 'U' 'A' 'U'
 'U' 'U' 'M' 'M' 'A' 'M' 'M' 'U' 'A' 'U' 'U' 'M' 'M' 'A' 'M' 'M' 'M' 'A'
 'U' 'A' 'M' 'A' 'U' 'U' 'A' 'U' 'M' 'U' 'M' 'M' 'U' 'M' 'M' 'M' 'M' 'M'
 'M' 'M' 'M' 'M' 'M' 'U' 'M' 'U' 'U' 'U' 'A' 'U' 'M' 'M' 'U' 'M' 'M' 'A'
 'U' 'U' 'M' 'M' 'U' 'U' 'M' 'U' 'M' 'U' 'A' 'U' 'U' 'U' 'U' 'M' 'M' 'M'
 'A' 'U' 'M' 'U' 'U' 'A' 'U' 'A' 'A' 'U' 'U' 'M' 'M' 'U' 'M' 'A' 'M' 'M'
 'M' 'A' 'U' 'M' 'U' 'A' 'A' 'A' 'A' 'U' 'A' 'A' 'A' 'A' 'U' 'U' 'U' 'M'
 'U' 'M' 'U' 'U' 'U' 'U' 'U' 'U' 'M' 'M' 'M' 'A' 'U' 'A' 'U' 'U' 'M' 'M'
 'U' 'A' 'U' 'U' 'U' 'U' 'A' 'A' 'M' 'A' 'U' 'A' 'M' 'U' 'A' 'U' 'A' 'M'
 'U' 'U' 'U' 'U' 'U' 'U' 'M' 'M' 'U' 'A' 'A' 'M' 'A' 'M' 'A' 'U' 'U' 'A']"
35801,1,119,50,69,79,1,0,"['A' 'U' 'A' 'U' 'M' 'U' 'A' 'U' 'U' 'A' 'A' 'U' 'A' 'U' 'U' 'M' 'U' 'M'
 'M' 'U' 'A' 'A' 'A' 'U' 'U' 'U' 'U' 'U' 'M' 'A' 'A' 'M' 'U' 'U' 'M' 'U'
 'U' 'M' 'M' 'M' 'A' 'U' 'M' 'M' 'A' 'U' 'U' 'M' 'M' 'A' 'M' 'M' 'M' 'U'
 'U' 'A' 'M' 'A' 'M' 'U' 'A' 'M' 'U' 'A' 'M' 'M' 'M' 'M' 'M' 'M' 'M' 'U'
 'M' 'M' 'M' 'M' 'U' 'M' 'M' 'U' 'A' 'U' 'A' 'U' 'M' 'M' 'M' 'M' 'M' 'A'
 'U' 'M' 'A' 'M' 'U' 'U' 'M' 'M' 'M' 'U' 'A' 'U' 'U' 'U' 'U' 'M' 'M' 'M'
 'A' 'U' 'U' 'A' 'U' 'A' 'U' 'A' 'A' 'U' 'U' 'M' 'M' 'U' 'U' 'U' 'U' 'M'
 'M' 'A' 'A' 'M' 'A' 'A' 'A' 'U' 'A' 'A' 'A' 'A' 'A' 'A' 'U' 'A' 'U' 'M'
 'A' 'M' 'U' 'U' 'U' 'U' 'U' 'U' 'M' 'M' 'U' 'M' 'U' 'U' 'U' 'U' 'M' 'M'
 'U' 'U' 'U' 'M' 'U' 'U' 'A' 'A' 'M' 'U' 'U' 'A' 'M' 'M' 'A' 'U' 'A' 'M'
 'A' 'U' 'U' 'M' 'U' 'M' 'M' 'M' 'U' 'U' 'A' 'M' 'A' 'M' 'U' 'U' 'U' 'A']"
35901,2,121,44,77,77,1,0,"['A' 'U' 'U' 'M' 'U' 'U' 'U' 'M' 'U' 'U' 'U' 'U' 'U' 'U' 'M' 'U' 'U' 'M'
 'M' 'M' 'A' 'A' 'A' 'M' 'M' 'U' 'M' 'A' 'U' 'U' 'U' 'M' 'U' 'U' 'M' 'U'
 'M' 'U' 'M' 'M' 'A' 'U' 'M' 'M' 'U' 'U' 'A' 'M' 'M' 'U' 'M' 'U' 'M' 'U'
 'U' 'A' 'M' 'A' 'M' 'M' 'M' 'U' 'U' 'A' 'M' 'U' 'M' 'M' 'M' 'M' 'M' 'M'
 'M' 'M' 'M' 'M' 'U' 'M' 'M' 'A' 'A' 'U' 'A' 'U' 'M' 'U' 'M' 'M' 'U' 'A'
 'A' 'M' 'A' 'U' 'U' 'U' 'M' 'U' 'M' 'M' 'A' 'U' 'U' 'M' 'U' 'M' 'M' 'M'
 'A' 'U' 'U' 'A' 'A' 'U' 'M' 'A' 'A' 'U' 'U' 'M' 'M' 'M' 'U' 'U' 'U' 'M'
 'M' 'U' 'A' 'M' 'A' 'A' 'A' 'A' 'A' 'A' 'U' 'A' 'A' 'A' 'U' 'U' 'U' 'M'
 'A' 'M' 'U' 'M' 'U' 'U' 'M' 'M' 'M' 'M' 'U' 'M' 'U' 'U' 'U' 'U' 'M' 'M'
 'U' 'U' 'A' 'M' 'A' 'U' 'A' 'A' 'M' 'U' 'U' 'A' 'M' 'M' 'A' 'U' 'A' 'M'
 'A' 'U' 'U' 'M' 'U' 'M' 'M' 'M' 'U' 'M' 'A' 'M' 'A' 'M' 'U' 'U' 'U' 'A']"
36001,3,119,47,72,79,0,0,"['A' 'U' 'U' 'M' 'U' 'U' 'U' 'M' 'M' 'U' 'M' 'U' 'U' 'U' 'U' 'U' 'U' 'U'
 'M' 'M' 'U' 'A' 'A' 'M' 'M' 'U' 'M' 'A' 'U' 'U' 'A' 'M' 'U' 'U' 'U' 'U'
 'M' 'A' 'M' 'U' 'A' 'U' 'M' 'M' 'U' 'U' 'A' 'U' 'M' 'U' 'U' 'U' 'M' 'U'
 'U' 'A' 'M' 'A' 'M' 'U' 'M' 'U' 'U' 'M' 'A' 'M' 'M' 'M' 'M' 'M' 'M' 'M'
 'U' 'M' 'M' 'M' 'U' 'M' 'M' 'A' 'U' 'M' 'A' 'U' 'M' 'U' 'A' 'M' 'U' 'A'
 'A' 'M' 'A' 'U' 'U' 'A' 'M' 'U' 'M' 'M' 'A' 'U' 'U' 'M' 'M' 'M' 'M' 'M'
 'A' 'U' 'U' 'A' 'A' 'U' 'M' 'A' 'A' 'U' 'U' 'M' 'M' 'M' 'M' 'U' 'A' 'M'
 'M' 'A' 'A' 'M' 'U' 'A' 'A' 'A' 'A' 'A' 'U' 'A' 'A' 'A' 'U' 'A' 'A' 'M'
 'A' 'U' 'U' 'M' 'U' 'U' 'U' 'M' 'U' 'M' 'U' 'M' 'U' 'U' 'U' 'M' 'M' 'M'
 'U' 'U' 'U' 'M' 'U' 'U' 'A' 'A' 'M' 'U' 'U' 'A' 'M' 'M' 'A' 'U' 'A' 'M'
 'A' 'U' 'U' 'M' 'U' 'U' 'M' 'M' 'U' 'M' 'A' 'M' 'A' 'U' 'U' 'M' 'M' 'A']"
36101,1,126,50,76,72,1,0,"['A' 'A' 'U' 'U' 'U' 'M' 'A' 'M' 'M' 'A' 'M' 'U' 'U' 'M' 'A' 'U' 'U' 'M'
 'M' 'M' 'U' 'A' 'A' 'M' 'M' 'M' 'M' 'U' 'U' 'A' 'A' 'U' 'U' 'U' 'U' 'U'
 'M' 'A' 'M' 'U' 'U' 'U' 'M' 'M' 'U' 'A' 'A' 'U' 'M' 'U' 'U' 'U' 'U' 'U'
 'U' 'U' 'M' 'A' 'M' 'M' 'M' 'U' 'M' 'M' 'A' 'M' 'M' 'U' 'M' 'M' 'M' 'M'
 'M' 'M' 'M' 'M' 'M' 'M' 'M' 'A' 'U' 'U' 'A' 'M' 'M' 'U' 'A' 'U' 'U' 'A'
 'A' 'M' 'U' 'U' 'U' 'A' 'M' 'U' 'M' 'M' 'U' 'U' 'U' 'M' 'M' 'M' 'U' 'M'
 'U' 'A' 'M' 'A' 'A' 'U' 'M' 'A' 'A' 'U' 'U' 'M' 'M' 'M' 'M' 'M' 'A' 'M'
 'M' 'A' 'A' 'M' 'U' 'A' 'A' 'A' 'A' 'A' 'A' 'A' 'A' 'A' 'A' 'A' 'A' 'M'
 'A' 'U' 'U' 'M' 'M' 'U' 'U' 'M' 'U' 'M' 'U' 'M' 'U' 'U' 'M' 'U' 'U' 'M'
 'U' 'U' 'M' 'M' 'A' 'U' 'U' 'A' 'U' 'U' 'U' 'U' 'M' 'M' 'A' 'M' 'U' 'M'
 'A' 'U' 'U' 'U' 'A' 'U' 'M' 'M' 'A' 'M' 'A' 'M' 'A' 'A' 'U' 'M' 'M' 'U']"
36201,0,123,37,86,75,1,0,"['A' 'A' 'U' 'U' 'U' 'M' 'A' 'M' 'M' 'A' 'M' 'U' 'U' 'M' 'A' 'U' 'U' 'M'
 'M' 'U' 'U' 'U' 'A' 'M' 'M' 'M' 'M' 'U' 'U' 'A' 'M' 'U' 'U' 'U' 'M' 'U'
 'M' 'A' 'M' 'M' 'U' 'U' 'M' 'M' 'U' 'M' 'A' 'U' 'M' 'U' 'U' 'U' 'U' 'A'
 'M' 'U' 'M' 'U' 'M' 'M' 'M' 'U' 'M' 'U' 'A' 'M' 'M' 'M' 'M' 'U' 'M' 'M'
 'M' 'M' 'M' 'M' 'M' 'M' 'M' 'A' 'M' 'M' 'U' 'M' 'M' 'U' 'U' 'U' 'U' 'A'
 'A' 'M' 'U' 'U' 'U' 'A' 'M' 'U' 'M' 'M' 'U' 'U' 'U' 'M' 'M' 'M' 'U' 'M'
 'U' 'A' 'U' 'U' 'U' 'U' 'M' 'U' 'U' 'U' 'U' 'M' 'M' 'M' 'U' 'M' 'U' 'M'
 'M' 'A' 'A' 'M' 'U' 'A' 'A' 'A' 'A' 'A' 'A' 'A' 'A' 'U' 'A' 'A' 'A' 'M'
 'A' 'U' 'U' 'M' 'M' 'U' 'A' 'M' 'U' 'M' 'U' 'M' 'U' 'U' 'U' 'U' 'U' 'U'
 'M' 'U' 'M' 'M' 'U' 'U' 'M' 'M' 'M' 'M' 'U' 'U' 'M' 'M' 'A' 'M' 'U' 'M'
 'M' 'U' 'M' 'M' 'A' 'U' 'M' 'M' 'A' 'M' 'A' 'M' 'A' 'U' 'M' 'M' 'M' 'A']"
36301,1,124,40,84,74,1,0,"['A' 'A' 'U' 'U' 'U' 'M' 'A' 'M' 'M' 'A' 'U' 'A' 'U' 'M' 'U' 'U' 'U' 'M'
 'M' 'M' 'U' 'U' 'A' 'M' 'M' 'M' 'M' 'U' 'M' 'A' 'M' 'U' 'U' 'U' 'M' 'U'
 'M' 'A' 'M' 'U' 'U' 'U' 'M' 'M' 'U' 'M' 'U' 'U' 'M' 'U' 'U' 'U' 'M' 'A'
 'M' 'U' 'M' 'U' 'M' 'M' 'M' 'U' 'M' 'U' 'U' 'M' 'M' 'U' 'M' 'M' 'M' 'M'
 'M' 'M' 'M' 'M' 'M' 'M' 'M' 'A' 'M' 'M' 'U' 'M' 'M' 'U' 'U' 'A' 'U' 'A'
 'A' 'M' 'A' 'U' 'M' 'A' 'M' 'M' 'M' 'M' 'U' 'U' 'U' 'U' 'M' 'M' 'U' 'M'
 'A' 'A' 'U' 'M' 'U' 'U' 'M' 'U' 'U' 'U' 'U' 'U' 'M' 'M' 'U' 'M' 'U' 'U'
 'M' 'A' 'A' 'M' 'A' 'U' 'A' 'A' 'A' 'A' 'A' 'A' 'A' 'U' 'A' 'A' 'A' 'M'
 'A' 'U' 'U' 'M' 'M' 'U' 'A' 'U' 'U' 'U' 'U' 'M' 'U' 'M' 'U' 'A' 'U' 'A'
 'M' 'U' 'M' 'M' 'U' 'U' 'M' 'U' 'M' 'M' 'M' 'M' 'U' 'M' 'U' 'A' 'M' 'M'
 'M' 'U' 'M' 'M' 'U' 'U' 'M' 'M' 'A' 'M' 'A' 'M' 'A' 'A' 'U' 'U' 'M' 'A']"
36401,1,118,41,77,80,0,0,"['A' 'A' 'U' 'U' 'U' 'M' 'A' 'M' 'M' 'U' 'A' 'A' 'M' 'M' 'A' 'U' 'U' 'U'
 'M' 'M' 'U' 'U' 'U' 'M' 'U' 'M' 'M' 'U' 'U' 'A' 'M' 'U' 'U' 'A' 'M' 'U'
 'M' 'A' 'M' 'U' 'U' 'U' 'U' 'U' 'M' 'M' 'M' 'U' 'M' 'U' 'U' 'U' 'M' 'A'
 'M' 'U' 'U' 'U' 'M' 'M' 'M' 'A' 'M' 'U' 'A' 'M' 'U' 'M' 'M' 'M' 'M' 'M'
 'M' 'M' 'M' 'U' 'M' 'M' 'M' 'A' 'M' 'M' 'A' 'M' 'M' 'U' 'U' 'U' 'U' 'A'
 'A' 'M' 'U' 'U' 'M' 'A' 'M' 'U' 'M' 'M' 'U' 'M' 'U' 'A' 'U' 'M' 'U' 'U'
 'U' 'U' 'A' 'M' 'U' 'U' 'M' 'M' 'M' 'U' 'U' 'U' 'U' 'M' 'U' 'M' 'U' 'U'
 'U' 'A' 'A' 'U' 'A' 'A' 'A' 'A' 'A' 'A' 'A' 'A' 'A' 'M' 'A' 'A' 'U' 'M'
 'A' 'M' 'U' 'M' 'U' 'M' 'A' 'M' 'U' 'U' 'U' 'M' 'U' 'M' 'U' 'U' 'M' 'A'
 'M' 'U' 'U' 'M' 'U' 'U' 'U' 'U' 'M' 'M' 'M' 'U' 'M' 'U' 'U' 'U' 'A' 'M'
 'M' 'U' 'M' 'A' 'U' 'U' 'M' 'M' 'A' 'M' 'U' 'M' 'A' 'A' 'U' 'M' 'M' 'A']"
36501,2,122,47,75,76,1,0,"['A' 'A' 'M' 'U' 'A' 'M' 'A' 'M' 'M' 'U' 'A' 'A' 'M' 'M' 'A' 'U' 'M' 'A'
 'U' 'M' 'U' 'U' 'U' 'M' 'U' 'U' 'A' 'U' 'U' 'U' 'M' 'U' 'U' 'A' 'M' 'U'
 'U' 'A' 'M' 'A' 'U' 'U' 'U' 'U' 'M' 'M' 'M' 'U' 'U' 'U' 'U' 'U' 'M' 'A'
 'M' 'U' 'M' 'A' 'M' 'M' 'M' 'A' 'M' 'U' 'A' 'M' 'M' 'M' 'M' 'M' 'M' 'M'
 'U' 'M' 'M' 'U' 'M' 'M' 'M' 'U' 'U' 'M' 'A' 'A' 'M' 'U' 'U' 'U' 'U' 'A'
 'A' 'M' 'A' 'U' 'M' 'A' 'M' 'U' 'M' 'M' 'U' 'M' 'M' 'U' 'M' 'M' 'U' 'U'
 'M' 'M' 'A' 'M' 'U' 'U' 'M' 'M' 'M' 'U' 'U' 'U' 'U' 'M' 'M' 'M' 'U' 'U'
 'U' 'A' 'A' 'U' 'A' 'A' 'A' 'A' 'A' 'A' 'A' 'M' 'U' 'M' 'U' 'A' 'M' 'M'
 'A' 'M' 'U' 'M' 'U' 'M' 'A' 'U' 'U' 'U' 'M' 'M' 'U' 'M' 'A' 'A' 'U' 'A'
 'M' 'M' 'U' 'M' 'U' 'U' 'U' 'U' 'M' 'U' 'A' 'A' 'A' 'U' 'U' 'U' 'A' 'U'
 'M' 'M' 'U' 'A' 'U' 'U' 'U' 'U' 'A' 'M' 'M' 'M' 'A' 'A' 'U' 'M' 'M' 'A']"
36601,2,124,58,66,74,1,0,"['A' 'A' 'M' 'U' 'A' 'U' 'A' 'U' 'M' 'A' 'U' 'A' 'M' 'U' 'A' 'A' 'M' 'A'
 'A' 'M' 'U' 'U' 'U' 'U' 'U' 'U' 'A' 'U' 'U' 'U' 'U' 'U' 'U' 'A' 'M' 'U'
 'U' 'A' 'M' 'A' 'U' 'M' 'U' 'M' 'M' 'U' 'M' 'A' 'U' 'A' 'U' 'A' 'M' 'A'
 'U' 'U' 'M' 'A' 'M' 'M' 'M' 'A' 'M' 'U' 'U' 'M' 'M' 'M' 'M' 'U' 'M' 'M'
 'M' 'M' 'M' 'U' 'M' 'M' 'M' 'A' 'U' 'U' 'A' 'A' 'U' 'M' 'U' 'U' 'U' 'A'
 'M' 'M' 'A' 'U' 'M' 'A' 'U' 'U' 'M' 'U' 'U' 'M' 'U' 'U' 'U' 'M' 'A' 'M'
 'U' 'U' 'A' 'M' 'M' 'U' 'M' 'M' 'U' 'U' 'M' 'U' 'U' 'M' 'U' 'M' 'M' 'U'
 'U' 'A' 'A' 'U' 'A' 'A' 'A' 'A' 'A' 'A' 'A' 'A' 'A' 'M' 'A' 'A' 'M' 'M'
 'A' 'M' 'A' 'M' 'U' 'M' 'A' 'U' 'U' 'U' 'M' 'M' 'M' 'U' 'A' 'M' 'U' 'A'
 'U' 'M' 'M' 'M' 'A' 'U' 'U' 'U' 'M' 'U' 'A' 'A' 'A' 'U' 'U' 'U' 'A' 'A'
 'M' 'M' 'U' 'A' 'A' 'U' 'U' 'U' 'A' 'M' 'M' 'M' 'A' 'A' 'U' 'M' 'M' 'A']"
36701,2,125,61,64,73,0,1,"['A' 'A' 'U' 'U' 'A' 'M' 'A' 'U' 'M' 'A' 'U' 'A' 'M' 'M' 'A' 'A' 'M' 'A'
 'A' 'M' 'U' 'U' 'U' 'U' 'U' 'A' 'U' 'U' 'M' 'U' 'U' 'A' 'U' 'A' 'M' 'M'
 'U' 'A' 'M' 'A' 'A' 'M' 'U' 'M' 'M' 'M' 'U' 'U' 'U' 'A' 'U' 'U' 'M' 'A'
 'U' 'U' 'M' 'A' 'M' 'M' 'M' 'A' 'M' 'M' 'U' 'M' 'M' 'U' 'M' 'M' 'M' 'M'
 'M' 'M' 'M' 'A' 'U' 'U' 'M' 'A' 'A' 'U' 'A' 'A' 'M' 'M' 'U' 'U' 'U' 'A'
 'M' 'A' 'U' 'U' 'M' 'A' 'U' 'U' 'M' 'U' 'U' 'M' 'U' 'U' 'U' 'M' 'U' 'M'
 'A' 'U' 'A' 'U' 'M' 'U' 'M' 'M' 'A' 'U' 'M' 'U' 'U' 'M' 'U' 'M' 'U' 'U'
 'U' 'A' 'U' 'U' 'U' 'A' 'A' 'A' 'A' 'A' 'A' 'A' 'A' 'M' 'U' 'A' 'M' 'M'
 'A' 'M' 'A' 'M' 'U' 'M' 'U' 'A' 'U' 'A' 'M' 'M' 'U' 'U' 'A' 'M' 'A' 'A'
 'A' 'M' 'M' 'M' 'A' 'U' 'U' 'U' 'A' 'U' 'U' 'U' 'A' 'U' 'U' 'A' 'A' 'A'
 'M' 'U' 'M' 'A' 'A' 'U' 'A' 'U' 'U' 'M' 'M' 'M' 'A' 'A' 'U' 'M' 'M' 'A']"
36801,0,135,65,70,63,0,1,"['A' 'A' 'U' 'U' 'U' 'M' 'A' 'U' 'M' 'A' 'U' 'A' 'M' 'M' 'A' 'A' 'M' 'A'
 'A' 'M' 'U' 'U' 'U' 'A' 'U' 'A' 'U' 'U' 'M' 'M' 'M' 'A' 'M' 'A' 'U' 'M'
 'U' 'A' 'M' 'U' 'A' 'M' 'U' 'M' 'M' 'M' 'M' 'U' 'U' 'A' 'M' 'M' 'M' 'U'
 'U' 'U' 'U' 'A' 'M' 'M' 'M' 'A' 'M' 'M' 'U' 'M' 'M' 'M' 'M' 'M' 'M' 'M'
 'U' 'M' 'M' 'A' 'U' 'U' 'M' 'U' 'U' 'U' 'A' 'A' 'U' 'M' 'A' 'A' 'M' 'A'
 'M' 'A' 'U' 'M' 'M' 'A' 'U' 'U' 'M' 'U' 'U' 'M' 'U' 'U' 'U' 'M' 'M' 'M'
 'A' 'M' 'A' 'M' 'M' 'U' 'A' 'M' 'A' 'U' 'M' 'U' 'M' 'M' 'M' 'U' 'U' 'A'
 'A' 'A' 'A' 'U' 'U' 'A' 'A' 'A' 'A' 'A' 'A' 'A' 'A' 'M' 'A' 'U' 'U' 'M'
 'A' 'M' 'A' 'M' 'U' 'U' 'A' 'A' 'A' 'U' 'U' 'M' 'U' 'U' 'A' 'M' 'A' 'A'
 'A' 'M' 'M' 'A' 'A' 'U' 'U' 'U' 'A' 'U' 'U' 'M' 'A' 'U' 'U' 'A' 'A' 'M'
 'M' 'A' 'M' 'A' 'A' 'U' 'A' 'M' 'U' 'M' 'M' 'M' 'A' 'A' 'U' 'U' 'M' 'A']"
36901,1,125,57,68,73,1,0,"['A' 'A' 'U' 'A' 'U' 'M' 'A' 'U' 'U' 'A' 'U' 'U' 'M' 'M' 'U' 'M' 'U' 'U'
 'A' 'M' 'M' 'U' 'A' 'A' 'U' 'U' 'U' 'M' 'M' 'M' 'M' 'A' 'M' 'A' 'U' 'U'
 'U' 'A' 'M' 'U' 'A' 'M' 'U' 'M' 'M' 'M' 'M' 'M' 'U' 'A' 'M' 'U' 'M' 'A'
 'U' 'U' 'U' 'U' 'M' 'M' 'M' 'A' 'M' 'M' 'M' 'M' 'M' 'M' 'M' 'M' 'M' 'M'
 'U' 'M' 'M' 'A' 'U' 'U' 'M' 'U' 'U' 'A' 'A' 'A' 'U' 'M' 'A' 'U' 'M' 'A'
 'M' 'A' 'M' 'M' 'U' 'A' 'U' 'U' 'M' 'U' 'U' 'U' 'A' 'U' 'U' 'M' 'M' 'M'
 'A' 'M' 'U' 'M' 'M' 'U' 'A' 'M' 'U' 'M' 'M' 'U' 'M' 'U' 'M' 'U' 'U' 'A'
 'U' 'A' 'A' 'M' 'U' 'U' 'A' 'A' 'A' 'A' 'A' 'A' 'A' 'A' 'A' 'U' 'A' 'M'
 'A' 'M' 'M' 'M' 'U' 'U' 'A' 'A' 'A' 'U' 'U' 'M' 'U' 'U' 'U' 'M' 'A' 'A'
 'A' 'U' 'M' 'A' 'A' 'U' 'U' 'M' 'A' 'U' 'U' 'U' 'A' 'A' 'U' 'A' 'A' 'M'
 'U' 'A' 'M' 'U' 'U' 'U' 'A' 'M' 'U' 'M' 'M' 'U' 'A' 'U' 'U' 'A' 'M' 'U']"
37001,2,122,52,70,76,0,0,"['A' 'A' 'U' 'A' 'U' 'M' 'A' 'M' 'U' 'A' 'M' 'U' 'M' 'M' 'U' 'M' 'M' 'A'
 'U' 'M' 'M' 'M' 'A' 'A' 'A' 'U' 'U' 'U' 'M' 'U' 'U' 'A' 'M' 'A' 'A' 'M'
 'U' 'A' 'M' 'U' 'A' 'U' 'U' 'M' 'M' 'A' 'U' 'M' 'U' 'A' 'M' 'M' 'M' 'A'
 'U' 'U' 'U' 'U' 'M' 'M' 'M' 'A' 'M' 'U' 'M' 'M' 'M' 'U' 'M' 'M' 'M' 'M'
 'M' 'M' 'M' 'U' 'M' 'U' 'M' 'U' 'U' 'A' 'U' 'A' 'A' 'M' 'A' 'U' 'M' 'A'
 'M' 'A' 'M' 'M' 'M' 'U' 'U' 'U' 'U' 'M' 'U' 'M' 'A' 'A' 'U' 'M' 'M' 'U'
 'U' 'U' 'U' 'M' 'M' 'M' 'A' 'U' 'U' 'M' 'M' 'U' 'M' 'U' 'M' 'A' 'U' 'A'
 'U' 'A' 'A' 'A' 'U' 'U' 'A' 'A' 'A' 'A' 'A' 'A' 'A' 'U' 'U' 'U' 'A' 'M'
 'A' 'M' 'M' 'M' 'U' 'U' 'A' 'U' 'A' 'U' 'U' 'M' 'U' 'U' 'U' 'M' 'U' 'U'
 'A' 'M' 'M' 'A' 'A' 'M' 'U' 'M' 'A' 'U' 'M' 'U' 'A' 'A' 'U' 'A' 'U' 'M'
 'U' 'A' 'M' 'U' 'M' 'M' 'U' 'M' 'U' 'U' 'M' 'U' 'U' 'U' 'U' 'A' 'U' 'U']"
37101,2,121,53,68,77,0,1,"['A' 'U' 'U' 'A' 'U' 'M' 'A' 'M' 'M' 'A' 'M' 'M' 'M' 'M' 'U' 'U' 'M' 'A'
 'U' 'M' 'U' 'M' 'U' 'A' 'A' 'U' 'U' 'U' 'M' 'A' 'M' 'A' 'M' 'A' 'A' 'M'
 'U' 'A' 'M' 'U' 'A' 'A' 'U' 'M' 'M' 'A' 'U' 'M' 'U' 'A' 'M' 'M' 'M' 'A'
 'U' 'U' 'U' 'U' 'M' 'M' 'M' 'A' 'M' 'U' 'U' 'M' 'U' 'M' 'M' 'M' 'M' 'M'
 'M' 'M' 'M' 'U' 'M' 'U' 'M' 'U' 'U' 'U' 'U' 'U' 'A' 'M' 'A' 'U' 'M' 'A'
 'M' 'A' 'M' 'M' 'A' 'M' 'U' 'U' 'M' 'M' 'U' 'U' 'U' 'U' 'U' 'M' 'U' 'U'
 'A' 'U' 'U' 'U' 'M' 'M' 'A' 'M' 'U' 'U' 'M' 'U' 'U' 'M' 'M' 'A' 'A' 'A'
 'M' 'A' 'A' 'U' 'A' 'A' 'A' 'A' 'A' 'A' 'A' 'A' 'A' 'U' 'U' 'M' 'A' 'M'
 'A' 'U' 'M' 'M' 'U' 'U' 'A' 'U' 'A' 'U' 'U' 'M' 'U' 'U' 'A' 'M' 'U' 'U'
 'U' 'U' 'M' 'A' 'U' 'M' 'U' 'A' 'U' 'M' 'M' 'U' 'A' 'A' 'U' 'A' 'A' 'M'
 'U' 'A' 'M' 'U' 'U' 'M' 'U' 'M' 'U' 'U' 'U' 'M' 'U' 'A' 'M' 'A' 'U' 'U']"
37201,1,116,55,61,82,0,1,"['A' 'A' 'U' 'A' 'M' 'M' 'U' 'U' 'M' 'A' 'M' 'U' 'M' 'U' 'U' 'U' 'M' 'A'
 'U' 'M' 'U' 'M' 'U' 'A' 'A' 'U' 'U' 'U' 'U' 'U' 'M' 'A' 'M' 'A' 'U' 'M'
 'U' 'A' 'M' 'M' 'U' 'A' 'U' 'U' 'M' 'A' 'U' 'M' 'U' 'A' 'M' 'U' 'M' 'A'
 'M' 'U' 'U' 'U' 'M' 'U' 'M' 'A' 'M' 'U' 'U' 'M' 'M' 'M' 'M' 'U' 'M' 'M'
 'M' 'M' 'M' 'U' 'A' 'U' 'U' 'U' 'A' 'U' 'U' 'U' 'A' 'M' 'A' 'A' 'M' 'A'
 'U' 'U' 'U' 'M' 'A' 'M' 'U' 'M' 'M' 'M' 'U' 'M' 'U' 'U' 'U' 'M' 'U' 'U'
 'A' 'U' 'A' 'M' 'M' 'U' 'A' 'M' 'A' 'U' 'M' 'A' 'U' 'U' 'M' 'A' 'A' 'A'
 'M' 'U' 'A' 'U' 'A' 'A' 'A' 'A' 'A' 'A' 'A' 'A' 'A' 'U' 'U' 'M' 'A' 'M'
 'A' 'U' 'U' 'M' 'U' 'U' 'U' 'U' 'A' 'U' 'U' 'M' 'U' 'U' 'A' 'M' 'U' 'U'
 'U' 'U' 'M' 'A' 'M' 'M' 'U' 'A' 'M' 'U' 'M' 'U' 'A' 'A' 'U' 'M' 'A' 'U'
 'M' 'A' 'M' 'U' 'U' 'M' 'A' 'A' 'U' 'U' 'U' 'M' 'U' 'A' 'M' 'A' 'U' 'A']"
37301,3,124,61,63,74,0,0,"['A' 'A' 'U' 'A' 'M' 'M' 'U' 'U' 'M' 'A' 'M' 'U' 'M' 'U' 'U' 'U' 'M' 'A'
 'U' 'M' 'A' 'M' 'M' 'A' 'A' 'A' 'A' 'U' 'U' 'U' 'M' 'A' 'M' 'U' 'U' 'M'
 'U' 'U' 'M' 'M' 'U' 'U' 'U' 'U' 'M' 'A' 'U' 'M' 'M' 'A' 'M' 'U' 'U' 'U'
 'U' 'U' 'U' 'U' 'M' 'U' 'M' 'A' 'U' 'U' 'U' 'M' 'M' 'M' 'M' 'U' 'M' 'M'
 'M' 'M' 'M' 'U' 'A' 'U' 'A' 'U' 'A' 'U' 'U' 'U' 'A' 'M' 'A' 'A' 'M' 'A'
 'U' 'U' 'A' 'M' 'A' 'M' 'U' 'M' 'M' 'M' 'U' 'U' 'U' 'M' 'U' 'M' 'A' 'U'
 'A' 'U' 'A' 'M' 'M' 'U' 'A' 'M' 'A' 'A' 'M' 'A' 'M' 'M' 'M' 'A' 'A' 'A'
 'M' 'U' 'U' 'M' 'A' 'A' 'A' 'A' 'A' 'A' 'A' 'A' 'A' 'M' 'U' 'M' 'A' 'U'
 'A' 'A' 'U' 'U' 'A' 'U' 'A' 'U' 'U' 'U' 'A' 'M' 'A' 'U' 'A' 'M' 'U' 'M'
 'M' 'U' 'M' 'A' 'M' 'U' 'U' 'A' 'M' 'U' 'M' 'A' 'A' 'M' 'U' 'M' 'U' 'U'
 'M' 'A' 'M' 'U' 'U' 'M' 'A' 'A' 'A' 'U' 'U' 'U' 'U' 'A' 'M' 'A' 'U' 'A']"
37401,1,129,57,72,69,0,0,"['A' 'A' 'U' 'U' 'M' 'M' 'U' 'M' 'M' 'U' 'M' 'M' 'M' 'U' 'U' 'U' 'M' 'A'
 'U' 'U' 'A' 'A' 'M' 'A' 'A' 'A' 'A' 'U' 'U' 'U' 'M' 'A' 'M' 'U' 'A' 'M'
 'A' 'M' 'U' 'M' 'U' 'A' 'U' 'U' 'M' 'A' 'U' 'M' 'M' 'A' 'M' 'U' 'M' 'U'
 'U' 'A' 'U' 'U' 'M' 'M' 'M' 'U' 'U' 'U' 'M' 'U' 'M' 'M' 'M' 'M' 'M' 'M'
 'M' 'M' 'M' 'U' 'A' 'U' 'A' 'U' 'U' 'U' 'U' 'U' 'A' 'M' 'A' 'A' 'M' 'U'
 'U' 'U' 'A' 'M' 'A' 'M' 'U' 'M' 'M' 'M' 'U' 'U' 'A' 'U' 'U' 'M' 'A' 'U'
 'A' 'U' 'U' 'M' 'M' 'U' 'A' 'M' 'A' 'A' 'M' 'A' 'M' 'M' 'M' 'A' 'A' 'A'
 'M' 'A' 'U' 'U' 'A' 'A' 'A' 'A' 'A' 'A' 'A' 'A' 'A' 'M' 'M' 'U' 'A' 'M'
 'A' 'A' 'U' 'U' 'A' 'M' 'A' 'U' 'M' 'M' 'U' 'M' 'U' 'M' 'A' 'M' 'U' 'M'
 'M' 'U' 'M' 'A' 'M' 'U' 'A' 'A' 'M' 'U' 'M' 'A' 'U' 'U' 'M' 'M' 'U' 'M'
 'M' 'M' 'M' 'M' 'U' 'M' 'A' 'U' 'U' 'U' 'U' 'U' 'U' 'A' 'M' 'A' 'U' 'A']"
37501,1,124,57,67,74,0,0,"['A' 'U' 'M' 'U' 'M' 'M' 'U' 'U' 'M' 'U' 'M' 'M' 'M' 'U' 'A' 'U' 'M' 'A'
 'U' 'U' 'A' 'A' 'M' 'A' 'A' 'A' 'U' 'U' 'U' 'A' 'M' 'U' 'M' 'A' 'U' 'M'
 'A' 'M' 'U' 'M' 'U' 'A' 'A' 'M' 'M' 'A' 'U' 'M' 'U' 'A' 'U' 'M' 'M' 'U'
 'A' 'A' 'U' 'U' 'M' 'M' 'M' 'U' 'A' 'U' 'M' 'M' 'M' 'M' 'M' 'M' 'M' 'M'
 'U' 'M' 'M' 'U' 'U' 'U' 'A' 'U' 'A' 'U' 'U' 'A' 'A' 'M' 'A' 'A' 'M' 'U'
 'U' 'U' 'A' 'M' 'U' 'M' 'A' 'U' 'U' 'M' 'U' 'M' 'A' 'U' 'U' 'M' 'A' 'M'
 'A' 'M' 'U' 'A' 'U' 'A' 'A' 'M' 'A' 'A' 'M' 'U' 'M' 'U' 'U' 'U' 'A' 'A'
 'M' 'U' 'U' 'U' 'A' 'A' 'A' 'A' 'A' 'A' 'A' 'A' 'A' 'M' 'M' 'A' 'A' 'M'
 'U' 'A' 'U' 'M' 'U' 'M' 'A' 'U' 'M' 'M' 'U' 'U' 'U' 'M' 'A' 'M' 'U' 'M'
 'M' 'U' 'U' 'A' 'M' 'U' 'A' 'A' 'A' 'U' 'M' 'U' 'U' 'U' 'U' 'M' 'M' 'M'
 'M' 'M' 'M' 'M' 'U' 'U' 'A' 'U' 'U' 'U' 'M' 'U' 'U' 'U' 'M' 'A' 'U' 'A']"
37601,2,128,66,62,70,1,0,"['A' 'U' 'M' 'U' 'M' 'M' 'U' 'U' 'U' 'U' 'M' 'M' 'M' 'U' 'A' 'U' 'M' 'U'
 'A' 'A' 'A' 'A' 'A' 'A' 'A' 'A' 'U' 'U' 'M' 'U' 'U' 'U' 'M' 'A' 'U' 'M'
 'U' 'M' 'A' 'A' 'A' 'A' 'A' 'M' 'M' 'A' 'M' 'M' 'U' 'A' 'U' 'M' 'M' 'U'
 'A' 'U' 'U' 'A' 'M' 'M' 'M' 'U' 'A' 'U' 'M' 'M' 'M' 'M' 'M' 'M' 'U' 'M'
 'M' 'M' 'M' 'U' 'A' 'U' 'U' 'U' 'A' 'M' 'U' 'A' 'A' 'M' 'A' 'A' 'M' 'U'
 'A' 'U' 'A' 'M' 'U' 'M' 'U' 'U' 'A' 'M' 'U' 'M' 'A' 'U' 'U' 'M' 'A' 'A'
 'A' 'M' 'A' 'A' 'U' 'U' 'A' 'M' 'A' 'A' 'M' 'U' 'M' 'M' 'U' 'M' 'A' 'A'
 'M' 'U' 'U' 'U' 'A' 'A' 'A' 'A' 'A' 'A' 'A' 'A' 'A' 'U' 'M' 'A' 'A' 'M'
 'U' 'A' 'U' 'M' 'M' 'M' 'A' 'U' 'U' 'M' 'U' 'U' 'U' 'M' 'A' 'M' 'A' 'M'
 'M' 'U' 'U' 'A' 'U' 'U' 'A' 'A' 'A' 'U' 'M' 'A' 'U' 'U' 'U' 'M' 'M' 'U'
 'M' 'M' 'U' 'M' 'U' 'A' 'U' 'A' 'U' 'U' 'M' 'A' 'U' 'U' 'U' 'A' 'U' 'A']"
37701,4,122,64,58,76,0,1,"['A' 'U' 'U' 'U' 'M' 'U' 'A' 'U' 'U' 'M' 'M' 'M' 'U' 'U' 'U' 'U' 'M' 'U'
 'U' 'A' 'A' 'A' 'A' 'A' 'A' 'A' 'U' 'U' 'U' 'U' 'U' 'U' 'M' 'U' 'U' 'M'
 'U' 'U' 'A' 'A' 'A' 'A' 'A' 'A' 'U' 'A' 'M' 'M' 'M' 'A' 'U' 'U' 'M' 'U'
 'A' 'M' 'A' 'A' 'M' 'M' 'M' 'A' 'A' 'A' 'M' 'M' 'M' 'U' 'M' 'M' 'M' 'M'
 'M' 'M' 'M' 'M' 'U' 'U' 'U' 'A' 'A' 'U' 'U' 'U' 'A' 'M' 'A' 'A' 'M' 'U'
 'U' 'U' 'A' 'M' 'A' 'M' 'U' 'U' 'A' 'M' 'U' 'M' 'A' 'U' 'M' 'M' 'A' 'A'
 'A' 'U' 'A' 'A' 'M' 'U' 'A' 'U' 'U' 'A' 'M' 'U' 'M' 'M' 'U' 'M' 'A' 'A'
 'U' 'U' 'M' 'U' 'A' 'A' 'A' 'A' 'A' 'A' 'A' 'A' 'A' 'M' 'M' 'A' 'A' 'U'
 'U' 'A' 'U' 'M' 'U' 'M' 'A' 'U' 'U' 'M' 'M' 'U' 'U' 'M' 'A' 'M' 'U' 'U'
 'M' 'U' 'U' 'A' 'U' 'U' 'A' 'U' 'U' 'U' 'M' 'A' 'U' 'U' 'U' 'M' 'M' 'U'
 'M' 'M' 'M' 'M' 'A' 'A' 'M' 'A' 'U' 'U' 'M' 'A' 'U' 'U' 'U' 'A' 'U' 'A']"
37801,4,119,64,55,79,1,0,"['A' 'U' 'U' 'U' 'M' 'U' 'U' 'U' 'U' 'M' 'M' 'M' 'U' 'U' 'U' 'A' 'U' 'U'
 'M' 'U' 'A' 'U' 'A' 'A' 'A' 'A' 'U' 'U' 'A' 'U' 'U' 'A' 'M' 'U' 'A' 'U'
 'U' 'U' 'A' 'A' 'A' 'A' 'A' 'A' 'U' 'U' 'M' 'U' 'M' 'A' 'U' 'M' 'M' 'M'
 'U' 'M' 'A' 'A' 'U' 'U' 'M' 'A' 'A' 'A' 'A' 'M' 'M' 'U' 'M' 'M' 'M' 'M'
 'M' 'M' 'M' 'U' 'U' 'U' 'M' 'A' 'A' 'U' 'U' 'U' 'A' 'M' 'A' 'A' 'M' 'M'
 'U' 'U' 'A' 'M' 'U' 'M' 'U' 'U' 'A' 'M' 'M' 'M' 'A' 'A' 'M' 'M' 'U' 'A'
 'A' 'U' 'A' 'A' 'M' 'A' 'A' 'U' 'U' 'A' 'M' 'M' 'M' 'U' 'U' 'M' 'U' 'U'
 'U' 'U' 'U' 'U' 'A' 'A' 'A' 'A' 'A' 'A' 'A' 'A' 'A' 'M' 'U' 'A' 'A' 'U'
 'U' 'U' 'U' 'M' 'U' 'M' 'U' 'U' 'U' 'U' 'M' 'U' 'U' 'M' 'A' 'M' 'A' 'U'
 'M' 'U' 'U' 'A' 'U' 'U' 'A' 'U' 'A' 'U' 'U' 'A' 'A' 'U' 'M' 'U' 'U' 'M'
 'M' 'M' 'M' 'M' 'A' 'A' 'M' 'A' 'U' 'M' 'M' 'A' 'U' 'A' 'U' 'A' 'M' 'A']"
37901,0,117,65,52,81,1,0,"['A' 'U' 'U' 'M' 'M' 'U' 'U' 'U' 'U' 'M' 'U' 'M' 'U' 'M' 'U' 'U' 'M' 'U'
 'M' 'U' 'A' 'A' 'A' 'A' 'A' 'A' 'M' 'U' 'A' 'A' 'U' 'A' 'M' 'U' 'A' 'U'
 'U' 'M' 'U' 'A' 'A' 'U' 'A' 'A' 'U' 'U' 'M' 'U' 'M' 'A' 'U' 'U' 'M' 'M'
 'U' 'M' 'A' 'A' 'U' 'A' 'A' 'A' 'A' 'A' 'A' 'M' 'M' 'M' 'M' 'M' 'M' 'M'
 'U' 'M' 'M' 'U' 'U' 'M' 'M' 'A' 'U' 'U' 'U' 'U' 'A' 'M' 'A' 'A' 'M' 'U'
 'U' 'U' 'U' 'M' 'U' 'M' 'M' 'U' 'A' 'M' 'M' 'M' 'A' 'A' 'U' 'U' 'U' 'A'
 'A' 'A' 'A' 'A' 'M' 'A' 'A' 'A' 'A' 'A' 'U' 'M' 'M' 'U' 'U' 'U' 'U' 'A'
 'U' 'U' 'U' 'U' 'A' 'A' 'A' 'A' 'A' 'A' 'A' 'A' 'A' 'U' 'U' 'U' 'A' 'U'
 'U' 'U' 'A' 'M' 'U' 'M' 'U' 'M' 'U' 'U' 'M' 'U' 'A' 'M' 'A' 'U' 'A' 'U'
 'A' 'U' 'M' 'A' 'U' 'U' 'A' 'U' 'A' 'U' 'U' 'A' 'A' 'U' 'M' 'U' 'U' 'M'
 'M' 'M' 'U' 'U' 'U' 'A' 'M' 'M' 'U' 'M' 'M' 'U' 'U' 'A' 'U' 'U' 'M' 'A']"
38001,2,118,63,55,80,0,1,"['A' 'U' 'U' 'M' 'U' 'U' 'A' 'U' 'M' 'M' 'U' 'M' 'U' 'U' 'U' 'U' 'M' 'U'
 'M' 'U' 'A' 'A' 'A' 'A' 'A' 'A' 'U' 'U' 'A' 'A' 'M' 'A' 'M' 'U' 'A' 'U'
 'U' 'M' 'U' 'A' 'A' 'U' 'A' 'A' 'M' 'U' 'M' 'U' 'U' 'A' 'U' 'A' 'U' 'M'
 'M' 'U' 'U' 'A' 'U' 'U' 'A' 'A' 'A' 'A' 'A' 'M' 'U' 'M' 'M' 'M' 'M' 'M'
 'M' 'M' 'M' 'U' 'M' 'M' 'U' 'A' 'U' 'U' 'U' 'U' 'M' 'M' 'U' 'A' 'M' 'U'
 'U' 'U' 'U' 'U' 'U' 'M' 'M' 'U' 'U' 'M' 'M' 'M' 'M' 'A' 'U' 'U' 'U' 'U'
 'A' 'A' 'A' 'A' 'U' 'A' 'A' 'A' 'A' 'A' 'U' 'M' 'M' 'U' 'U' 'A' 'U' 'U'
 'U' 'U' 'U' 'A' 'A' 'A' 'A' 'A' 'A' 'A' 'A' 'A' 'A' 'M' 'U' 'A' 'A' 'M'
 'A' 'U' 'A' 'M' 'A' 'M' 'M' 'M' 'U' 'A' 'M' 'U' 'A' 'M' 'A' 'U' 'A' 'U'
 'A' 'M' 'M' 'U' 'U' 'U' 'U' 'U' 'A' 'U' 'U' 'A' 'A' 'U' 'M' 'A' 'U' 'M'
 'M' 'M' 'U' 'U' 'U' 'M' 'M' 'M' 'U' 'M' 'M' 'U' 'U' 'A' 'U' 'U' 'M' 'A']"
38101,1,127,62,65,71,0,1,"['A' 'U' 'M' 'M' 'U' 'U' 'M' 'U' 'M' 'U' 'M' 'M' 'A' 'A' 'U' 'U' 'M' 'U'
 'M' 'U' 'A' 'U' 'A' 'A' 'A' 'A' 'A' 'U' 'U' 'A' 'M' 'A' 'M' 'U' 'U' 'M'
 'U' 'M' 'U' 'A' 'A' 'U' 'U' 'A' 'M' 'U' 'M' 'U' 'U' 'U' 'M' 'A' 'U' 'U'
 'M' 'U' 'U' 'A' 'U' 'U' 'A' 'U' 'A' 'A' 'A' 'U' 'M' 'M' 'M' 'M' 'M' 'M'
 'M' 'M' 'M' 'U' 'M' 'M' 'U' 'U' 'M' 'M' 'U' 'U' 'M' 'M' 'U' 'A' 'M' 'M'
 'M' 'U' 'U' 'M' 'U' 'M' 'M' 'U' 'M' 'M' 'A' 'M' 'M' 'A' 'A' 'U' 'U' 'U'
 'A' 'A' 'A' 'A' 'U' 'A' 'A' 'M' 'A' 'A' 'U' 'M' 'U' 'U' 'U' 'A' 'U' 'M'
 'U' 'U' 'U' 'A' 'A' 'A' 'A' 'A' 'A' 'A' 'A' 'A' 'A' 'M' 'U' 'A' 'A' 'M'
 'A' 'U' 'A' 'M' 'A' 'M' 'M' 'M' 'U' 'A' 'M' 'U' 'U' 'M' 'U' 'A' 'A' 'U'
 'A' 'M' 'M' 'U' 'U' 'A' 'U' 'A' 'A' 'U' 'U' 'A' 'A' 'U' 'M' 'A' 'U' 'M'
 'M' 'M' 'U' 'U' 'A' 'U' 'M' 'M' 'U' 'M' 'M' 'A' 'M' 'A' 'U' 'M' 'M' 'A']"
38201,1,133,67,66,65,1,0,"['A' 'U' 'M' 'M' 'U' 'U' 'M' 'U' 'M' 'A' 'M' 'M' 'A' 'A' 'M' 'A' 'U' 'M'
 'M' 'U' 'A' 'M' 'U' 'A' 'A' 'A' 'A' 'U' 'U' 'A' 'U' 'A' 'M' 'U' 'U' 'M'
 'A' 'M' 'U' 'A' 'A' 'A' 'U' 'A' 'M' 'M' 'M' 'U' 'A' 'M' 'M' 'A' 'U' 'U'
 'M' 'A' 'U' 'A' 'U' 'U' 'A' 'U' 'A' 'A' 'A' 'M' 'M' 'M' 'M' 'M' 'M' 'M'
 'U' 'M' 'M' 'U' 'M' 'M' 'U' 'M' 'U' 'U' 'U' 'A' 'M' 'M' 'M' 'A' 'M' 'U'
 'M' 'U' 'U' 'M' 'U' 'U' 'M' 'U' 'A' 'M' 'A' 'M' 'M' 'A' 'A' 'U' 'U' 'M'
 'A' 'A' 'A' 'A' 'U' 'A' 'U' 'M' 'A' 'A' 'U' 'M' 'M' 'A' 'M' 'M' 'U' 'U'
 'U' 'U' 'U' 'A' 'U' 'A' 'A' 'A' 'A' 'A' 'A' 'A' 'A' 'U' 'M' 'M' 'A' 'A'
 'A' 'U' 'U' 'M' 'A' 'M' 'M' 'M' 'U' 'A' 'M' 'U' 'A' 'A' 'U' 'A' 'A' 'U'
 'U' 'M' 'M' 'A' 'M' 'A' 'U' 'A' 'A' 'U' 'A' 'A' 'U' 'U' 'M' 'A' 'M' 'M'
 'U' 'M' 'U' 'M' 'U' 'U' 'M' 'M' 'A' 'M' 'U' 'A' 'U' 'A' 'U' 'M' 'U' 'U']"
38301,1,131,64,67,67,0,0,"['A' 'U' 'M' 'U' 'U' 'U' 'M' 'U' 'M' 'A' 'M' 'M' 'A' 'A' 'M' 'A' 'U' 'U'
 'U' 'U' 'A' 'A' 'U' 'A' 'U' 'A' 'U' 'U' 'U' 'A' 'U' 'A' 'M' 'U' 'U' 'M'
 'U' 'M' 'M' 'A' 'A' 'A' 'M' 'U' 'M' 'M' 'U' 'A' 'A' 'U' 'M' 'A' 'M' 'U'
 'M' 'A' 'M' 'A' 'M' 'U' 'A' 'U' 'A' 'A' 'A' 'M' 'M' 'M' 'M' 'U' 'M' 'M'
 'M' 'M' 'M' 'U' 'M' 'M' 'M' 'M' 'M' 'U' 'U' 'A' 'M' 'M' 'M' 'A' 'M' 'U'
 'M' 'U' 'U' 'M' 'U' 'A' 'M' 'U' 'A' 'M' 'A' 'M' 'U' 'A' 'U' 'U' 'A' 'M'
 'A' 'A' 'A' 'A' 'U' 'A' 'U' 'U' 'A' 'A' 'U' 'M' 'M' 'A' 'M' 'M' 'U' 'U'
 'A' 'M' 'M' 'A' 'U' 'A' 'A' 'A' 'A' 'A' 'A' 'U' 'A' 'M' 'U' 'M' 'A' 'A'
 'A' 'U' 'U' 'M' 'A' 'U' 'M' 'M' 'U' 'U' 'M' 'M' 'A' 'A' 'U' 'A' 'A' 'U'
 'U' 'U' 'M' 'U' 'M' 'A' 'U' 'A' 'U' 'U' 'A' 'A' 'A' 'U' 'M' 'A' 'M' 'M'
 'M' 'M' 'U' 'M' 'U' 'U' 'M' 'U' 'A' 'M' 'U' 'A' 'M' 'A' 'U' 'M' 'U' 'U']"
38401,3,123,60,63,75,1,0,"['A' 'A' 'M' 'U' 'M' 'U' 'M' 'U' 'M' 'A' 'M' 'M' 'A' 'U' 'A' 'U' 'U' 'U'
 'U' 'U' 'A' 'A' 'U' 'A' 'U' 'A' 'U' 'U' 'M' 'A' 'A' 'A' 'M' 'U' 'U' 'M'
 'U' 'M' 'M' 'A' 'A' 'A' 'M' 'U' 'M' 'M' 'A' 'A' 'A' 'U' 'U' 'A' 'M' 'U'
 'U' 'A' 'M' 'A' 'M' 'U' 'A' 'A' 'U' 'A' 'A' 'M' 'M' 'M' 'M' 'M' 'U' 'M'
 'M' 'M' 'M' 'U' 'U' 'U' 'M' 'U' 'M' 'M' 'A' 'A' 'M' 'U' 'M' 'A' 'M' 'U'
 'M' 'U' 'U' 'U' 'U' 'A' 'M' 'U' 'A' 'M' 'A' 'M' 'A' 'A' 'M' 'U' 'U' 'M'
 'A' 'A' 'A' 'U' 'A' 'U' 'M' 'U' 'M' 'A' 'U' 'M' 'M' 'A' 'M' 'M' 'U' 'U'
 'A' 'M' 'U' 'A' 'U' 'A' 'A' 'A' 'A' 'U' 'A' 'A' 'A' 'M' 'M' 'U' 'A' 'U'
 'A' 'U' 'U' 'M' 'A' 'U' 'M' 'M' 'U' 'U' 'U' 'M' 'A' 'A' 'M' 'A' 'U' 'A'
 'U' 'U' 'M' 'U' 'M' 'A' 'U' 'A' 'U' 'M' 'U' 'A' 'U' 'M' 'M' 'U' 'U' 'M'
 'U' 'M' 'U' 'M' 'U' 'U' 'M' 'U' 'A' 'M' 'U' 'U' 'M' 'A' 'U' 'U' 'U' 'U']"
38501,2,121,56,65,77,1,0,"['A' 'A' 'U' 'M' 'M' 'A' 'U' 'A' 'M' 'U' 'M' 'M' 'U' 'U' 'A' 'M' 'U' 'U'
 'U' 'M' 'A' 'A' 'U' 'A' 'U' 'A' 'U' 'A' 'U' 'A' 'U' 'A' 'M' 'M' 'U' 'M'
 'U' 'M' 'M' 'A' 'A' 'U' 'U' 'M' 'M' 'M' 'A' 'A' 'A' 'U' 'U' 'A' 'M' 'U'
 'U' 'A' 'M' 'A' 'M' 'A' 'A' 'U' 'U' 'A' 'U' 'M' 'M' 'M' 'M' 'M' 'M' 'U'
 'M' 'M' 'M' 'U' 'U' 'M' 'M' 'U' 'U' 'U' 'A' 'U' 'M' 'U' 'M' 'U' 'U' 'U'
 'M' 'U' 'U' 'U' 'U' 'A' 'M' 'U' 'A' 'M' 'A' 'M' 'A' 'U' 'U' 'U' 'M' 'U'
 'U' 'A' 'A' 'M' 'U' 'U' 'M' 'U' 'M' 'A' 'U' 'M' 'M' 'A' 'M' 'U' 'U' 'U'
 'A' 'M' 'U' 'A' 'U' 'A' 'A' 'A' 'A' 'A' 'A' 'A' 'A' 'M' 'M' 'U' 'A' 'U'
 'A' 'U' 'U' 'M' 'A' 'U' 'M' 'M' 'M' 'U' 'U' 'M' 'U' 'U' 'M' 'A' 'U' 'A'
 'U' 'U' 'M' 'U' 'M' 'A' 'A' 'A' 'M' 'M' 'A' 'A' 'U' 'M' 'M' 'U' 'U' 'M'
 'A' 'M' 'M' 'M' 'M' 'U' 'M' 'M' 'A' 'M' 'A' 'U' 'U' 'A' 'U' 'U' 'U' 'U']"
38601,3,120,51,69,78,1,0,"['A' 'A' 'U' 'M' 'M' 'A' 'U' 'A' 'M' 'A' 'M' 'M' 'U' 'U' 'U' 'M' 'U' 'U'
 'U' 'M' 'U' 'A' 'U' 'U' 'U' 'A' 'M' 'A' 'U' 'A' 'U' 'A' 'M' 'M' 'M' 'M'
 'U' 'U' 'M' 'A' 'A' 'U' 'U' 'M' 'M' 'M' 'A' 'A' 'A' 'U' 'U' 'U' 'M' 'U'
 'U' 'U' 'M' 'A' 'M' 'A' 'A' 'A' 'U' 'A' 'U' 'M' 'M' 'M' 'M' 'M' 'M' 'M'
 'U' 'M' 'M' 'M' 'A' 'M' 'U' 'U' 'U' 'A' 'A' 'U' 'M' 'M' 'M' 'U' 'U' 'M'
 'M' 'U' 'M' 'U' 'U' 'U' 'M' 'U' 'U' 'U' 'A' 'U' 'A' 'U' 'U' 'U' 'U' 'U'
 'M' 'A' 'A' 'M' 'M' 'U' 'M' 'M' 'M' 'A' 'A' 'M' 'M' 'A' 'M' 'U' 'U' 'U'
 'A' 'M' 'U' 'A' 'U' 'A' 'A' 'A' 'A' 'A' 'A' 'A' 'A' 'U' 'M' 'U' 'A' 'U'
 'A' 'U' 'U' 'U' 'U' 'U' 'M' 'M' 'M' 'U' 'A' 'M' 'U' 'U' 'M' 'A' 'A' 'A'
 'U' 'U' 'M' 'U' 'M' 'A' 'U' 'U' 'M' 'M' 'A' 'A' 'U' 'M' 'M' 'M' 'U' 'M'
 'U' 'M' 'M' 'U' 'U' 'U' 'M' 'M' 'A' 'M' 'A' 'U' 'U' 'M' 'M' 'U' 'M' 'U']"
38701,2,118,53,65,80,0,0,"['A' 'A' 'U' 'A' 'M' 'U' 'U' 'A' 'M' 'U' 'M' 'M' 'U' 'U' 'U' 'M' 'A' 'U'
 'U' 'M' 'U' 'A' 'U' 'U' 'U' 'A' 'M' 'A' 'A' 'A' 'U' 'A' 'M' 'M' 'M' 'M'
 'U' 'A' 'M' 'A' 'U' 'U' 'U' 'M' 'M' 'M' 'U' 'A' 'A' 'U' 'U' 'U' 'M' 'U'
 'A' 'U' 'M' 'U' 'U' 'A' 'A' 'A' 'U' 'A' 'U' 'M' 'U' 'M' 'M' 'M' 'M' 'M'
 'M' 'M' 'M' 'M' 'A' 'M' 'U' 'U' 'U' 'A' 'A' 'M' 'M' 'A' 'M' 'U' 'U' 'M'
 'M' 'A' 'M' 'U' 'U' 'U' 'M' 'U' 'U' 'U' 'A' 'U' 'A' 'U' 'U' 'U' 'M' 'U'
 'U' 'A' 'A' 'U' 'M' 'U' 'M' 'M' 'M' 'A' 'A' 'M' 'M' 'U' 'M' 'U' 'U' 'U'
 'U' 'M' 'U' 'U' 'U' 'A' 'U' 'A' 'A' 'U' 'A' 'A' 'A' 'U' 'A' 'A' 'A' 'U'
 'A' 'U' 'U' 'A' 'U' 'A' 'M' 'M' 'M' 'A' 'A' 'M' 'U' 'U' 'M' 'A' 'A' 'A'
 'U' 'U' 'U' 'U' 'M' 'A' 'U' 'U' 'M' 'M' 'A' 'A' 'U' 'M' 'M' 'M' 'U' 'U'
 'U' 'M' 'M' 'U' 'U' 'M' 'M' 'M' 'A' 'M' 'A' 'U' 'U' 'M' 'M' 'M' 'M' 'U']"
38801,3,110,52,58,88,0,0,"['A' 'A' 'U' 'A' 'M' 'U' 'A' 'U' 'M' 'U' 'M' 'U' 'M' 'U' 'U' 'M' 'A' 'U'
 'U' 'M' 'A' 'U' 'U' 'U' 'U' 'A' 'U' 'A' 'A' 'A' 'U' 'U' 'M' 'M' 'U' 'M'
 'U' 'A' 'M' 'A' 'U' 'U' 'U' 'M' 'M' 'M' 'U' 'A' 'U' 'U' 'U' 'U' 'M' 'M'
 'A' 'U' 'M' 'M' 'U' 'U' 'A' 'A' 'U' 'A' 'U' 'M' 'M' 'M' 'U' 'M' 'M' 'M'
 'M' 'M' 'M' 'M' 'A' 'M' 'A' 'U' 'M' 'A' 'A' 'U' 'M' 'A' 'M' 'U' 'U' 'U'
 'U' 'A' 'M' 'U' 'A' 'U' 'U' 'U' 'U' 'U' 'A' 'U' 'U' 'U' 'U' 'U' 'U' 'A'
 'A' 'U' 'A' 'U' 'M' 'U' 'U' 'M' 'M' 'A' 'A' 'U' 'U' 'U' 'M' 'U' 'A' 'M'
 'U' 'M' 'A' 'U' 'U' 'A' 'A' 'A' 'A' 'A' 'A' 'A' 'A' 'U' 'A' 'U' 'A' 'U'
 'A' 'A' 'U' 'A' 'U' 'M' 'M' 'M' 'M' 'U' 'A' 'U' 'M' 'M' 'U' 'A' 'A' 'A'
 'U' 'M' 'A' 'U' 'M' 'U' 'U' 'U' 'U' 'M' 'A' 'A' 'U' 'M' 'U' 'M' 'U' 'U'
 'U' 'M' 'M' 'U' 'U' 'M' 'M' 'M' 'U' 'M' 'U' 'U' 'U' 'M' 'M' 'U' 'M' 'U']"
38901,7,121,57,64,77,0,1,"['A' 'A' 'U' 'A' 'M' 'U' 'A' 'U' 'M' 'U' 'M' 'U' 'M' 'A' 'U' 'U' 'A' 'A'
 'U' 'M' 'A' 'U' 'U' 'U' 'U' 'A' 'U' 'A' 'U' 'A' 'M' 'U' 'M' 'U' 'U' 'M'
 'M' 'A' 'M' 'A' 'A' 'A' 'M' 'U' 'M' 'M' 'U' 'A' 'M' 'A' 'U' 'M' 'U' 'M'
 'A' 'U' 'M' 'M' 'U' 'U' 'A' 'A' 'U' 'A' 'U' 'M' 'M' 'M' 'M' 'U' 'M' 'M'
 'M' 'M' 'M' 'M' 'U' 'M' 'A' 'U' 'M' 'U' 'A' 'U' 'U' 'U' 'M' 'U' 'U' 'A'
 'A' 'A' 'M' 'M' 'A' 'U' 'U' 'U' 'U' 'U' 'A' 'U' 'U' 'U' 'U' 'M' 'M' 'A'
 'A' 'M' 'A' 'U' 'M' 'U' 'U' 'M' 'M' 'A' 'A' 'U' 'U' 'U' 'A' 'U' 'A' 'M'
 'U' 'M' 'A' 'U' 'U' 'A' 'A' 'A' 'A' 'A' 'A' 'A' 'A' 'U' 'A' 'U' 'A' 'U'
 'A' 'U' 'U' 'A' 'U' 'M' 'U' 'M' 'M' 'U' 'A' 'A' 'M' 'M' 'U' 'A' 'A' 'A'
 'A' 'M' 'U' 'U' 'M' 'U' 'M' 'U' 'A' 'M' 'A' 'A' 'U' 'M' 'M' 'M' 'U' 'M'
 'U' 'M' 'M' 'U' 'U' 'M' 'M' 'M' 'U' 'U' 'U' 'U' 'U' 'M' 'M' 'M' 'M' 'M']"
39001,0,118,55,63,80,1,0,"['A' 'U' 'M' 'A' 'M' 'A' 'M' 'U' 'M' 'U' 'M' 'U' 'U' 'U' 'M' 'U' 'A' 'U'
 'U' 'U' 'A' 'U' 'U' 'U' 'U' 'A' 'M' 'A' 'U' 'A' 'M' 'A' 'M' 'U' 'U' 'U'
 'U' 'A' 'M' 'A' 'U' 'A' 'M' 'A' 'M' 'M' 'A' 'A' 'M' 'A' 'U' 'M' 'M' 'U'
 'A' 'U' 'M' 'U' 'U' 'U' 'A' 'A' 'U' 'A' 'A' 'U' 'M' 'M' 'M' 'M' 'M' 'M'
 'M' 'M' 'M' 'M' 'U' 'M' 'U' 'U' 'M' 'A' 'A' 'U' 'U' 'U' 'M' 'U' 'M' 'A'
 'A' 'A' 'M' 'M' 'A' 'M' 'U' 'M' 'U' 'U' 'A' 'U' 'U' 'U' 'M' 'M' 'U' 'U'
 'A' 'U' 'A' 'M' 'M' 'U' 'M' 'M' 'M' 'U' 'A' 'U' 'U' 'A' 'M' 'M' 'A' 'U'
 'U' 'M' 'A' 'U' 'U' 'U' 'A' 'A' 'A' 'A' 'A' 'A' 'A' 'U' 'A' 'U' 'U' 'U'
 'A' 'U' 'U' 'A' 'U' 'U' 'U' 'M' 'M' 'U' 'A' 'A' 'M' 'M' 'U' 'A' 'A' 'A'
 'A' 'M' 'M' 'U' 'M' 'A' 'M' 'U' 'A' 'U' 'A' 'A' 'U' 'M' 'U' 'M' 'U' 'U'
 'U' 'M' 'U' 'U' 'U' 'U' 'M' 'M' 'U' 'A' 'U' 'U' 'U' 'M' 'M' 'M' 'M' 'M']"
39101,1,120,53,67,78,0,0,"['A' 'A' 'M' 'A' 'M' 'A' 'U' 'U' 'M' 'U' 'M' 'U' 'U' 'U' 'M' 'M' 'A' 'U'
 'U' 'U' 'U' 'A' 'U' 'U' 'U' 'A' 'M' 'A' 'U' 'A' 'M' 'U' 'M' 'U' 'U' 'U'
 'U' 'A' 'U' 'U' 'A' 'U' 'M' 'U' 'M' 'M' 'A' 'A' 'M' 'A' 'U' 'M' 'M' 'U'
 'U' 'U' 'M' 'U' 'U' 'U' 'A' 'U' 'U' 'M' 'A' 'M' 'M' 'M' 'M' 'U' 'M' 'M'
 'M' 'M' 'M' 'U' 'U' 'M' 'U' 'A' 'M' 'A' 'A' 'U' 'U' 'A' 'M' 'A' 'M' 'A'
 'A' 'A' 'M' 'U' 'U' 'M' 'M' 'M' 'U' 'U' 'A' 'U' 'U' 'M' 'M' 'M' 'M' 'U'
 'A' 'U' 'A' 'M' 'M' 'U' 'M' 'A' 'M' 'U' 'A' 'U' 'M' 'A' 'U' 'M' 'A' 'U'
 'U' 'M' 'U' 'U' 'U' 'A' 'A' 'A' 'A' 'A' 'A' 'A' 'A' 'U' 'A' 'M' 'U' 'U'
 'A' 'A' 'U' 'A' 'U' 'U' 'U' 'M' 'M' 'U' 'A' 'A' 'M' 'M' 'U' 'A' 'A' 'A'
 'A' 'U' 'M' 'U' 'M' 'A' 'M' 'U' 'A' 'U' 'A' 'U' 'U' 'M' 'A' 'M' 'M' 'U'
 'M' 'M' 'M' 'U' 'M' 'U' 'M' 'M' 'U' 'U' 'M' 'U' 'U' 'M' 'U' 'M' 'M' 'M']"
39201,1,122,59,63,76,1,0,"['A' 'A' 'M' 'A' 'M' 'M' 'U' 'A' 'M' 'U' 'M' 'U' 'U' 'M' 'M' 'M' 'A' 'U'
 'U' 'U' 'A' 'A' 'U' 'U' 'U' 'U' 'M' 'A' 'U' 'A' 'A' 'U' 'M' 'U' 'U' 'A'
 'A' 'A' 'M' 'U' 'U' 'A' 'M' 'U' 'M' 'M' 'A' 'U' 'M' 'A' 'U' 'M' 'M' 'U'
 'U' 'U' 'U' 'U' 'A' 'U' 'A' 'U' 'U' 'U' 'A' 'M' 'M' 'M' 'M' 'U' 'M' 'M'
 'M' 'M' 'M' 'M' 'U' 'U' 'M' 'A' 'M' 'A' 'U' 'U' 'U' 'A' 'M' 'U' 'U' 'A'
 'A' 'A' 'M' 'A' 'U' 'M' 'M' 'U' 'U' 'U' 'A' 'U' 'M' 'M' 'M' 'M' 'M' 'U'
 'A' 'U' 'A' 'M' 'M' 'U' 'M' 'A' 'M' 'M' 'A' 'U' 'U' 'A' 'U' 'M' 'A' 'A'
 'U' 'M' 'U' 'U' 'U' 'A' 'A' 'A' 'A' 'A' 'A' 'A' 'A' 'U' 'A' 'U' 'A' 'U'
 'A' 'A' 'U' 'A' 'U' 'A' 'U' 'M' 'M' 'U' 'A' 'U' 'M' 'M' 'M' 'A' 'A' 'A'
 'A' 'U' 'M' 'U' 'U' 'A' 'M' 'U' 'A' 'U' 'A' 'M' 'U' 'M' 'A' 'M' 'M' 'A'
 'U' 'M' 'M' 'U' 'U' 'U' 'U' 'M' 'U' 'U' 'U' 'U' 'M' 'U' 'A' 'M' 'M' 'M']"
39301,0,107,53,54,91,0,0,"['A' 'A' 'U' 'A' 'U' 'M' 'A' 'A' 'M' 'U' 'M' 'U' 'U' 'U' 'U' 'U' 'A' 'U'
 'A' 'U' 'A' 'M' 'U' 'U' 'A' 'U' 'U' 'A' 'A' 'A' 'A' 'U' 'M' 'U' 'A' 'A'
 'A' 'U' 'U' 'U' 'A' 'U' 'M' 'U' 'U' 'M' 'A' 'U' 'A' 'A' 'A' 'M' 'M' 'M'
 'U' 'U' 'U' 'U' 'A' 'U' 'U' 'U' 'U' 'U' 'A' 'M' 'M' 'M' 'M' 'M' 'M' 'M'
 'M' 'U' 'M' 'M' 'U' 'U' 'U' 'U' 'M' 'A' 'A' 'U' 'M' 'A' 'M' 'U' 'U' 'A'
 'A' 'U' 'M' 'U' 'U' 'M' 'M' 'U' 'U' 'U' 'U' 'U' 'M' 'U' 'M' 'U' 'M' 'U'
 'A' 'U' 'U' 'M' 'M' 'M' 'M' 'A' 'M' 'M' 'A' 'U' 'U' 'A' 'U' 'M' 'A' 'A'
 'U' 'M' 'U' 'U' 'U' 'A' 'A' 'A' 'A' 'A' 'A' 'A' 'A' 'A' 'A' 'U' 'A' 'U'
 'U' 'A' 'M' 'A' 'U' 'A' 'M' 'M' 'M' 'U' 'U' 'U' 'M' 'U' 'M' 'A' 'U' 'A'
 'A' 'U' 'M' 'U' 'U' 'A' 'M' 'U' 'A' 'U' 'U' 'M' 'U' 'M' 'U' 'M' 'M' 'U'
 'U' 'M' 'M' 'U' 'U' 'U' 'U' 'U' 'U' 'U' 'U' 'U' 'U' 'U' 'U' 'M' 'M' 'M']"
39401,2,115,55,60,83,0,0,"['A' 'A' 'U' 'U' 'U' 'M' 'A' 'U' 'M' 'U' 'M' 'M' 'U' 'U' 'A' 'U' 'A' 'U'
 'A' 'U' 'U' 'M' 'U' 'M' 'A' 'U' 'A' 'A' 'A' 'A' 'A' 'U' 'M' 'U' 'A' 'A'
 'A' 'M' 'U' 'U' 'A' 'M' 'M' 'U' 'U' 'M' 'A' 'U' 'A' 'A' 'A' 'M' 'M' 'M'
 'U' 'U' 'U' 'M' 'A' 'U' 'U' 'U' 'U' 'U' 'A' 'M' 'M' 'M' 'M' 'U' 'M' 'M'
 'M' 'M' 'M' 'M' 'U' 'U' 'U' 'M' 'M' 'U' 'A' 'A' 'M' 'A' 'U' 'U' 'U' 'A'
 'A' 'U' 'M' 'U' 'U' 'M' 'M' 'U' 'U' 'U' 'U' 'M' 'U' 'U' 'M' 'U' 'U' 'U'
 'A' 'U' 'M' 'M' 'M' 'M' 'M' 'A' 'M' 'M' 'A' 'U' 'U' 'A' 'U' 'M' 'A' 'U'
 'U' 'M' 'M' 'U' 'U' 'A' 'A' 'A' 'A' 'A' 'A' 'A' 'A' 'A' 'A' 'U' 'A' 'U'
 'U' 'A' 'M' 'A' 'U' 'A' 'M' 'U' 'M' 'U' 'A' 'M' 'M' 'U' 'M' 'U' 'U' 'U'
 'A' 'U' 'M' 'A' 'A' 'A' 'M' 'U' 'U' 'U' 'U' 'M' 'U' 'M' 'A' 'M' 'M' 'U'
 'U' 'M' 'M' 'A' 'U' 'U' 'M' 'A' 'U' 'U' 'U' 'U' 'A' 'U' 'U' 'M' 'M' 'U']"
39501,1,114,51,63,84,0,0,"['A' 'A' 'U' 'U' 'U' 'M' 'A' 'U' 'M' 'U' 'M' 'M' 'U' 'U' 'A' 'U' 'A' 'U'
 'A' 'U' 'U' 'M' 'A' 'M' 'A' 'U' 'A' 'U' 'A' 'U' 'A' 'M' 'M' 'M' 'U' 'A'
 'A' 'M' 'U' 'M' 'A' 'U' 'M' 'U' 'U' 'U' 'A' 'U' 'U' 'A' 'A' 'M' 'U' 'M'
 'U' 'U' 'M' 'U' 'A' 'U' 'M' 'U' 'U' 'U' 'A' 'M' 'M' 'M' 'M' 'U' 'M' 'M'
 'M' 'M' 'M' 'M' 'U' 'U' 'U' 'M' 'U' 'U' 'A' 'A' 'M' 'A' 'U' 'U' 'U' 'A'
 'A' 'U' 'M' 'M' 'A' 'U' 'M' 'U' 'U' 'U' 'U' 'M' 'U' 'M' 'M' 'M' 'U' 'U'
 'A' 'M' 'M' 'M' 'M' 'M' 'M' 'A' 'M' 'M' 'M' 'U' 'U' 'U' 'U' 'U' 'U' 'U'
 'U' 'M' 'U' 'U' 'U' 'A' 'A' 'A' 'A' 'A' 'A' 'A' 'A' 'A' 'A' 'U' 'A' 'U'
 'U' 'A' 'M' 'U' 'U' 'A' 'M' 'U' 'M' 'U' 'A' 'U' 'M' 'U' 'M' 'U' 'U' 'A'
 'A' 'U' 'M' 'A' 'A' 'A' 'M' 'A' 'M' 'U' 'A' 'M' 'U' 'M' 'U' 'M' 'M' 'U'
 'U' 'M' 'M' 'A' 'U' 'U' 'M' 'M' 'U' 'U' 'U' 'U' 'A' 'U' 'U' 'M' 'M' 'A']"
39601,1,119,60,59,79,0,0,"['A' 'A' 'U' 'M' 'U' 'A' 'A' 'U' 'M' 'U' 'M' 'M' 'U' 'U' 'A' 'U' 'A' 'A'
 'A' 'A' 'M' 'M' 'A' 'M' 'A' 'U' 'A' 'U' 'U' 'U' 'A' 'U' 'M' 'A' 'U' 'A'
 'A' 'M' 'U' 'M' 'U' 'U' 'U' 'U' 'U' 'U' 'U' 'U' 'A' 'U' 'U' 'U' 'U' 'M'
 'A' 'U' 'U' 'U' 'A' 'M' 'U' 'U' 'U' 'U' 'A' 'M' 'M' 'M' 'U' 'M' 'M' 'M'
 'M' 'M' 'M' 'M' 'U' 'U' 'U' 'M' 'A' 'U' 'A' 'A' 'M' 'A' 'U' 'U' 'M' 'A'
 'A' 'U' 'M' 'U' 'A' 'U' 'M' 'U' 'U' 'U' 'U' 'U' 'U' 'M' 'M' 'M' 'M' 'A'
 'A' 'M' 'M' 'U' 'M' 'M' 'U' 'A' 'M' 'M' 'M' 'U' 'A' 'A' 'A' 'U' 'A' 'U'
 'U' 'M' 'U' 'U' 'A' 'A' 'A' 'A' 'A' 'A' 'A' 'A' 'A' 'A' 'A' 'A' 'U' 'U'
 'U' 'A' 'M' 'U' 'M' 'A' 'M' 'M' 'M' 'A' 'U' 'U' 'M' 'U' 'M' 'U' 'U' 'A'
 'A' 'U' 'U' 'U' 'A' 'U' 'M' 'A' 'M' 'U' 'A' 'M' 'U' 'M' 'U' 'U' 'M' 'M'
 'U' 'M' 'M' 'A' 'U' 'U' 'M' 'M' 'U' 'M' 'A' 'A' 'A' 'U' 'A' 'M' 'M' 'A']"
39701,1,112,52,60,86,0,1,"['A' 'A' 'U' 'M' 'U' 'A' 'U' 'M' 'U' 'U' 'M' 'A' 'U' 'U' 'A' 'M' 'U' 'U'
 'U' 'A' 'M' 'M' 'U' 'M' 'A' 'A' 'A' 'U' 'U' 'U' 'A' 'U' 'M' 'U' 'U' 'A'
 'A' 'M' 'U' 'U' 'M' 'U' 'U' 'U' 'U' 'U' 'U' 'U' 'A' 'U' 'A' 'U' 'U' 'U'
 'A' 'U' 'U' 'U' 'A' 'M' 'U' 'U' 'M' 'A' 'A' 'M' 'M' 'M' 'M' 'M' 'U' 'M'
 'M' 'M' 'M' 'M' 'M' 'M' 'U' 'U' 'A' 'U' 'A' 'U' 'M' 'A' 'U' 'U' 'M' 'A'
 'A' 'U' 'M' 'A' 'A' 'U' 'M' 'U' 'U' 'U' 'U' 'U' 'U' 'M' 'M' 'M' 'U' 'A'
 'U' 'M' 'M' 'U' 'M' 'M' 'U' 'U' 'M' 'M' 'U' 'A' 'A' 'A' 'M' 'U' 'U' 'U'
 'U' 'U' 'U' 'M' 'A' 'A' 'A' 'A' 'A' 'A' 'A' 'A' 'A' 'U' 'A' 'A' 'M' 'M'
 'U' 'A' 'M' 'U' 'M' 'U' 'U' 'U' 'M' 'A' 'A' 'U' 'U' 'A' 'M' 'U' 'U' 'M'
 'U' 'U' 'U' 'M' 'A' 'U' 'M' 'A' 'M' 'U' 'A' 'M' 'U' 'U' 'U' 'A' 'M' 'M'
 'U' 'M' 'M' 'U' 'U' 'U' 'M' 'M' 'M' 'M' 'A' 'A' 'A' 'U' 'A' 'M' 'M' 'U']"
39801,0,117,51,66,81,0,1,"['A' 'A' 'U' 'M' 'U' 'A' 'U' 'M' 'U' 'U' 'M' 'A' 'U' 'U' 'U' 'M' 'U' 'U'
 'U' 'A' 'M' 'M' 'U' 'U' 'A' 'U' 'A' 'U' 'U' 'U' 'A' 'U' 'M' 'U' 'M' 'A'
 'A' 'M' 'U' 'M' 'M' 'U' 'U' 'U' 'M' 'A' 'U' 'U' 'A' 'A' 'A' 'U' 'A' 'A'
 'A' 'U' 'U' 'M' 'A' 'M' 'M' 'U' 'M' 'U' 'A' 'M' 'M' 'M' 'M' 'M' 'M' 'M'
 'U' 'M' 'M' 'M' 'U' 'M' 'U' 'U' 'A' 'A' 'M' 'U' 'U' 'A' 'M' 'U' 'M' 'U'
 'A' 'U' 'M' 'A' 'A' 'U' 'M' 'U' 'A' 'U' 'U' 'M' 'U' 'M' 'M' 'M' 'M' 'A'
 'U' 'M' 'M' 'U' 'M' 'M' 'A' 'U' 'U' 'M' 'M' 'A' 'U' 'A' 'M' 'U' 'M' 'U'
 'U' 'U' 'U' 'U' 'M' 'A' 'A' 'A' 'A' 'A' 'A' 'A' 'A' 'M' 'A' 'A' 'M' 'M'
 'U' 'A' 'U' 'U' 'U' 'U' 'U' 'U' 'M' 'A' 'A' 'U' 'U' 'A' 'M' 'M' 'U' 'M'
 'A' 'U' 'U' 'M' 'U' 'U' 'M' 'A' 'M' 'U' 'A' 'M' 'U' 'M' 'U' 'A' 'M' 'M'
 'U' 'U' 'M' 'U' 'U' 'U' 'M' 'U' 'U' 'M' 'A' 'A' 'A' 'U' 'M' 'M' 'M' 'U']"
39901,3,120,51,69,78,0,1,"['A' 'A' 'U' 'A' 'U' 'A' 'M' 'M' 'U' 'M' 'M' 'A' 'U' 'M' 'U' 'U' 'U' 'U'
 'A' 'A' 'M' 'M' 'U' 'U' 'A' 'U' 'A' 'M' 'U' 'U' 'A' 'U' 'M' 'U' 'M' 'A'
 'A' 'M' 'U' 'M' 'A' 'U' 'A' 'U' 'M' 'U' 'U' 'U' 'A' 'A' 'A' 'U' 'A' 'A'
 'A' 'U' 'M' 'M' 'A' 'M' 'M' 'U' 'M' 'U' 'A' 'M' 'M' 'M' 'U' 'M' 'M' 'M'
 'M' 'M' 'M' 'M' 'U' 'U' 'U' 'M' 'U' 'U' 'M' 'U' 'U' 'A' 'M' 'U' 'M' 'A'
 'A' 'U' 'M' 'A' 'A' 'U' 'M' 'U' 'U' 'U' 'U' 'M' 'A' 'M' 'M' 'M' 'U' 'A'
 'U' 'M' 'M' 'U' 'U' 'M' 'U' 'U' 'M' 'U' 'M' 'M' 'U' 'A' 'M' 'U' 'M' 'U'
 'U' 'U' 'U' 'U' 'U' 'A' 'A' 'A' 'A' 'A' 'A' 'A' 'A' 'M' 'A' 'A' 'U' 'M'
 'M' 'A' 'U' 'U' 'U' 'U' 'U' 'M' 'M' 'A' 'A' 'A' 'A' 'M' 'M' 'U' 'U' 'M'
 'A' 'U' 'U' 'M' 'U' 'U' 'M' 'A' 'U' 'U' 'A' 'M' 'U' 'M' 'U' 'A' 'M' 'M'
 'M' 'U' 'M' 'M' 'U' 'U' 'M' 'M' 'U' 'M' 'A' 'A' 'U' 'U' 'M' 'M' 'M' 'U']"
40001,2,125,54,71,73,0,1,"['A' 'A' 'U' 'A' 'M' 'A' 'M' 'M' 'U' 'M' 'M' 'A' 'A' 'M' 'M' 'U' 'U' 'A'
 'U' 'A' 'M' 'M' 'U' 'U' 'A' 'M' 'A' 'U' 'U' 'U' 'U' 'U' 'M' 'U' 'M' 'A'
 'A' 'M' 'U' 'M' 'A' 'U' 'A' 'U' 'M' 'U' 'U' 'U' 'A' 'A' 'A' 'U' 'A' 'A'
 'A' 'U' 'M' 'M' 'A' 'M' 'M' 'M' 'M' 'U' 'A' 'M' 'U' 'M' 'M' 'M' 'M' 'M'
 'M' 'M' 'M' 'U' 'U' 'U' 'U' 'M' 'A' 'U' 'M' 'A' 'U' 'A' 'M' 'U' 'M' 'A'
 'A' 'U' 'M' 'A' 'A' 'U' 'U' 'M' 'M' 'U' 'U' 'M' 'A' 'M' 'M' 'M' 'U' 'A'
 'U' 'M' 'M' 'U' 'U' 'U' 'M' 'M' 'U' 'U' 'M' 'M' 'U' 'A' 'M' 'U' 'M' 'U'
 'U' 'U' 'U' 'U' 'U' 'A' 'A' 'A' 'A' 'A' 'A' 'A' 'A' 'M' 'U' 'A' 'U' 'M'
 'M' 'A' 'U' 'U' 'U' 'U' 'U' 'M' 'M' 'A' 'A' 'A' 'U' 'M' 'M' 'U' 'U' 'M'
 'A' 'U' 'A' 'M' 'U' 'A' 'M' 'A' 'U' 'M' 'A' 'U' 'U' 'M' 'U' 'U' 'M' 'M'
 'M' 'U' 'M' 'M' 'U' 'M' 'U' 'M' 'A' 'M' 'A' 'A' 'A' 'U' 'U' 'M' 'M' 'U']"
40101,1,117,54,63,81,0,0,"['A' 'A' 'A' 'U' 'U' 'A' 'M' 'M' 'U' 'M' 'M' 'U' 'A' 'M' 'U' 'A' 'M' 'A'
 'U' 'U' 'M' 'M' 'U' 'U' 'A' 'M' 'U' 'U' 'U' 'U' 'A' 'U' 'M' 'U' 'M' 'A'
 'A' 'M' 'U' 'U' 'A' 'U' 'A' 'U' 'U' 'U' 'A' 'U' 'A' 'U' 'A' 'U' 'U' 'A'
 'U' 'M' 'M' 'M' 'A' 'M' 'M' 'M' 'M' 'M' 'A' 'M' 'M' 'M' 'M' 'M' 'U' 'M'
 'M' 'M' 'M' 'U' 'U' 'U' 'U' 'M' 'A' 'U' 'U' 'A' 'U' 'A' 'M' 'U' 'M' 'A'
 'A' 'U' 'U' 'A' 'U' 'U' 'U' 'U' 'U' 'U' 'U' 'M' 'A' 'U' 'M' 'M' 'U' 'A'
 'U' 'M' 'M' 'M' 'A' 'U' 'M' 'M' 'U' 'U' 'U' 'M' 'A' 'A' 'M' 'U' 'M' 'U'
 'A' 'U' 'U' 'U' 'U' 'A' 'A' 'A' 'A' 'A' 'A' 'A' 'A' 'M' 'A' 'A' 'U' 'M'
 'U' 'A' 'U' 'U' 'U' 'U' 'A' 'M' 'M' 'A' 'A' 'U' 'M' 'M' 'M' 'U' 'M' 'M'
 'A' 'U' 'U' 'M' 'A' 'A' 'U' 'A' 'U' 'M' 'A' 'U' 'U' 'M' 'U' 'U' 'U' 'M'
 'M' 'A' 'M' 'U' 'U' 'M' 'M' 'U' 'U' 'M' 'A' 'A' 'A' 'U' 'U' 'M' 'M' 'U']"
40201,0,118,49,69,80,0,1,"['A' 'A' 'A' 'A' 'U' 'M' 'U' 'M' 'U' 'M' 'M' 'U' 'U' 'M' 'U' 'A' 'M' 'A'
 'U' 'M' 'M' 'M' 'U' 'U' 'A' 'M' 'M' 'A' 'U' 'U' 'A' 'U' 'M' 'U' 'M' 'A'
 'U' 'M' 'U' 'U' 'A' 'U' 'A' 'M' 'M' 'U' 'A' 'U' 'U' 'U' 'A' 'U' 'U' 'A'
 'U' 'M' 'M' 'U' 'U' 'U' 'U' 'M' 'M' 'M' 'A' 'M' 'M' 'M' 'M' 'M' 'M' 'M'
 'U' 'M' 'M' 'U' 'U' 'A' 'M' 'M' 'U' 'U' 'M' 'A' 'A' 'A' 'M' 'U' 'M' 'A'
 'A' 'U' 'U' 'U' 'U' 'U' 'U' 'U' 'M' 'M' 'U' 'M' 'A' 'U' 'M' 'M' 'U' 'A'
 'U' 'M' 'M' 'M' 'U' 'U' 'M' 'M' 'U' 'U' 'U' 'M' 'A' 'A' 'U' 'M' 'M' 'U'
 'U' 'A' 'A' 'U' 'U' 'U' 'U' 'A' 'A' 'A' 'A' 'A' 'A' 'M' 'A' 'A' 'A' 'M'
 'U' 'A' 'A' 'U' 'U' 'M' 'A' 'M' 'M' 'A' 'A' 'M' 'M' 'M' 'M' 'U' 'U' 'M'
 'A' 'U' 'U' 'M' 'A' 'A' 'U' 'A' 'U' 'M' 'U' 'A' 'M' 'M' 'U' 'U' 'U' 'U'
 'U' 'U' 'M' 'U' 'U' 'M' 'M' 'U' 'U' 'M' 'A' 'U' 'U' 'M' 'U' 'M' 'M' 'A']"
40301,1,119,53,66,79,1,0,"['A' 'U' 'A' 'A' 'U' 'M' 'M' 'U' 'U' 'M' 'M' 'U' 'M' 'U' 'U' 'A' 'M' 'A'
 'A' 'M' 'M' 'M' 'U' 'U' 'A' 'M' 'U' 'A' 'U' 'U' 'A' 'U' 'M' 'M' 'M' 'A'
 'U' 'M' 'U' 'A' 'U' 'U' 'A' 'M' 'M' 'A' 'A' 'U' 'U' 'U' 'A' 'U' 'U' 'A'
 'A' 'M' 'M' 'U' 'U' 'U' 'U' 'U' 'M' 'M' 'A' 'M' 'M' 'M' 'M' 'M' 'M' 'M'
 'U' 'M' 'M' 'A' 'U' 'A' 'M' 'M' 'U' 'A' 'M' 'A' 'U' 'A' 'M' 'A' 'M' 'U'
 'A' 'U' 'U' 'A' 'A' 'A' 'U' 'U' 'M' 'M' 'U' 'M' 'A' 'U' 'M' 'M' 'U' 'U'
 'U' 'M' 'M' 'M' 'U' 'U' 'M' 'M' 'U' 'U' 'U' 'U' 'U' 'A' 'M' 'M' 'U' 'U'
 'U' 'A' 'A' 'U' 'U' 'A' 'A' 'A' 'A' 'A' 'A' 'A' 'A' 'M' 'A' 'A' 'A' 'M'
 'U' 'U' 'A' 'M' 'U' 'M' 'A' 'U' 'M' 'A' 'A' 'M' 'M' 'M' 'M' 'U' 'U' 'M'
 'A' 'U' 'U' 'M' 'U' 'U' 'A' 'A' 'U' 'U' 'U' 'A' 'M' 'M' 'U' 'U' 'U' 'M'
 'U' 'U' 'M' 'A' 'U' 'M' 'U' 'A' 'U' 'U' 'U' 'M' 'U' 'M' 'U' 'M' 'M' 'U']"
40401,1,120,52,68,78,0,1,"['A' 'U' 'A' 'A' 'U' 'M' 'M' 'U' 'U' 'M' 'M' 'M' 'M' 'U' 'U' 'A' 'U' 'A'
 'A' 'U' 'M' 'M' 'M' 'U' 'U' 'M' 'U' 'A' 'U' 'U' 'A' 'U' 'M' 'M' 'M' 'A'
 'U' 'M' 'U' 'A' 'U' 'U' 'A' 'U' 'M' 'A' 'A' 'A' 'U' 'U' 'A' 'M' 'U' 'A'
 'A' 'M' 'M' 'U' 'U' 'A' 'U' 'U' 'M' 'M' 'A' 'M' 'M' 'M' 'M' 'M' 'M' 'M'
 'M' 'U' 'M' 'A' 'M' 'U' 'U' 'U' 'U' 'U' 'M' 'A' 'M' 'A' 'M' 'A' 'M' 'U'
 'U' 'M' 'M' 'U' 'U' 'A' 'U' 'A' 'M' 'M' 'U' 'M' 'A' 'U' 'M' 'U' 'U' 'U'
 'A' 'M' 'M' 'M' 'U' 'U' 'M' 'M' 'A' 'A' 'U' 'M' 'M' 'A' 'M' 'M' 'U' 'U'
 'M' 'M' 'U' 'U' 'M' 'A' 'A' 'A' 'A' 'U' 'A' 'A' 'A' 'M' 'U' 'A' 'U' 'M'
 'A' 'A' 'A' 'U' 'U' 'M' 'A' 'U' 'U' 'A' 'A' 'M' 'M' 'U' 'U' 'U' 'U' 'U'
 'A' 'M' 'U' 'M' 'U' 'A' 'A' 'U' 'U' 'A' 'U' 'A' 'U' 'M' 'U' 'U' 'U' 'M'
 'M' 'U' 'M' 'A' 'A' 'M' 'U' 'A' 'U' 'U' 'U' 'M' 'U' 'M' 'U' 'M' 'M' 'U']"
40501,2,133,58,75,65,1,0,"['A' 'U' 'A' 'A' 'M' 'M' 'M' 'U' 'U' 'M' 'M' 'M' 'M' 'U' 'U' 'U' 'A' 'A'
 'U' 'U' 'M' 'M' 'M' 'U' 'U' 'M' 'M' 'U' 'A' 'U' 'M' 'U' 'M' 'U' 'M' 'A'
 'M' 'U' 'M' 'A' 'A' 'A' 'A' 'U' 'M' 'U' 'A' 'A' 'M' 'M' 'A' 'U' 'U' 'A'
 'U' 'M' 'M' 'U' 'U' 'A' 'U' 'A' 'U' 'M' 'A' 'M' 'M' 'M' 'M' 'M' 'M' 'M'
 'U' 'M' 'M' 'A' 'M' 'U' 'U' 'A' 'A' 'A' 'M' 'A' 'M' 'A' 'M' 'A' 'M' 'A'
 'U' 'M' 'M' 'M' 'A' 'U' 'U' 'A' 'M' 'M' 'U' 'M' 'A' 'U' 'M' 'U' 'M' 'M'
 'A' 'U' 'U' 'M' 'U' 'U' 'U' 'M' 'A' 'U' 'M' 'M' 'M' 'A' 'M' 'M' 'A' 'A'
 'M' 'M' 'U' 'U' 'M' 'A' 'A' 'A' 'A' 'A' 'A' 'A' 'A' 'M' 'U' 'A' 'M' 'M'
 'A' 'A' 'A' 'M' 'A' 'M' 'U' 'U' 'M' 'A' 'A' 'M' 'M' 'U' 'U' 'U' 'U' 'U'
 'A' 'M' 'A' 'M' 'U' 'A' 'A' 'A' 'M' 'U' 'U' 'A' 'U' 'M' 'U' 'U' 'U' 'M'
 'M' 'U' 'M' 'A' 'A' 'U' 'U' 'A' 'U' 'U' 'U' 'M' 'U' 'M' 'U' 'M' 'U' 'M']"
40601,2,130,57,73,68,0,0,"['A' 'U' 'A' 'U' 'M' 'M' 'U' 'U' 'U' 'M' 'M' 'U' 'M' 'U' 'U' 'U' 'U' 'U'
 'A' 'U' 'M' 'M' 'M' 'M' 'A' 'M' 'M' 'U' 'A' 'U' 'M' 'U' 'M' 'U' 'M' 'U'
 'M' 'U' 'M' 'A' 'A' 'A' 'A' 'U' 'M' 'U' 'A' 'A' 'M' 'M' 'A' 'U' 'U' 'U'
 'U' 'M' 'U' 'U' 'U' 'A' 'A' 'U' 'M' 'M' 'A' 'M' 'M' 'M' 'M' 'M' 'M' 'U'
 'M' 'M' 'M' 'A' 'A' 'M' 'U' 'A' 'A' 'A' 'M' 'A' 'M' 'A' 'U' 'A' 'M' 'U'
 'U' 'M' 'M' 'M' 'A' 'U' 'U' 'A' 'U' 'M' 'U' 'M' 'A' 'U' 'M' 'U' 'U' 'M'
 'A' 'U' 'M' 'M' 'U' 'U' 'U' 'M' 'A' 'U' 'M' 'M' 'M' 'A' 'M' 'U' 'A' 'A'
 'U' 'M' 'M' 'U' 'M' 'A' 'A' 'A' 'A' 'A' 'A' 'A' 'A' 'M' 'U' 'A' 'M' 'M'
 'A' 'A' 'A' 'M' 'A' 'M' 'U' 'A' 'M' 'M' 'A' 'U' 'U' 'U' 'M' 'U' 'M' 'U'
 'A' 'M' 'A' 'M' 'U' 'U' 'A' 'A' 'M' 'A' 'U' 'A' 'U' 'U' 'U' 'A' 'A' 'M'
 'M' 'M' 'M' 'A' 'A' 'M' 'U' 'A' 'U' 'U' 'U' 'M' 'U' 'M' 'U' 'M' 'U' 'M']"
40701,2,124,60,64,74,0,0,"['A' 'U' 'A' 'A' 'U' 'M' 'U' 'U' 'U' 'M' 'M' 'U' 'M' 'U' 'U' 'U' 'U' 'A'
 'U' 'U' 'M' 'M' 'M' 'M' 'A' 'M' 'M' 'U' 'A' 'U' 'M' 'U' 'M' 'M' 'U' 'U'
 'M' 'U' 'M' 'A' 'A' 'A' 'U' 'U' 'M' 'M' 'U' 'A' 'U' 'A' 'U' 'U' 'U' 'U'
 'M' 'M' 'A' 'M' 'M' 'A' 'A' 'U' 'M' 'M' 'A' 'U' 'M' 'M' 'M' 'M' 'M' 'M'
 'M' 'M' 'M' 'A' 'A' 'M' 'U' 'A' 'A' 'U' 'M' 'A' 'M' 'U' 'U' 'A' 'M' 'U'
 'U' 'M' 'U' 'M' 'U' 'U' 'U' 'A' 'U' 'U' 'U' 'U' 'A' 'U' 'M' 'A' 'U' 'M'
 'U' 'U' 'M' 'M' 'M' 'A' 'M' 'U' 'A' 'U' 'U' 'M' 'M' 'A' 'M' 'U' 'A' 'A'
 'U' 'M' 'U' 'U' 'M' 'A' 'A' 'A' 'A' 'A' 'A' 'A' 'A' 'M' 'U' 'A' 'A' 'U'
 'A' 'A' 'A' 'M' 'U' 'M' 'A' 'A' 'M' 'M' 'A' 'U' 'U' 'A' 'M' 'U' 'M' 'U'
 'A' 'U' 'A' 'M' 'U' 'U' 'A' 'A' 'M' 'U' 'U' 'A' 'U' 'U' 'U' 'A' 'A' 'M'
 'U' 'M' 'M' 'A' 'A' 'M' 'A' 'A' 'A' 'A' 'U' 'M' 'U' 'U' 'U' 'M' 'U' 'A']"
40801,1,116,54,62,82,0,0,"['A' 'U' 'A' 'A' 'U' 'M' 'U' 'U' 'U' 'M' 'M' 'A' 'U' 'U' 'U' 'U' 'U' 'A'
 'M' 'A' 'M' 'M' 'M' 'U' 'A' 'U' 'M' 'U' 'A' 'M' 'M' 'M' 'U' 'M' 'A' 'U'
 'M' 'A' 'M' 'U' 'A' 'A' 'U' 'U' 'M' 'M' 'U' 'A' 'U' 'A' 'U' 'M' 'U' 'U'
 'M' 'M' 'A' 'M' 'M' 'U' 'U' 'U' 'M' 'M' 'A' 'U' 'M' 'M' 'M' 'M' 'M' 'M'
 'M' 'M' 'M' 'A' 'A' 'U' 'U' 'A' 'U' 'U' 'M' 'A' 'M' 'U' 'M' 'U' 'M' 'U'
 'U' 'M' 'U' 'U' 'U' 'U' 'U' 'A' 'U' 'M' 'U' 'U' 'A' 'U' 'M' 'U' 'U' 'M'
 'M' 'A' 'M' 'M' 'M' 'A' 'M' 'A' 'A' 'A' 'U' 'M' 'M' 'U' 'U' 'U' 'A' 'A'
 'U' 'M' 'U' 'U' 'U' 'A' 'A' 'A' 'A' 'A' 'A' 'A' 'A' 'U' 'U' 'A' 'A' 'U'
 'A' 'A' 'U' 'M' 'U' 'M' 'A' 'A' 'M' 'M' 'U' 'U' 'M' 'A' 'U' 'M' 'M' 'U'
 'A' 'U' 'A' 'M' 'U' 'U' 'A' 'U' 'U' 'U' 'A' 'U' 'U' 'M' 'U' 'U' 'A' 'M'
 'U' 'M' 'M' 'U' 'A' 'M' 'A' 'A' 'A' 'U' 'U' 'U' 'U' 'U' 'U' 'M' 'U' 'A']"
40901,1,113,48,65,85,0,1,"['A' 'U' 'A' 'A' 'U' 'M' 'U' 'U' 'U' 'M' 'U' 'A' 'U' 'A' 'U' 'U' 'A' 'A'
 'M' 'A' 'M' 'M' 'M' 'U' 'A' 'U' 'M' 'U' 'A' 'U' 'U' 'M' 'U' 'M' 'A' 'U'
 'M' 'A' 'M' 'U' 'U' 'U' 'U' 'M' 'M' 'M' 'U' 'A' 'M' 'U' 'U' 'U' 'U' 'U'
 'M' 'M' 'A' 'M' 'U' 'M' 'U' 'M' 'M' 'M' 'U' 'M' 'M' 'M' 'M' 'U' 'M' 'M'
 'M' 'M' 'M' 'A' 'U' 'A' 'U' 'A' 'A' 'U' 'U' 'U' 'M' 'U' 'M' 'U' 'M' 'U'
 'U' 'M' 'U' 'U' 'A' 'M' 'U' 'A' 'M' 'M' 'U' 'U' 'A' 'U' 'U' 'U' 'M' 'M'
 'M' 'U' 'M' 'M' 'U' 'A' 'M' 'U' 'M' 'A' 'U' 'M' 'M' 'U' 'U' 'U' 'U' 'A'
 'U' 'M' 'M' 'A' 'U' 'A' 'A' 'A' 'A' 'A' 'A' 'A' 'A' 'M' 'U' 'A' 'U' 'U'
 'U' 'A' 'A' 'M' 'U' 'M' 'A' 'A' 'M' 'M' 'A' 'A' 'M' 'A' 'U' 'U' 'M' 'U'
 'U' 'U' 'U' 'M' 'U' 'U' 'U' 'U' 'U' 'U' 'A' 'U' 'U' 'M' 'A' 'M' 'M' 'M'
 'U' 'U' 'M' 'U' 'A' 'M' 'A' 'A' 'A' 'U' 'M' 'M' 'U' 'U' 'U' 'U' 'U' 'A']"
41001,2,131,55,76,67,0,1,"['A' 'M' 'A' 'U' 'U' 'M' 'U' 'M' 'M' 'M' 'U' 'A' 'U' 'U' 'U' 'U' 'U' 'A'
 'M' 'A' 'M' 'M' 'M' 'U' 'A' 'U' 'M' 'A' 'U' 'U' 'U' 'M' 'M' 'U' 'A' 'U'
 'M' 'A' 'M' 'U' 'A' 'U' 'M' 'M' 'M' 'M' 'A' 'U' 'M' 'U' 'U' 'A' 'U' 'U'
 'M' 'M' 'A' 'U' 'U' 'M' 'U' 'M' 'M' 'M' 'A' 'M' 'M' 'M' 'M' 'M' 'M' 'M'
 'U' 'M' 'M' 'U' 'U' 'M' 'U' 'A' 'A' 'A' 'U' 'U' 'M' 'M' 'M' 'A' 'M' 'U'
 'U' 'M' 'U' 'A' 'A' 'M' 'U' 'A' 'M' 'M' 'A' 'U' 'A' 'M' 'A' 'U' 'M' 'A'
 'U' 'M' 'U' 'M' 'M' 'A' 'M' 'U' 'M' 'A' 'U' 'M' 'M' 'U' 'M' 'U' 'A' 'A'
 'U' 'M' 'M' 'A' 'U' 'A' 'A' 'A' 'A' 'A' 'A' 'A' 'A' 'M' 'U' 'U' 'U' 'U'
 'M' 'A' 'A' 'M' 'U' 'U' 'A' 'A' 'M' 'M' 'A' 'A' 'M' 'A' 'U' 'U' 'M' 'U'
 'U' 'U' 'M' 'M' 'U' 'A' 'M' 'U' 'U' 'U' 'M' 'U' 'M' 'M' 'A' 'M' 'M' 'M'
 'U' 'U' 'M' 'M' 'A' 'M' 'A' 'A' 'A' 'U' 'M' 'U' 'A' 'A' 'U' 'A' 'M' 'A']"
41101,1,131,52,79,67,1,0,"['A' 'M' 'A' 'U' 'U' 'M' 'U' 'M' 'M' 'U' 'M' 'A' 'U' 'M' 'U' 'M' 'U' 'U'
 'M' 'M' 'M' 'M' 'M' 'A' 'A' 'M' 'M' 'A' 'U' 'U' 'U' 'U' 'M' 'U' 'A' 'U'
 'M' 'A' 'A' 'U' 'A' 'U' 'M' 'M' 'U' 'M' 'A' 'A' 'M' 'M' 'U' 'A' 'M' 'U'
 'M' 'M' 'A' 'U' 'U' 'M' 'U' 'M' 'M' 'M' 'A' 'M' 'M' 'U' 'M' 'M' 'M' 'M'
 'M' 'M' 'M' 'U' 'A' 'M' 'U' 'A' 'A' 'A' 'M' 'U' 'M' 'M' 'M' 'A' 'M' 'A'
 'U' 'M' 'M' 'A' 'U' 'M' 'U' 'A' 'M' 'M' 'U' 'U' 'A' 'U' 'A' 'U' 'M' 'U'
 'A' 'M' 'U' 'M' 'U' 'A' 'M' 'M' 'U' 'A' 'M' 'M' 'M' 'A' 'M' 'U' 'U' 'U'
 'M' 'M' 'M' 'A' 'U' 'A' 'A' 'A' 'A' 'A' 'A' 'A' 'A' 'M' 'U' 'U' 'U' 'A'
 'M' 'A' 'A' 'M' 'U' 'U' 'A' 'U' 'U' 'M' 'A' 'U' 'M' 'A' 'M' 'U' 'M' 'U'
 'U' 'U' 'M' 'U' 'U' 'A' 'A' 'U' 'U' 'U' 'M' 'U' 'M' 'M' 'M' 'U' 'M' 'A'
 'U' 'U' 'M' 'M' 'A' 'M' 'A' 'A' 'U' 'U' 'M' 'M' 'U' 'U' 'U' 'A' 'M' 'A']"
41201,0,132,48,84,66,0,0,"['A' 'M' 'A' 'M' 'U' 'M' 'M' 'M' 'U' 'M' 'M' 'A' 'M' 'U' 'U' 'M' 'M' 'U'
 'M' 'M' 'U' 'M' 'A' 'A' 'U' 'M' 'M' 'U' 'U' 'U' 'U' 'A' 'M' 'U' 'A' 'U'
 'M' 'A' 'M' 'U' 'U' 'U' 'U' 'M' 'U' 'M' 'A' 'A' 'M' 'M' 'U' 'U' 'M' 'U'
 'M' 'M' 'A' 'U' 'U' 'M' 'U' 'M' 'M' 'M' 'A' 'M' 'M' 'M' 'U' 'M' 'M' 'M'
 'M' 'M' 'M' 'A' 'A' 'U' 'U' 'A' 'U' 'A' 'M' 'U' 'M' 'M' 'M' 'A' 'M' 'M'
 'A' 'M' 'U' 'A' 'M' 'U' 'A' 'A' 'M' 'M' 'U' 'U' 'A' 'U' 'A' 'M' 'M' 'U'
 'A' 'M' 'U' 'M' 'U' 'A' 'M' 'M' 'A' 'A' 'M' 'M' 'M' 'U' 'M' 'U' 'U' 'U'
 'M' 'M' 'M' 'A' 'U' 'A' 'A' 'A' 'A' 'A' 'A' 'A' 'A' 'M' 'U' 'M' 'U' 'A'
 'M' 'A' 'U' 'M' 'U' 'U' 'A' 'U' 'U' 'U' 'A' 'U' 'U' 'A' 'M' 'U' 'M' 'M'
 'U' 'U' 'M' 'U' 'M' 'A' 'A' 'U' 'A' 'U' 'M' 'U' 'M' 'M' 'M' 'A' 'M' 'U'
 'U' 'U' 'M' 'M' 'A' 'M' 'A' 'M' 'M' 'M' 'M' 'M' 'U' 'U' 'U' 'A' 'M' 'U']"
41301,4,137,55,82,61,1,0,"['A' 'M' 'A' 'M' 'M' 'M' 'M' 'M' 'M' 'U' 'M' 'A' 'M' 'U' 'M' 'M' 'M' 'U'
 'M' 'M' 'U' 'M' 'A' 'A' 'M' 'M' 'M' 'U' 'U' 'M' 'U' 'A' 'M' 'A' 'A' 'U'
 'M' 'A' 'M' 'U' 'U' 'U' 'U' 'M' 'U' 'M' 'A' 'A' 'M' 'U' 'U' 'U' 'M' 'A'
 'M' 'U' 'A' 'U' 'M' 'M' 'U' 'M' 'U' 'M' 'A' 'M' 'U' 'M' 'M' 'M' 'M' 'M'
 'M' 'M' 'M' 'U' 'A' 'U' 'M' 'U' 'M' 'A' 'M' 'U' 'U' 'M' 'M' 'U' 'M' 'U'
 'A' 'U' 'M' 'A' 'M' 'U' 'A' 'A' 'U' 'M' 'U' 'U' 'A' 'U' 'A' 'M' 'U' 'U'
 'A' 'M' 'A' 'A' 'U' 'A' 'M' 'M' 'U' 'A' 'M' 'M' 'M' 'M' 'M' 'M' 'A' 'A'
 'M' 'M' 'M' 'A' 'U' 'A' 'A' 'A' 'A' 'A' 'A' 'A' 'A' 'M' 'U' 'M' 'U' 'A'
 'M' 'A' 'U' 'M' 'U' 'U' 'A' 'M' 'U' 'U' 'A' 'U' 'A' 'A' 'U' 'U' 'M' 'M'
 'U' 'U' 'M' 'M' 'M' 'A' 'U' 'A' 'A' 'U' 'A' 'A' 'U' 'M' 'U' 'A' 'M' 'U'
 'U' 'A' 'M' 'U' 'A' 'M' 'A' 'M' 'M' 'M' 'M' 'M' 'U' 'A' 'U' 'A' 'M' 'U']"
41401,2,131,56,75,67,1,0,"['A' 'M' 'A' 'M' 'M' 'U' 'M' 'U' 'M' 'U' 'U' 'A' 'U' 'A' 'M' 'M' 'M' 'U'
 'U' 'M' 'U' 'M' 'A' 'A' 'M' 'M' 'M' 'U' 'U' 'M' 'U' 'A' 'U' 'A' 'A' 'A'
 'M' 'A' 'A' 'U' 'U' 'A' 'U' 'U' 'U' 'M' 'A' 'A' 'M' 'U' 'M' 'U' 'M' 'A'
 'M' 'U' 'M' 'U' 'M' 'M' 'U' 'M' 'U' 'M' 'A' 'M' 'M' 'M' 'M' 'M' 'M' 'M'
 'M' 'M' 'U' 'U' 'A' 'A' 'M' 'A' 'U' 'U' 'M' 'U' 'A' 'M' 'M' 'U' 'M' 'M'
 'A' 'U' 'M' 'A' 'M' 'U' 'A' 'A' 'U' 'M' 'U' 'U' 'A' 'U' 'A' 'U' 'M' 'M'
 'A' 'M' 'A' 'A' 'M' 'A' 'M' 'U' 'U' 'U' 'M' 'U' 'M' 'M' 'M' 'M' 'A' 'A'
 'M' 'M' 'M' 'A' 'U' 'M' 'A' 'A' 'A' 'U' 'A' 'A' 'A' 'M' 'U' 'M' 'U' 'A'
 'M' 'U' 'A' 'M' 'U' 'A' 'A' 'M' 'U' 'U' 'U' 'U' 'A' 'A' 'U' 'U' 'M' 'M'
 'U' 'U' 'M' 'M' 'M' 'U' 'U' 'A' 'A' 'A' 'U' 'A' 'U' 'M' 'U' 'A' 'U' 'U'
 'A' 'A' 'M' 'M' 'A' 'M' 'A' 'U' 'M' 'U' 'M' 'U' 'U' 'A' 'M' 'U' 'M' 'U']"
41501,2,128,62,66,70,0,0,"['A' 'A' 'A' 'U' 'M' 'U' 'M' 'U' 'M' 'U' 'U' 'A' 'U' 'A' 'M' 'M' 'U' 'A'
 'U' 'M' 'U' 'M' 'A' 'U' 'M' 'U' 'M' 'U' 'U' 'M' 'M' 'A' 'A' 'A' 'A' 'A'
 'M' 'A' 'A' 'U' 'U' 'A' 'U' 'U' 'A' 'M' 'A' 'A' 'M' 'U' 'M' 'U' 'U' 'A'
 'U' 'U' 'M' 'U' 'M' 'M' 'U' 'M' 'U' 'M' 'A' 'M' 'M' 'M' 'U' 'M' 'M' 'M'
 'M' 'M' 'M' 'U' 'U' 'A' 'M' 'A' 'U' 'U' 'A' 'A' 'A' 'U' 'M' 'A' 'M' 'M'
 'A' 'A' 'M' 'A' 'U' 'U' 'A' 'A' 'M' 'A' 'A' 'U' 'A' 'U' 'U' 'U' 'M' 'M'
 'A' 'M' 'A' 'A' 'M' 'A' 'M' 'M' 'U' 'U' 'M' 'U' 'M' 'M' 'M' 'U' 'A' 'U'
 'M' 'U' 'M' 'A' 'U' 'A' 'A' 'A' 'U' 'A' 'A' 'A' 'A' 'M' 'A' 'U' 'M' 'U'
 'U' 'U' 'A' 'M' 'U' 'A' 'A' 'M' 'U' 'U' 'U' 'U' 'A' 'A' 'M' 'U' 'M' 'U'
 'M' 'U' 'M' 'M' 'M' 'M' 'U' 'A' 'U' 'U' 'U' 'U' 'A' 'U' 'U' 'A' 'A' 'U'
 'A' 'A' 'M' 'M' 'A' 'M' 'A' 'A' 'U' 'U' 'M' 'U' 'U' 'M' 'M' 'U' 'M' 'M']"
41601,3,128,70,58,70,0,0,"['A' 'U' 'A' 'A' 'M' 'U' 'M' 'U' 'M' 'U' 'U' 'A' 'U' 'A' 'M' 'M' 'U' 'A'
 'U' 'M' 'A' 'U' 'U' 'U' 'M' 'U' 'U' 'M' 'U' 'M' 'M' 'A' 'A' 'A' 'A' 'A'
 'U' 'A' 'A' 'U' 'U' 'A' 'A' 'M' 'A' 'U' 'A' 'A' 'U' 'U' 'M' 'U' 'U' 'U'
 'M' 'A' 'M' 'U' 'M' 'M' 'U' 'M' 'U' 'U' 'A' 'M' 'M' 'M' 'U' 'M' 'M' 'M'
 'M' 'M' 'M' 'A' 'U' 'A' 'M' 'A' 'U' 'U' 'A' 'A' 'A' 'A' 'U' 'A' 'M' 'U'
 'A' 'A' 'M' 'A' 'U' 'U' 'U' 'A' 'A' 'A' 'U' 'U' 'A' 'U' 'U' 'U' 'M' 'M'
 'A' 'M' 'A' 'A' 'M' 'A' 'U' 'M' 'A' 'U' 'M' 'M' 'M' 'U' 'M' 'U' 'A' 'M'
 'U' 'U' 'M' 'A' 'U' 'A' 'A' 'A' 'A' 'A' 'A' 'A' 'A' 'M' 'A' 'U' 'M' 'U'
 'M' 'M' 'A' 'M' 'A' 'U' 'A' 'M' 'M' 'A' 'U' 'U' 'A' 'A' 'M' 'A' 'U' 'U'
 'U' 'U' 'M' 'M' 'M' 'M' 'U' 'A' 'U' 'U' 'A' 'U' 'A' 'A' 'U' 'A' 'A' 'U'
 'U' 'A' 'U' 'U' 'A' 'M' 'A' 'A' 'U' 'M' 'U' 'U' 'U' 'M' 'M' 'M' 'M' 'A']"
41701,2,123,71,52,75,0,0,"['A' 'U' 'A' 'A' 'M' 'U' 'M' 'U' 'U' 'U' 'U' 'A' 'U' 'A' 'M' 'U' 'U' 'U'
 'U' 'U' 'A' 'U' 'A' 'M' 'U' 'A' 'A' 'M' 'U' 'M' 'M' 'A' 'A' 'U' 'U' 'A'
 'U' 'A' 'A' 'U' 'U' 'A' 'A' 'M' 'U' 'U' 'U' 'A' 'U' 'U' 'M' 'U' 'A' 'M'
 'M' 'U' 'M' 'U' 'M' 'M' 'U' 'U' 'A' 'U' 'A' 'U' 'M' 'M' 'M' 'M' 'M' 'M'
 'M' 'M' 'M' 'A' 'U' 'A' 'M' 'A' 'M' 'A' 'A' 'A' 'A' 'A' 'U' 'A' 'M' 'U'
 'U' 'A' 'M' 'A' 'U' 'U' 'A' 'A' 'M' 'A' 'U' 'U' 'A' 'M' 'U' 'A' 'A' 'M'
 'U' 'M' 'A' 'A' 'M' 'A' 'M' 'M' 'A' 'U' 'U' 'M' 'M' 'A' 'M' 'U' 'A' 'M'
 'U' 'A' 'U' 'A' 'U' 'A' 'A' 'A' 'A' 'A' 'A' 'A' 'A' 'M' 'U' 'U' 'U' 'U'
 'M' 'M' 'A' 'M' 'A' 'A' 'A' 'U' 'M' 'A' 'M' 'A' 'A' 'U' 'M' 'U' 'U' 'U'
 'U' 'U' 'M' 'U' 'M' 'U' 'U' 'A' 'A' 'U' 'A' 'U' 'A' 'U' 'M' 'A' 'A' 'U'
 'U' 'A' 'U' 'U' 'U' 'U' 'A' 'A' 'U' 'U' 'U' 'A' 'U' 'M' 'M' 'M' 'M' 'A']"
41801,1,121,78,43,77,1,0,"['A' 'U' 'A' 'A' 'M' 'U' 'U' 'U' 'U' 'M' 'U' 'A' 'U' 'A' 'A' 'A' 'U' 'A'
 'U' 'U' 'A' 'U' 'A' 'M' 'A' 'A' 'A' 'U' 'U' 'M' 'M' 'A' 'A' 'U' 'A' 'M'
 'U' 'A' 'A' 'U' 'A' 'A' 'U' 'U' 'U' 'U' 'U' 'A' 'U' 'A' 'U' 'U' 'A' 'M'
 'M' 'U' 'M' 'U' 'U' 'M' 'M' 'U' 'U' 'U' 'A' 'M' 'M' 'M' 'M' 'M' 'M' 'M'
 'U' 'M' 'M' 'A' 'U' 'A' 'U' 'A' 'M' 'U' 'A' 'A' 'A' 'A' 'U' 'A' 'M' 'M'
 'U' 'A' 'U' 'A' 'U' 'U' 'A' 'A' 'U' 'A' 'U' 'U' 'A' 'M' 'U' 'A' 'U' 'M'
 'M' 'M' 'A' 'A' 'U' 'A' 'M' 'U' 'A' 'U' 'U' 'M' 'U' 'A' 'M' 'U' 'A' 'M'
 'U' 'A' 'U' 'A' 'U' 'A' 'A' 'A' 'A' 'U' 'A' 'A' 'A' 'M' 'U' 'U' 'A' 'U'
 'M' 'M' 'A' 'M' 'A' 'A' 'A' 'U' 'U' 'A' 'M' 'A' 'A' 'U' 'A' 'U' 'U' 'U'
 'U' 'U' 'M' 'A' 'M' 'U' 'A' 'A' 'A' 'A' 'A' 'U' 'A' 'U' 'M' 'A' 'A' 'U'
 'U' 'A' 'M' 'U' 'U' 'A' 'A' 'A' 'U' 'U' 'U' 'A' 'A' 'U' 'M' 'M' 'M' 'U']"
41901,3,118,72,46,80,0,0,"['A' 'U' 'A' 'A' 'M' 'M' 'U' 'U' 'M' 'M' 'U' 'U' 'U' 'U' 'A' 'A' 'M' 'A'
 'U' 'U' 'A' 'U' 'A' 'M' 'A' 'A' 'U' 'U' 'U' 'M' 'M' 'U' 'A' 'A' 'A' 'M'
 'U' 'U' 'A' 'A' 'A' 'A' 'U' 'A' 'U' 'U' 'U' 'A' 'U' 'A' 'U' 'U' 'A' 'M'
 'U' 'A' 'M' 'U' 'U' 'M' 'U' 'U' 'U' 'U' 'A' 'M' 'U' 'M' 'M' 'M' 'M' 'M'
 'M' 'M' 'M' 'A' 'U' 'A' 'U' 'A' 'M' 'U' 'A' 'A' 'U' 'A' 'U' 'A' 'M' 'M'
 'U' 'A' 'U' 'A' 'A' 'U' 'A' 'A' 'U' 'A' 'U' 'U' 'U' 'M' 'A' 'A' 'M' 'M'
 'U' 'U' 'A' 'A' 'U' 'A' 'M' 'U' 'A' 'M' 'U' 'M' 'U' 'U' 'M' 'U' 'U' 'M'
 'U' 'A' 'U' 'A' 'U' 'A' 'A' 'A' 'A' 'A' 'A' 'A' 'A' 'M' 'U' 'U' 'A' 'A'
 'M' 'M' 'M' 'M' 'A' 'A' 'A' 'M' 'U' 'A' 'M' 'A' 'U' 'U' 'A' 'U' 'A' 'U'
 'M' 'U' 'M' 'U' 'U' 'U' 'A' 'A' 'A' 'A' 'U' 'M' 'A' 'U' 'M' 'A' 'A' 'U'
 'U' 'A' 'M' 'U' 'U' 'U' 'A' 'A' 'U' 'U' 'U' 'U' 'A' 'U' 'U' 'M' 'M' 'U']"
42001,1,124,81,43,74,0,1,"['A' 'U' 'U' 'U' 'U' 'M' 'U' 'U' 'M' 'M' 'U' 'U' 'U' 'U' 'A' 'A' 'U' 'A'
 'U' 'A' 'A' 'U' 'A' 'M' 'U' 'U' 'U' 'U' 'A' 'M' 'M' 'M' 'A' 'A' 'A' 'M'
 'A' 'U' 'A' 'A' 'A' 'A' 'U' 'A' 'U' 'A' 'U' 'U' 'A' 'A' 'U' 'U' 'U' 'A'
 'U' 'U' 'U' 'U' 'A' 'M' 'U' 'U' 'A' 'M' 'A' 'M' 'U' 'M' 'M' 'M' 'M' 'M'
 'M' 'M' 'M' 'A' 'U' 'A' 'U' 'A' 'M' 'U' 'U' 'U' 'A' 'A' 'U' 'A' 'M' 'U'
 'U' 'A' 'U' 'A' 'A' 'A' 'A' 'A' 'U' 'A' 'A' 'U' 'U' 'M' 'A' 'A' 'M' 'M'
 'U' 'U' 'A' 'A' 'A' 'A' 'M' 'U' 'A' 'M' 'A' 'M' 'U' 'U' 'M' 'U' 'U' 'M'
 'M' 'A' 'U' 'A' 'U' 'A' 'A' 'A' 'A' 'A' 'A' 'A' 'A' 'M' 'U' 'U' 'A' 'A'
 'U' 'M' 'M' 'U' 'A' 'A' 'A' 'M' 'U' 'A' 'A' 'A' 'A' 'U' 'A' 'U' 'A' 'A'
 'M' 'A' 'M' 'U' 'U' 'U' 'M' 'U' 'A' 'A' 'A' 'U' 'A' 'U' 'M' 'A' 'A' 'U'
 'U' 'A' 'M' 'U' 'U' 'U' 'A' 'A' 'U' 'A' 'U' 'M' 'A' 'U' 'A' 'M' 'M' 'M']"
42101,0,126,74,52,72,0,0,"['A' 'U' 'U' 'U' 'U' 'M' 'U' 'M' 'U' 'M' 'U' 'U' 'U' 'A' 'A' 'A' 'U' 'U'
 'U' 'A' 'A' 'U' 'U' 'M' 'U' 'U' 'M' 'U' 'A' 'M' 'M' 'M' 'U' 'U' 'A' 'M'
 'A' 'U' 'A' 'A' 'A' 'U' 'A' 'U' 'M' 'U' 'U' 'U' 'U' 'A' 'U' 'U' 'U' 'A'
 'U' 'A' 'U' 'U' 'U' 'M' 'U' 'U' 'A' 'M' 'A' 'M' 'M' 'U' 'M' 'M' 'M' 'M'
 'M' 'M' 'M' 'U' 'U' 'A' 'U' 'A' 'M' 'U' 'A' 'U' 'A' 'U' 'A' 'A' 'M' 'U'
 'M' 'A' 'U' 'A' 'A' 'A' 'A' 'A' 'U' 'A' 'A' 'U' 'U' 'M' 'A' 'A' 'M' 'M'
 'U' 'M' 'A' 'A' 'A' 'A' 'M' 'U' 'A' 'M' 'U' 'M' 'U' 'M' 'M' 'M' 'U' 'M'
 'M' 'A' 'A' 'M' 'U' 'A' 'A' 'A' 'A' 'A' 'A' 'A' 'A' 'M' 'A' 'U' 'U' 'A'
 'M' 'M' 'M' 'U' 'A' 'A' 'A' 'M' 'U' 'A' 'A' 'A' 'A' 'U' 'U' 'U' 'A' 'A'
 'M' 'A' 'M' 'A' 'U' 'U' 'M' 'U' 'A' 'A' 'A' 'U' 'A' 'U' 'M' 'A' 'A' 'U'
 'A' 'A' 'U' 'U' 'U' 'U' 'A' 'A' 'U' 'A' 'U' 'M' 'M' 'M' 'A' 'M' 'M' 'M']"
42201,1,135,78,57,63,1,0,"['A' 'U' 'M' 'U' 'U' 'M' 'U' 'M' 'U' 'U' 'U' 'M' 'U' 'A' 'A' 'A' 'U' 'U'
 'M' 'A' 'A' 'U' 'U' 'M' 'U' 'M' 'M' 'U' 'U' 'U' 'M' 'M' 'A' 'M' 'A' 'M'
 'A' 'M' 'A' 'A' 'U' 'A' 'A' 'A' 'U' 'A' 'U' 'U' 'U' 'A' 'M' 'U' 'U' 'A'
 'U' 'A' 'A' 'U' 'U' 'M' 'U' 'U' 'A' 'M' 'A' 'M' 'M' 'U' 'M' 'M' 'M' 'M'
 'M' 'M' 'M' 'U' 'M' 'A' 'U' 'A' 'M' 'U' 'A' 'U' 'A' 'U' 'A' 'A' 'M' 'U'
 'M' 'U' 'M' 'A' 'U' 'A' 'A' 'A' 'U' 'U' 'A' 'U' 'U' 'M' 'A' 'A' 'M' 'M'
 'U' 'M' 'A' 'A' 'A' 'A' 'M' 'A' 'A' 'U' 'U' 'M' 'U' 'M' 'M' 'U' 'A' 'M'
 'U' 'A' 'U' 'M' 'M' 'A' 'A' 'A' 'A' 'A' 'A' 'A' 'A' 'U' 'A' 'U' 'U' 'A'
 'M' 'M' 'M' 'A' 'U' 'A' 'A' 'M' 'A' 'A' 'A' 'A' 'A' 'U' 'M' 'U' 'A' 'A'
 'U' 'A' 'M' 'A' 'U' 'U' 'M' 'U' 'A' 'A' 'A' 'U' 'A' 'M' 'M' 'A' 'A' 'M'
 'A' 'A' 'A' 'A' 'U' 'U' 'A' 'A' 'M' 'A' 'M' 'M' 'U' 'M' 'A' 'M' 'M' 'U']"
42301,0,134,81,53,64,1,0,"['A' 'M' 'M' 'M' 'U' 'M' 'A' 'M' 'U' 'U' 'U' 'U' 'U' 'A' 'A' 'A' 'M' 'U'
 'U' 'A' 'A' 'U' 'U' 'M' 'A' 'M' 'U' 'M' 'U' 'M' 'M' 'U' 'A' 'M' 'A' 'M'
 'U' 'M' 'A' 'A' 'A' 'U' 'A' 'A' 'A' 'A' 'U' 'A' 'M' 'A' 'M' 'U' 'M' 'A'
 'U' 'A' 'A' 'U' 'U' 'M' 'U' 'U' 'U' 'M' 'A' 'M' 'M' 'M' 'M' 'M' 'U' 'M'
 'M' 'M' 'M' 'U' 'M' 'A' 'A' 'A' 'U' 'U' 'A' 'U' 'A' 'M' 'A' 'U' 'M' 'U'
 'U' 'U' 'M' 'U' 'A' 'A' 'A' 'A' 'U' 'U' 'U' 'U' 'U' 'A' 'A' 'A' 'M' 'U'
 'U' 'M' 'A' 'A' 'A' 'A' 'U' 'M' 'A' 'A' 'M' 'M' 'A' 'M' 'M' 'U' 'U' 'U'
 'U' 'A' 'U' 'U' 'M' 'A' 'A' 'A' 'A' 'A' 'A' 'A' 'A' 'U' 'A' 'U' 'U' 'A'
 'M' 'U' 'M' 'A' 'U' 'U' 'A' 'M' 'A' 'A' 'A' 'A' 'A' 'A' 'U' 'U' 'A' 'A'
 'U' 'M' 'M' 'A' 'U' 'A' 'M' 'U' 'A' 'A' 'A' 'U' 'A' 'M' 'M' 'A' 'A' 'M'
 'U' 'A' 'A' 'A' 'M' 'A' 'A' 'A' 'U' 'A' 'M' 'M' 'U' 'U' 'A' 'A' 'M' 'U']"
42401,0,131,83,48,67,0,1,"['A' 'M' 'U' 'M' 'A' 'M' 'A' 'M' 'A' 'U' 'M' 'A' 'A' 'U' 'A' 'A' 'M' 'U'
 'U' 'A' 'A' 'U' 'U' 'M' 'A' 'M' 'U' 'M' 'U' 'M' 'M' 'U' 'A' 'U' 'A' 'U'
 'U' 'M' 'A' 'A' 'A' 'U' 'A' 'A' 'A' 'A' 'U' 'A' 'M' 'A' 'U' 'U' 'M' 'U'
 'U' 'A' 'U' 'A' 'U' 'U' 'U' 'U' 'A' 'M' 'A' 'M' 'M' 'M' 'M' 'M' 'M' 'U'
 'M' 'M' 'M' 'M' 'M' 'A' 'A' 'A' 'A' 'A' 'A' 'U' 'A' 'M' 'A' 'U' 'M' 'U'
 'M' 'U' 'U' 'U' 'A' 'A' 'A' 'A' 'A' 'M' 'U' 'U' 'U' 'A' 'U' 'A' 'M' 'U'
 'A' 'M' 'A' 'A' 'A' 'U' 'U' 'M' 'A' 'A' 'U' 'U' 'U' 'M' 'M' 'A' 'U' 'U'
 'U' 'A' 'U' 'U' 'U' 'A' 'A' 'A' 'A' 'A' 'A' 'A' 'A' 'A' 'A' 'U' 'U' 'U'
 'M' 'A' 'U' 'A' 'A' 'U' 'A' 'M' 'A' 'U' 'A' 'A' 'A' 'A' 'U' 'M' 'A' 'A'
 'U' 'U' 'U' 'U' 'U' 'A' 'M' 'U' 'A' 'A' 'U' 'U' 'U' 'M' 'M' 'U' 'A' 'M'
 'M' 'U' 'A' 'A' 'M' 'A' 'A' 'A' 'M' 'U' 'M' 'M' 'U' 'A' 'A' 'A' 'M' 'A']"
42501,0,126,76,50,72,1,0,"['A' 'M' 'U' 'M' 'A' 'M' 'A' 'M' 'A' 'U' 'U' 'A' 'U' 'M' 'A' 'A' 'A' 'U'
 'U' 'A' 'A' 'U' 'U' 'M' 'A' 'U' 'U' 'M' 'U' 'U' 'U' 'U' 'U' 'M' 'A' 'U'
 'U' 'M' 'A' 'U' 'A' 'U' 'A' 'A' 'A' 'U' 'U' 'A' 'M' 'A' 'U' 'U' 'M' 'A'
 'U' 'A' 'U' 'A' 'U' 'U' 'U' 'U' 'U' 'M' 'U' 'M' 'M' 'M' 'M' 'M' 'U' 'M'
 'M' 'M' 'M' 'U' 'M' 'A' 'A' 'A' 'A' 'A' 'A' 'U' 'A' 'M' 'A' 'U' 'M' 'M'
 'U' 'U' 'U' 'U' 'U' 'A' 'A' 'A' 'A' 'M' 'U' 'U' 'M' 'A' 'U' 'A' 'M' 'U'
 'U' 'M' 'U' 'U' 'A' 'U' 'A' 'M' 'A' 'A' 'U' 'M' 'M' 'M' 'M' 'A' 'M' 'M'
 'U' 'A' 'U' 'U' 'U' 'A' 'A' 'A' 'A' 'A' 'A' 'A' 'A' 'A' 'U' 'U' 'U' 'A'
 'U' 'U' 'U' 'U' 'A' 'U' 'A' 'M' 'U' 'U' 'A' 'A' 'A' 'A' 'M' 'M' 'A' 'A'
 'A' 'A' 'A' 'U' 'A' 'A' 'M' 'U' 'A' 'A' 'M' 'U' 'A' 'M' 'M' 'U' 'A' 'M'
 'M' 'U' 'A' 'A' 'M' 'A' 'A' 'A' 'U' 'U' 'M' 'M' 'U' 'A' 'U' 'M' 'M' 'A']"
42601,2,129,75,54,69,0,0,"['A' 'M' 'A' 'M' 'A' 'M' 'A' 'U' 'U' 'A' 'A' 'A' 'U' 'M' 'A' 'A' 'A' 'A'
 'U' 'A' 'A' 'U' 'U' 'M' 'A' 'U' 'M' 'M' 'U' 'U' 'U' 'U' 'U' 'U' 'U' 'A'
 'U' 'M' 'A' 'U' 'A' 'U' 'A' 'A' 'A' 'U' 'U' 'A' 'M' 'A' 'U' 'U' 'M' 'A'
 'U' 'U' 'A' 'A' 'A' 'U' 'A' 'M' 'U' 'M' 'U' 'M' 'M' 'M' 'M' 'M' 'M' 'M'
 'M' 'M' 'U' 'U' 'M' 'A' 'A' 'A' 'U' 'A' 'A' 'A' 'A' 'M' 'A' 'M' 'U' 'M'
 'U' 'A' 'U' 'U' 'U' 'U' 'A' 'A' 'A' 'M' 'U' 'U' 'M' 'A' 'U' 'A' 'M' 'U'
 'U' 'M' 'U' 'U' 'U' 'U' 'A' 'M' 'A' 'A' 'U' 'M' 'U' 'M' 'M' 'U' 'M' 'M'
 'U' 'A' 'U' 'M' 'U' 'A' 'A' 'A' 'A' 'A' 'U' 'A' 'A' 'A' 'U' 'A' 'A' 'A'
 'U' 'A' 'A' 'U' 'M' 'U' 'A' 'M' 'U' 'U' 'A' 'U' 'A' 'U' 'M' 'M' 'A' 'A'
 'A' 'A' 'A' 'M' 'A' 'M' 'M' 'M' 'A' 'U' 'M' 'U' 'A' 'M' 'U' 'U' 'U' 'M'
 'M' 'U' 'A' 'M' 'M' 'U' 'A' 'U' 'M' 'A' 'M' 'M' 'A' 'A' 'U' 'U' 'M' 'A']"
42701,1,132,72,60,66,0,0,"['A' 'U' 'A' 'M' 'A' 'A' 'U' 'A' 'U' 'U' 'A' 'A' 'U' 'M' 'A' 'A' 'A' 'A'
 'U' 'U' 'U' 'M' 'U' 'M' 'A' 'M' 'M' 'M' 'M' 'U' 'U' 'U' 'A' 'U' 'U' 'A'
 'U' 'M' 'M' 'M' 'A' 'U' 'A' 'M' 'A' 'M' 'U' 'A' 'M' 'A' 'U' 'U' 'M' 'A'
 'M' 'U' 'A' 'U' 'A' 'U' 'U' 'M' 'U' 'M' 'U' 'M' 'M' 'M' 'M' 'M' 'M' 'U'
 'M' 'M' 'M' 'A' 'U' 'A' 'A' 'A' 'U' 'A' 'A' 'U' 'A' 'U' 'A' 'U' 'A' 'M'
 'U' 'A' 'U' 'U' 'A' 'M' 'A' 'U' 'U' 'M' 'U' 'U' 'M' 'A' 'A' 'A' 'M' 'M'
 'U' 'M' 'U' 'U' 'U' 'U' 'U' 'U' 'A' 'A' 'U' 'M' 'M' 'M' 'M' 'U' 'M' 'M'
 'M' 'A' 'U' 'M' 'U' 'A' 'A' 'A' 'A' 'A' 'A' 'A' 'A' 'A' 'M' 'A' 'A' 'U'
 'M' 'A' 'A' 'U' 'M' 'U' 'A' 'M' 'U' 'U' 'A' 'M' 'A' 'U' 'M' 'M' 'A' 'A'
 'A' 'U' 'A' 'U' 'A' 'U' 'M' 'M' 'A' 'A' 'M' 'A' 'A' 'U' 'M' 'U' 'U' 'M'
 'M' 'U' 'A' 'M' 'A' 'A' 'U' 'U' 'M' 'A' 'U' 'M' 'A' 'A' 'M' 'U' 'M' 'A']"
42801,1,132,68,64,66,0,0,"['A' 'M' 'A' 'M' 'A' 'A' 'U' 'A' 'U' 'U' 'U' 'U' 'U' 'M' 'A' 'A' 'A' 'U'
 'U' 'U' 'A' 'M' 'U' 'M' 'A' 'U' 'M' 'M' 'M' 'U' 'U' 'M' 'U' 'A' 'U' 'A'
 'U' 'M' 'A' 'M' 'A' 'U' 'A' 'U' 'A' 'M' 'M' 'A' 'M' 'A' 'U' 'U' 'M' 'A'
 'M' 'M' 'A' 'A' 'A' 'U' 'U' 'M' 'U' 'M' 'U' 'M' 'U' 'M' 'M' 'M' 'M' 'M'
 'M' 'M' 'M' 'A' 'A' 'A' 'A' 'A' 'M' 'A' 'U' 'A' 'A' 'U' 'A' 'M' 'U' 'M'
 'U' 'A' 'U' 'U' 'A' 'M' 'A' 'A' 'U' 'M' 'M' 'U' 'M' 'A' 'A' 'U' 'U' 'M'
 'M' 'M' 'U' 'U' 'U' 'U' 'A' 'U' 'A' 'M' 'U' 'M' 'M' 'M' 'U' 'M' 'U' 'M'
 'M' 'A' 'U' 'M' 'U' 'U' 'A' 'A' 'A' 'A' 'A' 'A' 'A' 'A' 'U' 'U' 'A' 'M'
 'M' 'M' 'A' 'U' 'M' 'U' 'A' 'M' 'A' 'U' 'U' 'A' 'A' 'M' 'M' 'M' 'A' 'A'
 'A' 'U' 'A' 'U' 'U' 'U' 'M' 'U' 'A' 'A' 'M' 'A' 'A' 'M' 'U' 'U' 'M' 'M'
 'M' 'U' 'A' 'M' 'A' 'U' 'U' 'U' 'U' 'A' 'U' 'M' 'A' 'A' 'M' 'U' 'M' 'A']"
42901,4,129,64,65,69,1,0,"['A' 'M' 'A' 'M' 'U' 'A' 'U' 'A' 'U' 'U' 'U' 'U' 'U' 'M' 'A' 'A' 'U' 'U'
 'U' 'U' 'A' 'M' 'A' 'M' 'A' 'U' 'M' 'M' 'M' 'U' 'U' 'U' 'U' 'U' 'U' 'A'
 'M' 'M' 'A' 'M' 'A' 'A' 'A' 'A' 'A' 'M' 'M' 'U' 'M' 'A' 'U' 'A' 'M' 'A'
 'M' 'M' 'U' 'A' 'U' 'M' 'U' 'M' 'U' 'U' 'M' 'U' 'M' 'M' 'M' 'M' 'M' 'M'
 'M' 'M' 'M' 'A' 'A' 'U' 'A' 'A' 'M' 'A' 'M' 'A' 'A' 'U' 'A' 'U' 'A' 'M'
 'M' 'A' 'M' 'U' 'A' 'M' 'A' 'A' 'U' 'M' 'M' 'U' 'M' 'A' 'A' 'U' 'U' 'M'
 'U' 'M' 'A' 'U' 'U' 'U' 'A' 'U' 'A' 'M' 'U' 'M' 'M' 'M' 'U' 'U' 'U' 'M'
 'M' 'A' 'U' 'M' 'U' 'A' 'A' 'A' 'A' 'A' 'A' 'A' 'A' 'A' 'U' 'U' 'U' 'M'
 'M' 'M' 'A' 'U' 'M' 'U' 'A' 'M' 'U' 'U' 'A' 'U' 'A' 'M' 'M' 'A' 'A' 'A'
 'A' 'U' 'U' 'U' 'U' 'M' 'U' 'U' 'A' 'A' 'M' 'U' 'A' 'M' 'U' 'U' 'M' 'M'
 'M' 'M' 'A' 'U' 'A' 'M' 'M' 'U' 'U' 'U' 'A' 'U' 'A' 'U' 'M' 'U' 'M' 'A']"
43001,2,125,58,67,73,0,1,"['A' 'M' 'U' 'M' 'M' 'A' 'U' 'A' 'M' 'U' 'U' 'M' 'U' 'M' 'A' 'U' 'U' 'M'
 'U' 'U' 'A' 'M' 'A' 'M' 'U' 'U' 'M' 'U' 'M' 'U' 'M' 'U' 'U' 'U' 'U' 'A'
 'M' 'M' 'A' 'M' 'U' 'A' 'A' 'A' 'A' 'M' 'M' 'U' 'U' 'U' 'U' 'A' 'M' 'A'
 'M' 'U' 'U' 'A' 'A' 'U' 'U' 'A' 'U' 'U' 'U' 'M' 'M' 'M' 'M' 'M' 'M' 'M'
 'M' 'M' 'U' 'A' 'A' 'U' 'A' 'A' 'M' 'A' 'M' 'A' 'U' 'U' 'A' 'U' 'A' 'M'
 'M' 'A' 'M' 'M' 'A' 'M' 'A' 'A' 'U' 'M' 'M' 'U' 'M' 'A' 'A' 'U' 'M' 'M'
 'U' 'U' 'A' 'M' 'M' 'A' 'U' 'U' 'U' 'M' 'U' 'U' 'M' 'M' 'U' 'U' 'U' 'M'
 'M' 'U' 'M' 'M' 'U' 'A' 'A' 'A' 'A' 'A' 'A' 'A' 'A' 'A' 'M' 'U' 'U' 'M'
 'M' 'M' 'A' 'U' 'M' 'U' 'A' 'M' 'U' 'M' 'A' 'U' 'A' 'M' 'U' 'A' 'A' 'A'
 'A' 'U' 'A' 'U' 'U' 'M' 'U' 'U' 'A' 'U' 'M' 'A' 'U' 'M' 'A' 'M' 'M' 'M'
 'U' 'M' 'A' 'U' 'A' 'M' 'U' 'U' 'U' 'U' 'A' 'U' 'U' 'U' 'M' 'A' 'M' 'U']"
43101,0,123,61,62,75,0,1,"['A' 'M' 'A' 'M' 'M' 'A' 'M' 'U' 'M' 'U' 'U' 'M' 'A' 'M' 'A' 'M' 'U' 'M'
 'A' 'A' 'A' 'A' 'A' 'M' 'U' 'A' 'M' 'A' 'A' 'U' 'M' 'A' 'U' 'U' 'U' 'A'
 'M' 'M' 'A' 'M' 'U' 'A' 'U' 'A' 'A' 'M' 'M' 'U' 'U' 'U' 'M' 'A' 'M' 'A'
 'M' 'U' 'U' 'A' 'U' 'U' 'A' 'A' 'U' 'U' 'U' 'M' 'U' 'M' 'M' 'M' 'M' 'M'
 'M' 'M' 'M' 'A' 'A' 'U' 'U' 'M' 'M' 'A' 'U' 'A' 'U' 'M' 'U' 'U' 'U' 'U'
 'M' 'A' 'U' 'M' 'A' 'U' 'A' 'A' 'U' 'M' 'M' 'U' 'U' 'A' 'A' 'U' 'M' 'M'
 'U' 'U' 'U' 'U' 'M' 'M' 'U' 'U' 'A' 'M' 'U' 'U' 'M' 'M' 'U' 'M' 'U' 'U'
 'M' 'M' 'A' 'M' 'U' 'A' 'A' 'U' 'A' 'A' 'A' 'A' 'A' 'A' 'M' 'U' 'A' 'M'
 'U' 'M' 'U' 'M' 'M' 'U' 'A' 'U' 'U' 'U' 'A' 'A' 'A' 'M' 'A' 'U' 'A' 'A'
 'A' 'M' 'A' 'U' 'U' 'M' 'U' 'U' 'U' 'U' 'U' 'A' 'U' 'M' 'A' 'M' 'M' 'U'
 'U' 'M' 'U' 'U' 'U' 'M' 'A' 'M' 'U' 'U' 'A' 'A' 'A' 'U' 'M' 'A' 'U' 'U']"
43201,1,124,59,65,74,0,0,"['A' 'M' 'A' 'M' 'M' 'U' 'U' 'U' 'M' 'U' 'U' 'U' 'A' 'M' 'U' 'M' 'U' 'M'
 'A' 'A' 'A' 'U' 'U' 'M' 'U' 'A' 'M' 'A' 'A' 'U' 'M' 'A' 'M' 'U' 'U' 'A'
 'M' 'M' 'A' 'M' 'M' 'A' 'U' 'A' 'A' 'M' 'M' 'U' 'M' 'U' 'M' 'A' 'M' 'A'
 'M' 'U' 'U' 'A' 'A' 'U' 'U' 'A' 'U' 'U' 'M' 'M' 'U' 'M' 'M' 'M' 'M' 'M'
 'M' 'M' 'M' 'A' 'A' 'A' 'U' 'M' 'M' 'A' 'U' 'A' 'U' 'M' 'U' 'U' 'U' 'U'
 'M' 'A' 'M' 'M' 'A' 'U' 'A' 'A' 'U' 'M' 'M' 'U' 'U' 'A' 'U' 'U' 'M' 'M'
 'U' 'U' 'U' 'U' 'M' 'M' 'A' 'U' 'A' 'M' 'U' 'U' 'U' 'M' 'U' 'M' 'A' 'U'
 'M' 'M' 'A' 'M' 'U' 'A' 'A' 'A' 'A' 'A' 'A' 'A' 'A' 'A' 'M' 'U' 'A' 'M'
 'U' 'M' 'U' 'U' 'M' 'U' 'A' 'U' 'U' 'M' 'U' 'U' 'A' 'A' 'A' 'U' 'A' 'A'
 'A' 'M' 'A' 'M' 'U' 'M' 'U' 'U' 'U' 'U' 'U' 'U' 'U' 'M' 'A' 'M' 'M' 'U'
 'U' 'M' 'U' 'M' 'U' 'M' 'A' 'M' 'U' 'A' 'A' 'A' 'A' 'U' 'M' 'A' 'U' 'U']"
43301,2,129,61,68,69,1,0,"['A' 'U' 'A' 'M' 'M' 'U' 'U' 'U' 'M' 'M' 'U' 'M' 'A' 'M' 'U' 'M' 'U' 'U'
 'U' 'U' 'A' 'U' 'M' 'M' 'U' 'A' 'M' 'A' 'A' 'A' 'M' 'A' 'M' 'U' 'U' 'A'
 'M' 'U' 'A' 'U' 'M' 'U' 'M' 'U' 'A' 'M' 'M' 'A' 'M' 'M' 'M' 'A' 'M' 'U'
 'M' 'U' 'U' 'A' 'A' 'U' 'U' 'A' 'M' 'M' 'M' 'M' 'U' 'M' 'M' 'M' 'M' 'M'
 'M' 'M' 'M' 'A' 'U' 'A' 'U' 'M' 'M' 'A' 'U' 'A' 'A' 'M' 'U' 'U' 'U' 'U'
 'M' 'A' 'M' 'M' 'A' 'U' 'A' 'A' 'U' 'M' 'U' 'A' 'U' 'A' 'U' 'U' 'M' 'M'
 'U' 'A' 'A' 'U' 'M' 'M' 'A' 'M' 'A' 'M' 'U' 'U' 'A' 'M' 'A' 'M' 'A' 'U'
 'U' 'M' 'A' 'U' 'U' 'A' 'A' 'A' 'A' 'A' 'A' 'A' 'A' 'A' 'U' 'U' 'A' 'U'
 'M' 'M' 'U' 'U' 'M' 'U' 'A' 'U' 'U' 'M' 'U' 'U' 'A' 'A' 'A' 'A' 'A' 'U'
 'A' 'M' 'U' 'M' 'U' 'M' 'A' 'A' 'U' 'U' 'U' 'U' 'U' 'M' 'U' 'M' 'M' 'A'
 'U' 'M' 'M' 'M' 'U' 'M' 'A' 'M' 'U' 'A' 'M' 'A' 'A' 'U' 'M' 'A' 'U' 'M']"
43401,1,121,60,61,77,0,0,"['A' 'U' 'A' 'M' 'M' 'U' 'U' 'U' 'U' 'U' 'U' 'M' 'A' 'M' 'M' 'M' 'U' 'U'
 'U' 'U' 'A' 'U' 'U' 'M' 'U' 'A' 'M' 'A' 'U' 'A' 'U' 'A' 'M' 'U' 'U' 'A'
 'M' 'U' 'A' 'M' 'M' 'U' 'M' 'U' 'A' 'M' 'M' 'A' 'M' 'M' 'U' 'A' 'U' 'U'
 'M' 'A' 'U' 'A' 'A' 'U' 'U' 'A' 'M' 'M' 'M' 'M' 'M' 'M' 'M' 'M' 'M' 'M'
 'M' 'M' 'U' 'A' 'U' 'A' 'M' 'M' 'M' 'A' 'U' 'A' 'A' 'M' 'U' 'U' 'U' 'M'
 'M' 'A' 'U' 'U' 'A' 'U' 'A' 'U' 'U' 'M' 'U' 'A' 'A' 'A' 'U' 'A' 'M' 'M'
 'M' 'U' 'A' 'U' 'M' 'U' 'A' 'M' 'A' 'U' 'U' 'U' 'A' 'A' 'A' 'M' 'U' 'U'
 'M' 'M' 'U' 'A' 'U' 'A' 'A' 'A' 'A' 'A' 'A' 'A' 'A' 'A' 'U' 'U' 'A' 'U'
 'U' 'M' 'M' 'U' 'M' 'U' 'A' 'U' 'U' 'M' 'U' 'U' 'A' 'A' 'M' 'A' 'A' 'U'
 'A' 'U' 'U' 'M' 'U' 'M' 'A' 'A' 'U' 'U' 'U' 'U' 'U' 'M' 'A' 'M' 'U' 'A'
 'U' 'M' 'M' 'U' 'U' 'M' 'A' 'U' 'M' 'U' 'M' 'U' 'A' 'U' 'M' 'A' 'A' 'M']"
43501,3,130,65,65,68,0,0,"['A' 'U' 'A' 'M' 'M' 'U' 'U' 'U' 'U' 'U' 'U' 'M' 'A' 'U' 'M' 'M' 'M' 'U'
 'U' 'U' 'A' 'A' 'U' 'M' 'U' 'A' 'M' 'A' 'U' 'A' 'M' 'A' 'M' 'M' 'U' 'U'
 'M' 'A' 'A' 'M' 'M' 'U' 'M' 'U' 'A' 'M' 'M' 'A' 'M' 'M' 'M' 'U' 'U' 'U'
 'M' 'U' 'A' 'A' 'A' 'A' 'U' 'A' 'M' 'M' 'M' 'M' 'M' 'M' 'M' 'U' 'M' 'M'
 'M' 'M' 'M' 'A' 'U' 'A' 'U' 'M' 'M' 'A' 'U' 'A' 'A' 'U' 'A' 'A' 'U' 'M'
 'M' 'A' 'U' 'U' 'A' 'U' 'A' 'U' 'U' 'M' 'U' 'A' 'A' 'A' 'U' 'A' 'M' 'M'
 'M' 'U' 'U' 'U' 'M' 'A' 'A' 'M' 'A' 'U' 'U' 'U' 'A' 'A' 'A' 'M' 'U' 'M'
 'M' 'U' 'U' 'A' 'U' 'A' 'A' 'A' 'A' 'A' 'A' 'A' 'A' 'A' 'A' 'U' 'A' 'A'
 'U' 'M' 'M' 'M' 'U' 'M' 'U' 'M' 'U' 'U' 'A' 'U' 'A' 'A' 'M' 'A' 'U' 'U'
 'A' 'U' 'U' 'U' 'U' 'U' 'A' 'A' 'M' 'U' 'U' 'M' 'U' 'M' 'A' 'M' 'A' 'A'
 'U' 'M' 'M' 'U' 'U' 'M' 'A' 'M' 'M' 'U' 'M' 'M' 'A' 'M' 'M' 'A' 'U' 'A']"
43601,3,132,69,63,66,0,1,"['A' 'A' 'A' 'M' 'M' 'A' 'U' 'A' 'U' 'M' 'A' 'A' 'A' 'U' 'M' 'M' 'M' 'U'
 'U' 'U' 'U' 'A' 'U' 'M' 'A' 'A' 'U' 'A' 'U' 'A' 'M' 'A' 'U' 'U' 'U' 'U'
 'M' 'A' 'U' 'M' 'U' 'M' 'M' 'A' 'A' 'M' 'M' 'U' 'M' 'M' 'M' 'U' 'U' 'U'
 'M' 'A' 'A' 'A' 'A' 'A' 'U' 'A' 'U' 'M' 'M' 'M' 'M' 'M' 'M' 'M' 'M' 'U'
 'M' 'M' 'M' 'A' 'U' 'A' 'M' 'M' 'M' 'A' 'U' 'A' 'A' 'U' 'A' 'A' 'U' 'M'
 'M' 'A' 'M' 'U' 'A' 'U' 'U' 'U' 'M' 'U' 'U' 'A' 'A' 'A' 'A' 'A' 'M' 'M'
 'M' 'U' 'U' 'U' 'M' 'A' 'A' 'M' 'A' 'U' 'A' 'U' 'A' 'U' 'A' 'M' 'M' 'M'
 'M' 'U' 'M' 'U' 'U' 'A' 'A' 'A' 'A' 'A' 'A' 'U' 'A' 'A' 'A' 'U' 'A' 'A'
 'U' 'A' 'M' 'U' 'U' 'M' 'M' 'M' 'U' 'U' 'A' 'A' 'U' 'U' 'M' 'A' 'A' 'U'
 'A' 'U' 'M' 'U' 'A' 'U' 'A' 'A' 'M' 'U' 'M' 'M' 'U' 'U' 'A' 'M' 'U' 'A'
 'U' 'A' 'U' 'U' 'U' 'M' 'U' 'M' 'M' 'U' 'M' 'M' 'A' 'M' 'M' 'A' 'U' 'A']"
43701,1,131,68,63,67,0,0,"['A' 'A' 'U' 'M' 'M' 'A' 'M' 'A' 'U' 'M' 'A' 'U' 'A' 'U' 'M' 'M' 'M' 'U'
 'U' 'U' 'U' 'A' 'U' 'M' 'U' 'A' 'U' 'A' 'U' 'M' 'M' 'A' 'U' 'A' 'U' 'U'
 'U' 'A' 'U' 'U' 'U' 'M' 'U' 'A' 'A' 'M' 'U' 'U' 'M' 'M' 'M' 'A' 'A' 'U'
 'U' 'U' 'A' 'A' 'U' 'U' 'M' 'A' 'A' 'M' 'M' 'M' 'U' 'M' 'M' 'M' 'M' 'M'
 'M' 'M' 'M' 'A' 'M' 'A' 'U' 'M' 'U' 'A' 'U' 'A' 'A' 'U' 'A' 'A' 'U' 'M'
 'M' 'A' 'M' 'M' 'U' 'U' 'U' 'U' 'M' 'U' 'M' 'A' 'A' 'A' 'A' 'A' 'U' 'M'
 'U' 'M' 'U' 'U' 'M' 'A' 'A' 'M' 'A' 'U' 'A' 'U' 'A' 'A' 'U' 'M' 'M' 'M'
 'M' 'U' 'M' 'A' 'U' 'A' 'A' 'A' 'A' 'A' 'A' 'A' 'A' 'M' 'A' 'U' 'A' 'A'
 'U' 'U' 'M' 'U' 'A' 'M' 'M' 'M' 'M' 'U' 'A' 'A' 'U' 'U' 'M' 'A' 'A' 'U'
 'A' 'M' 'U' 'A' 'A' 'U' 'U' 'A' 'M' 'A' 'M' 'U' 'A' 'U' 'A' 'M' 'U' 'A'
 'U' 'A' 'U' 'U' 'U' 'M' 'M' 'M' 'M' 'U' 'M' 'M' 'A' 'M' 'M' 'A' 'U' 'A']"
43801,3,139,71,68,59,1,0,"['A' 'A' 'U' 'U' 'M' 'A' 'M' 'U' 'A' 'M' 'A' 'U' 'A' 'U' 'M' 'M' 'U' 'M'
 'U' 'U' 'U' 'A' 'A' 'A' 'U' 'A' 'U' 'A' 'U' 'M' 'M' 'A' 'U' 'A' 'U' 'U'
 'U' 'A' 'U' 'U' 'M' 'M' 'U' 'A' 'U' 'M' 'U' 'U' 'M' 'M' 'U' 'U' 'A' 'U'
 'U' 'A' 'U' 'A' 'U' 'M' 'M' 'A' 'A' 'M' 'M' 'M' 'M' 'M' 'M' 'U' 'M' 'M'
 'M' 'M' 'M' 'A' 'M' 'A' 'U' 'U' 'U' 'A' 'U' 'A' 'A' 'M' 'A' 'A' 'U' 'U'
 'M' 'U' 'M' 'M' 'U' 'U' 'U' 'U' 'M' 'M' 'M' 'A' 'A' 'A' 'A' 'A' 'U' 'M'
 'A' 'M' 'U' 'U' 'U' 'A' 'A' 'M' 'A' 'M' 'A' 'M' 'A' 'A' 'U' 'M' 'M' 'M'
 'M' 'U' 'M' 'A' 'U' 'A' 'A' 'A' 'A' 'A' 'A' 'A' 'A' 'M' 'U' 'M' 'A' 'A'
 'U' 'M' 'M' 'A' 'A' 'M' 'M' 'M' 'M' 'U' 'A' 'A' 'U' 'A' 'M' 'A' 'A' 'M'
 'U' 'M' 'U' 'A' 'A' 'U' 'M' 'A' 'M' 'A' 'M' 'U' 'A' 'A' 'U' 'M' 'U' 'A'
 'A' 'U' 'U' 'A' 'A' 'M' 'M' 'M' 'M' 'M' 'M' 'M' 'A' 'M' 'M' 'A' 'A' 'A']"
43901,2,136,66,70,62,0,0,"['A' 'A' 'U' 'A' 'U' 'U' 'M' 'U' 'A' 'U' 'A' 'A' 'A' 'M' 'M' 'M' 'U' 'M'
 'U' 'U' 'M' 'A' 'A' 'A' 'U' 'A' 'A' 'U' 'U' 'M' 'M' 'A' 'U' 'U' 'M' 'U'
 'M' 'A' 'A' 'U' 'M' 'M' 'M' 'A' 'U' 'M' 'U' 'U' 'M' 'M' 'U' 'U' 'U' 'U'
 'U' 'A' 'U' 'A' 'M' 'M' 'U' 'A' 'U' 'M' 'M' 'M' 'M' 'M' 'M' 'M' 'M' 'M'
 'M' 'M' 'U' 'A' 'M' 'A' 'U' 'U' 'U' 'A' 'U' 'A' 'A' 'M' 'A' 'A' 'U' 'A'
 'M' 'U' 'M' 'M' 'U' 'A' 'U' 'U' 'M' 'M' 'M' 'A' 'A' 'U' 'A' 'A' 'U' 'M'
 'U' 'M' 'U' 'U' 'M' 'A' 'A' 'M' 'A' 'M' 'A' 'M' 'A' 'A' 'M' 'M' 'M' 'U'
 'M' 'A' 'U' 'A' 'U' 'A' 'U' 'A' 'A' 'A' 'A' 'A' 'A' 'M' 'U' 'U' 'A' 'A'
 'U' 'M' 'U' 'A' 'A' 'M' 'M' 'M' 'U' 'U' 'U' 'A' 'U' 'A' 'M' 'A' 'U' 'U'
 'M' 'M' 'U' 'A' 'A' 'U' 'M' 'A' 'M' 'A' 'M' 'M' 'A' 'U' 'A' 'M' 'U' 'U'
 'U' 'A' 'U' 'A' 'M' 'M' 'M' 'M' 'M' 'M' 'M' 'M' 'A' 'M' 'M' 'A' 'A' 'A']"
44001,0,130,65,65,68,1,0,"['A' 'A' 'U' 'U' 'U' 'U' 'M' 'U' 'A' 'U' 'U' 'A' 'U' 'M' 'U' 'M' 'U' 'M'
 'M' 'U' 'M' 'U' 'A' 'U' 'U' 'A' 'A' 'U' 'U' 'M' 'M' 'A' 'U' 'U' 'M' 'U'
 'A' 'A' 'A' 'U' 'M' 'A' 'M' 'A' 'A' 'M' 'M' 'U' 'A' 'M' 'U' 'U' 'A' 'U'
 'M' 'A' 'U' 'A' 'M' 'M' 'U' 'A' 'U' 'M' 'M' 'M' 'M' 'M' 'M' 'U' 'M' 'M'
 'M' 'M' 'M' 'A' 'M' 'U' 'U' 'U' 'U' 'U' 'M' 'A' 'A' 'M' 'U' 'A' 'U' 'A'
 'M' 'M' 'M' 'M' 'U' 'A' 'M' 'M' 'M' 'M' 'M' 'A' 'A' 'U' 'A' 'U' 'U' 'U'
 'U' 'M' 'U' 'U' 'M' 'A' 'A' 'M' 'A' 'U' 'A' 'U' 'A' 'A' 'U' 'M' 'M' 'U'
 'M' 'U' 'U' 'A' 'A' 'A' 'A' 'A' 'A' 'A' 'A' 'A' 'A' 'M' 'U' 'U' 'A' 'A'
 'U' 'M' 'U' 'A' 'A' 'U' 'M' 'A' 'U' 'U' 'U' 'A' 'A' 'A' 'M' 'A' 'A' 'M'
 'M' 'M' 'A' 'A' 'U' 'U' 'M' 'A' 'U' 'A' 'U' 'M' 'A' 'U' 'A' 'M' 'U' 'A'
 'U' 'U' 'M' 'M' 'U' 'M' 'M' 'M' 'U' 'M' 'M' 'M' 'A' 'U' 'M' 'A' 'A' 'A']"
44101,2,126,63,63,72,0,1,"['A' 'A' 'U' 'A' 'U' 'U' 'M' 'U' 'A' 'U' 'U' 'A' 'U' 'M' 'A' 'U' 'U' 'M'
 'U' 'M' 'M' 'U' 'A' 'U' 'U' 'M' 'A' 'U' 'U' 'U' 'M' 'A' 'U' 'M' 'U' 'U'
 'A' 'U' 'A' 'U' 'M' 'A' 'M' 'A' 'A' 'M' 'M' 'U' 'A' 'M' 'U' 'U' 'A' 'U'
 'M' 'U' 'M' 'A' 'M' 'M' 'U' 'A' 'U' 'M' 'M' 'M' 'M' 'M' 'M' 'M' 'M' 'M'
 'U' 'M' 'M' 'A' 'M' 'U' 'U' 'U' 'U' 'M' 'M' 'U' 'A' 'M' 'U' 'A' 'U' 'A'
 'U' 'M' 'U' 'M' 'M' 'A' 'U' 'M' 'M' 'M' 'M' 'A' 'A' 'U' 'A' 'U' 'U' 'M'
 'U' 'M' 'U' 'U' 'M' 'A' 'A' 'U' 'A' 'A' 'U' 'U' 'U' 'A' 'A' 'M' 'M' 'U'
 'U' 'U' 'M' 'A' 'A' 'U' 'A' 'A' 'A' 'A' 'U' 'A' 'A' 'M' 'U' 'A' 'A' 'U'
 'U' 'M' 'A' 'A' 'A' 'U' 'M' 'A' 'A' 'U' 'U' 'A' 'A' 'A' 'M' 'U' 'A' 'M'
 'M' 'M' 'A' 'A' 'M' 'A' 'M' 'A' 'U' 'A' 'U' 'U' 'A' 'A' 'U' 'M' 'U' 'A'
 'M' 'M' 'U' 'U' 'U' 'M' 'M' 'M' 'U' 'M' 'U' 'M' 'A' 'A' 'M' 'U' 'A' 'A']"
44201,2,134,67,67,64,0,0,"['A' 'A' 'U' 'A' 'M' 'U' 'M' 'U' 'A' 'A' 'A' 'A' 'M' 'M' 'A' 'U' 'U' 'M'
 'U' 'M' 'U' 'U' 'A' 'A' 'U' 'M' 'A' 'U' 'U' 'U' 'U' 'A' 'U' 'M' 'M' 'U'
 'A' 'U' 'A' 'A' 'M' 'U' 'M' 'A' 'U' 'M' 'M' 'M' 'U' 'M' 'U' 'U' 'A' 'U'
 'U' 'U' 'M' 'A' 'M' 'M' 'M' 'A' 'U' 'M' 'M' 'M' 'M' 'U' 'M' 'M' 'M' 'M'
 'M' 'M' 'M' 'A' 'U' 'U' 'U' 'U' 'M' 'M' 'M' 'M' 'A' 'M' 'U' 'A' 'U' 'A'
 'U' 'M' 'U' 'U' 'M' 'A' 'U' 'M' 'U' 'M' 'M' 'A' 'U' 'A' 'A' 'U' 'M' 'U'
 'U' 'A' 'U' 'U' 'M' 'A' 'A' 'U' 'A' 'A' 'A' 'M' 'U' 'A' 'A' 'M' 'M' 'U'
 'U' 'M' 'M' 'U' 'A' 'A' 'A' 'A' 'A' 'A' 'A' 'A' 'A' 'M' 'A' 'A' 'A' 'M'
 'U' 'M' 'A' 'A' 'A' 'U' 'M' 'U' 'U' 'A' 'U' 'A' 'A' 'A' 'M' 'U' 'A' 'M'
 'M' 'M' 'A' 'A' 'U' 'A' 'M' 'A' 'A' 'A' 'M' 'U' 'A' 'M' 'U' 'M' 'U' 'A'
 'M' 'M' 'M' 'A' 'U' 'M' 'U' 'U' 'M' 'U' 'M' 'M' 'A' 'A' 'M' 'U' 'A' 'U']"
44301,3,130,63,67,68,0,0,"['A' 'A' 'U' 'A' 'U' 'M' 'U' 'A' 'A' 'A' 'A' 'A' 'M' 'M' 'A' 'U' 'A' 'U'
 'U' 'U' 'U' 'U' 'A' 'A' 'U' 'M' 'A' 'U' 'U' 'U' 'U' 'U' 'U' 'M' 'M' 'U'
 'A' 'A' 'A' 'U' 'M' 'U' 'M' 'A' 'M' 'M' 'M' 'M' 'U' 'U' 'M' 'U' 'A' 'U'
 'U' 'M' 'M' 'U' 'M' 'M' 'M' 'A' 'U' 'M' 'M' 'M' 'M' 'U' 'M' 'M' 'M' 'M'
 'M' 'M' 'M' 'U' 'U' 'A' 'M' 'A' 'M' 'M' 'M' 'M' 'A' 'M' 'M' 'M' 'A' 'U'
 'M' 'U' 'U' 'U' 'M' 'A' 'U' 'M' 'U' 'A' 'M' 'A' 'A' 'U' 'A' 'M' 'M' 'U'
 'M' 'A' 'U' 'U' 'M' 'U' 'A' 'U' 'A' 'U' 'A' 'M' 'A' 'A' 'A' 'A' 'M' 'U'
 'U' 'M' 'M' 'U' 'A' 'A' 'A' 'A' 'A' 'A' 'A' 'A' 'A' 'M' 'A' 'A' 'U' 'M'
 'U' 'M' 'A' 'U' 'A' 'M' 'M' 'U' 'M' 'A' 'U' 'A' 'A' 'A' 'M' 'U' 'U' 'M'
 'M' 'M' 'A' 'A' 'A' 'A' 'U' 'U' 'A' 'A' 'U' 'A' 'U' 'M' 'U' 'M' 'U' 'U'
 'U' 'M' 'M' 'A' 'U' 'M' 'U' 'U' 'U' 'U' 'M' 'M' 'U' 'A' 'M' 'U' 'A' 'U']"
44401,2,132,66,66,66,1,0,"['A' 'U' 'U' 'A' 'U' 'M' 'U' 'A' 'A' 'A' 'A' 'A' 'M' 'M' 'A' 'U' 'A' 'U'
 'A' 'M' 'U' 'U' 'A' 'A' 'A' 'M' 'A' 'U' 'U' 'A' 'U' 'M' 'A' 'M' 'U' 'M'
 'A' 'A' 'A' 'U' 'M' 'U' 'M' 'A' 'M' 'U' 'M' 'M' 'U' 'U' 'M' 'M' 'A' 'M'
 'U' 'U' 'U' 'A' 'M' 'U' 'M' 'A' 'U' 'M' 'A' 'M' 'M' 'M' 'M' 'M' 'M' 'M'
 'U' 'M' 'M' 'M' 'U' 'A' 'M' 'A' 'A' 'U' 'M' 'M' 'A' 'M' 'M' 'M' 'A' 'A'
 'M' 'U' 'U' 'U' 'M' 'A' 'M' 'M' 'U' 'A' 'M' 'A' 'A' 'M' 'A' 'M' 'M' 'U'
 'M' 'U' 'U' 'M' 'M' 'U' 'A' 'U' 'U' 'U' 'A' 'M' 'A' 'U' 'A' 'A' 'M' 'U'
 'U' 'M' 'M' 'U' 'U' 'A' 'A' 'A' 'A' 'A' 'A' 'A' 'A' 'M' 'A' 'U' 'M' 'M'
 'U' 'A' 'A' 'U' 'A' 'U' 'M' 'A' 'M' 'A' 'U' 'A' 'A' 'U' 'M' 'U' 'U' 'M'
 'M' 'M' 'A' 'U' 'A' 'A' 'M' 'U' 'A' 'A' 'U' 'A' 'A' 'M' 'U' 'U' 'U' 'U'
 'U' 'M' 'U' 'A' 'U' 'M' 'M' 'U' 'U' 'U' 'M' 'M' 'U' 'A' 'U' 'U' 'A' 'U']"
44501,0,130,69,61,68,0,0,"['A' 'A' 'U' 'A' 'U' 'U' 'U' 'A' 'M' 'A' 'A' 'A' 'U' 'U' 'A' 'M' 'A' 'U'
 'A' 'M' 'A' 'U' 'A' 'A' 'M' 'M' 'A' 'A' 'A' 'A' 'M' 'U' 'A' 'M' 'U' 'M'
 'A' 'A' 'A' 'U' 'M' 'U' 'M' 'A' 'M' 'M' 'U' 'M' 'U' 'U' 'U' 'U' 'U' 'U'
 'U' 'U' 'U' 'A' 'M' 'A' 'M' 'A' 'U' 'M' 'A' 'M' 'U' 'M' 'M' 'M' 'M' 'M'
 'M' 'M' 'M' 'M' 'U' 'A' 'M' 'A' 'A' 'U' 'M' 'U' 'A' 'M' 'M' 'U' 'A' 'A'
 'U' 'A' 'U' 'U' 'U' 'A' 'M' 'U' 'U' 'A' 'M' 'A' 'A' 'M' 'A' 'M' 'M' 'U'
 'M' 'M' 'U' 'U' 'M' 'M' 'A' 'M' 'U' 'U' 'A' 'M' 'A' 'A' 'A' 'A' 'M' 'U'
 'U' 'U' 'M' 'U' 'U' 'A' 'A' 'A' 'A' 'A' 'A' 'A' 'A' 'M' 'A' 'A' 'M' 'U'
 'M' 'A' 'A' 'U' 'U' 'U' 'M' 'A' 'M' 'A' 'U' 'A' 'A' 'U' 'M' 'U' 'A' 'U'
 'M' 'M' 'A' 'M' 'A' 'A' 'M' 'M' 'A' 'U' 'M' 'U' 'U' 'M' 'U' 'A' 'U' 'U'
 'U' 'M' 'U' 'A' 'U' 'M' 'U' 'U' 'M' 'U' 'M' 'M' 'U' 'A' 'U' 'U' 'A' 'U']"
44601,4,132,75,57,66,0,1,"['A' 'A' 'A' 'A' 'U' 'A' 'U' 'A' 'M' 'U' 'A' 'A' 'U' 'U' 'A' 'U' 'A' 'U'
 'A' 'M' 'A' 'U' 'U' 'A' 'M' 'M' 'A' 'A' 'A' 'A' 'M' 'U' 'A' 'M' 'U' 'M'
 'A' 'A' 'A' 'A' 'M' 'U' 'M' 'A' 'M' 'U' 'U' 'M' 'U' 'U' 'A' 'M' 'U' 'M'
 'A' 'M' 'U' 'A' 'M' 'U' 'U' 'A' 'M' 'U' 'A' 'U' 'M' 'M' 'M' 'M' 'M' 'M'
 'M' 'M' 'M' 'M' 'U' 'A' 'M' 'A' 'A' 'A' 'A' 'U' 'A' 'M' 'M' 'U' 'A' 'A'
 'A' 'A' 'U' 'U' 'U' 'A' 'M' 'U' 'A' 'A' 'M' 'A' 'U' 'M' 'U' 'U' 'M' 'U'
 'U' 'M' 'U' 'A' 'M' 'M' 'A' 'M' 'A' 'U' 'A' 'M' 'A' 'A' 'A' 'A' 'U' 'U'
 'M' 'A' 'U' 'U' 'U' 'A' 'A' 'A' 'A' 'A' 'A' 'A' 'A' 'M' 'U' 'A' 'M' 'U'
 'M' 'U' 'U' 'U' 'U' 'U' 'M' 'A' 'M' 'U' 'U' 'A' 'A' 'U' 'M' 'A' 'A' 'M'
 'U' 'M' 'A' 'M' 'A' 'A' 'M' 'U' 'A' 'A' 'M' 'M' 'M' 'M' 'A' 'A' 'U' 'U'
 'U' 'M' 'U' 'A' 'U' 'M' 'U' 'A' 'M' 'U' 'M' 'U' 'U' 'A' 'U' 'U' 'U' 'U']"
44701,1,125,73,52,73,0,0,"['A' 'U' 'A' 'A' 'U' 'A' 'M' 'A' 'U' 'M' 'A' 'U' 'U' 'A' 'A' 'U' 'U' 'U'
 'A' 'M' 'A' 'U' 'U' 'A' 'M' 'U' 'A' 'U' 'A' 'A' 'M' 'U' 'A' 'M' 'U' 'M'
 'A' 'A' 'A' 'A' 'M' 'A' 'A' 'U' 'M' 'U' 'U' 'U' 'M' 'U' 'A' 'M' 'U' 'M'
 'A' 'U' 'A' 'A' 'U' 'A' 'A' 'A' 'M' 'U' 'A' 'M' 'M' 'M' 'M' 'U' 'M' 'M'
 'M' 'M' 'M' 'M' 'U' 'A' 'U' 'U' 'A' 'A' 'U' 'A' 'A' 'U' 'M' 'U' 'A' 'A'
 'A' 'A' 'U' 'U' 'U' 'A' 'M' 'U' 'A' 'A' 'M' 'U' 'U' 'M' 'U' 'U' 'M' 'U'
 'U' 'M' 'U' 'A' 'M' 'U' 'A' 'M' 'A' 'U' 'A' 'M' 'A' 'A' 'A' 'U' 'M' 'U'
 'U' 'A' 'U' 'U' 'U' 'A' 'A' 'A' 'A' 'A' 'U' 'A' 'A' 'M' 'U' 'A' 'M' 'U'
 'M' 'U' 'M' 'U' 'U' 'A' 'M' 'A' 'M' 'U' 'U' 'A' 'A' 'U' 'M' 'A' 'A' 'M'
 'U' 'M' 'A' 'U' 'A' 'U' 'M' 'U' 'U' 'A' 'M' 'M' 'M' 'M' 'A' 'A' 'U' 'A'
 'U' 'A' 'M' 'A' 'U' 'M' 'U' 'A' 'U' 'U' 'M' 'U' 'U' 'U' 'A' 'M' 'U' 'M']"
44801,2,134,81,53,64,1,0,"['A' 'U' 'U' 'A' 'U' 'U' 'M' 'A' 'U' 'M' 'A' 'U' 'U' 'A' 'A' 'U' 'U' 'A'
 'U' 'U' 'A' 'M' 'U' 'U' 'U' 'U' 'A' 'U' 'A' 'A' 'M' 'U' 'A' 'U' 'M' 'M'
 'A' 'A' 'U' 'A' 'M' 'A' 'M' 'U' 'M' 'U' 'U' 'U' 'M' 'U' 'A' 'M' 'A' 'M'
 'U' 'U' 'A' 'A' 'U' 'A' 'A' 'A' 'M' 'U' 'A' 'M' 'M' 'M' 'M' 'M' 'M' 'M'
 'M' 'U' 'M' 'M' 'U' 'A' 'A' 'U' 'A' 'A' 'U' 'A' 'A' 'U' 'U' 'A' 'A' 'A'
 'A' 'A' 'U' 'U' 'U' 'M' 'M' 'M' 'A' 'A' 'M' 'U' 'M' 'M' 'M' 'A' 'M' 'U'
 'U' 'A' 'M' 'U' 'M' 'A' 'A' 'A' 'A' 'A' 'A' 'M' 'A' 'A' 'A' 'A' 'M' 'U'
 'A' 'A' 'U' 'U' 'U' 'A' 'A' 'A' 'A' 'A' 'A' 'A' 'A' 'A' 'M' 'A' 'M' 'A'
 'U' 'M' 'U' 'U' 'U' 'A' 'M' 'A' 'M' 'U' 'M' 'A' 'A' 'U' 'M' 'A' 'A' 'M'
 'U' 'U' 'A' 'U' 'A' 'U' 'U' 'A' 'U' 'A' 'M' 'M' 'M' 'M' 'A' 'A' 'A' 'A'
 'U' 'U' 'U' 'A' 'U' 'M' 'U' 'A' 'U' 'A' 'M' 'M' 'M' 'A' 'A' 'M' 'U' 'M']"
44901,0,134,86,48,64,0,0,"['A' 'U' 'U' 'A' 'U' 'U' 'M' 'A' 'U' 'U' 'A' 'U' 'A' 'A' 'A' 'U' 'U' 'A'
 'M' 'U' 'A' 'U' 'M' 'U' 'U' 'U' 'U' 'U' 'A' 'A' 'M' 'U' 'A' 'M' 'M' 'M'
 'A' 'A' 'U' 'U' 'M' 'A' 'U' 'U' 'M' 'A' 'U' 'U' 'M' 'U' 'A' 'M' 'A' 'M'
 'A' 'U' 'A' 'A' 'A' 'A' 'U' 'A' 'M' 'U' 'A' 'U' 'M' 'M' 'M' 'M' 'M' 'M'
 'M' 'M' 'M' 'M' 'U' 'A' 'A' 'M' 'A' 'A' 'U' 'A' 'A' 'U' 'U' 'U' 'A' 'A'
 'A' 'A' 'A' 'U' 'M' 'M' 'M' 'U' 'A' 'A' 'M' 'U' 'M' 'M' 'M' 'A' 'M' 'A'
 'U' 'A' 'U' 'A' 'U' 'M' 'A' 'A' 'A' 'A' 'A' 'U' 'A' 'A' 'A' 'A' 'U' 'A'
 'U' 'A' 'A' 'U' 'U' 'A' 'A' 'U' 'A' 'A' 'A' 'A' 'A' 'A' 'M' 'U' 'U' 'A'
 'U' 'M' 'A' 'U' 'U' 'A' 'U' 'A' 'M' 'A' 'M' 'A' 'A' 'U' 'M' 'A' 'U' 'M'
 'U' 'M' 'A' 'U' 'A' 'U' 'U' 'A' 'U' 'A' 'M' 'M' 'M' 'M' 'A' 'A' 'A' 'A'
 'U' 'A' 'U' 'A' 'U' 'U' 'U' 'A' 'U' 'A' 'M' 'M' 'M' 'A' 'A' 'A' 'A' 'M']"
45001,1,140,91,49,58,1,0,"['A' 'U' 'A' 'A' 'U' 'A' 'M' 'A' 'U' 'U' 'A' 'U' 'U' 'A' 'A' 'U' 'U' 'U'
 'M' 'A' 'A' 'U' 'M' 'A' 'U' 'M' 'U' 'U' 'A' 'A' 'M' 'U' 'A' 'M' 'U' 'M'
 'A' 'A' 'M' 'A' 'M' 'U' 'A' 'U' 'M' 'A' 'A' 'U' 'M' 'U' 'A' 'M' 'U' 'U'
 'A' 'A' 'A' 'A' 'A' 'A' 'U' 'A' 'U' 'U' 'A' 'M' 'M' 'M' 'M' 'U' 'M' 'M'
 'M' 'M' 'M' 'M' 'A' 'U' 'A' 'M' 'A' 'A' 'M' 'M' 'A' 'U' 'U' 'M' 'A' 'A'
 'A' 'A' 'A' 'U' 'M' 'M' 'M' 'M' 'A' 'A' 'M' 'U' 'M' 'M' 'M' 'A' 'U' 'A'
 'A' 'A' 'U' 'A' 'U' 'M' 'A' 'A' 'A' 'A' 'A' 'U' 'A' 'A' 'A' 'A' 'U' 'A'
 'U' 'A' 'A' 'U' 'A' 'A' 'A' 'A' 'A' 'A' 'A' 'A' 'A' 'A' 'U' 'U' 'U' 'A'
 'U' 'M' 'A' 'U' 'A' 'A' 'M' 'U' 'U' 'U' 'U' 'A' 'A' 'M' 'M' 'A' 'M' 'M'
 'U' 'U' 'A' 'U' 'A' 'U' 'M' 'A' 'U' 'A' 'M' 'M' 'U' 'M' 'A' 'A' 'U' 'A'
 'M' 'A' 'A' 'A' 'U' 'U' 'A' 'A' 'U' 'A' 'M' 'U' 'M' 'A' 'A' 'A' 'U' 'M']"
45101,3,141,92,49,57,1,0,"['A' 'U' 'U' 'A' 'U' 'U' 'U' 'A' 'U' 'A' 'A' 'A' 'A' 'A' 'A' 'U' 'U' 'U'
 'M' 'A' 'A' 'U' 'U' 'U' 'M' 'M' 'U' 'M' 'A' 'A' 'M' 'U' 'A' 'M' 'A' 'M'
 'A' 'A' 'M' 'A' 'M' 'A' 'A' 'A' 'M' 'A' 'A' 'U' 'M' 'U' 'A' 'M' 'U' 'U'
 'A' 'A' 'U' 'A' 'U' 'U' 'A' 'A' 'U' 'U' 'A' 'M' 'M' 'M' 'M' 'M' 'M' 'M'
 'M' 'U' 'M' 'M' 'A' 'U' 'A' 'M' 'U' 'U' 'M' 'M' 'U' 'U' 'U' 'M' 'A' 'A'
 'A' 'A' 'A' 'A' 'M' 'A' 'M' 'M' 'U' 'U' 'M' 'M' 'M' 'M' 'M' 'A' 'M' 'A'
 'A' 'A' 'U' 'U' 'A' 'M' 'A' 'A' 'A' 'U' 'A' 'M' 'A' 'A' 'A' 'A' 'U' 'A'
 'U' 'A' 'A' 'U' 'U' 'A' 'A' 'A' 'A' 'A' 'A' 'A' 'A' 'U' 'U' 'M' 'U' 'A'
 'U' 'M' 'A' 'A' 'A' 'U' 'U' 'U' 'U' 'M' 'U' 'A' 'A' 'M' 'A' 'A' 'M' 'M'
 'A' 'U' 'A' 'A' 'A' 'M' 'M' 'A' 'U' 'A' 'A' 'M' 'A' 'U' 'M' 'A' 'U' 'A'
 'U' 'A' 'A' 'A' 'A' 'U' 'A' 'A' 'A' 'A' 'U' 'U' 'M' 'A' 'A' 'U' 'A' 'M']"
45201,1,131,81,50,67,0,0,"['A' 'U' 'U' 'A' 'M' 'U' 'U' 'A' 'U' 'A' 'A' 'A' 'A' 'A' 'A' 'U' 'U' 'M'
 'M' 'A' 'U' 'M' 'U' 'U' 'M' 'M' 'M' 'M' 'A' 'U' 'M' 'U' 'A' 'M' 'A' 'M'
 'U' 'U' 'M' 'U' 'M' 'A' 'A' 'A' 'M' 'A' 'A' 'A' 'M' 'U' 'U' 'M' 'U' 'A'
 'U' 'U' 'A' 'A' 'U' 'U' 'A' 'A' 'U' 'M' 'A' 'M' 'M' 'M' 'M' 'M' 'M' 'M'
 'M' 'U' 'M' 'M' 'A' 'U' 'A' 'M' 'U' 'U' 'U' 'M' 'U' 'M' 'U' 'M' 'A' 'A'
 'A' 'A' 'A' 'A' 'M' 'A' 'M' 'U' 'M' 'U' 'U' 'U' 'U' 'M' 'M' 'A' 'U' 'A'
 'A' 'U' 'U' 'M' 'A' 'U' 'A' 'A' 'A' 'U' 'A' 'M' 'A' 'A' 'A' 'A' 'A' 'A'
 'U' 'A' 'A' 'A' 'U' 'A' 'A' 'U' 'A' 'U' 'A' 'A' 'A' 'U' 'M' 'M' 'M' 'A'
 'U' 'M' 'A' 'A' 'A' 'U' 'U' 'U' 'U' 'M' 'U' 'A' 'A' 'M' 'U' 'A' 'U' 'M'
 'U' 'U' 'A' 'A' 'A' 'M' 'M' 'A' 'U' 'U' 'A' 'M' 'A' 'U' 'M' 'U' 'U' 'U'
 'U' 'A' 'A' 'A' 'A' 'U' 'A' 'U' 'A' 'A' 'A' 'U' 'M' 'A' 'A' 'A' 'U' 'U']"
45301,1,127,76,51,71,0,1,"['A' 'U' 'A' 'A' 'M' 'U' 'U' 'M' 'U' 'A' 'A' 'A' 'A' 'A' 'A' 'U' 'U' 'M'
 'M' 'U' 'A' 'M' 'A' 'U' 'M' 'M' 'M' 'M' 'A' 'U' 'M' 'U' 'A' 'M' 'A' 'M'
 'U' 'U' 'M' 'U' 'M' 'A' 'U' 'A' 'M' 'A' 'A' 'A' 'M' 'U' 'U' 'M' 'U' 'A'
 'U' 'U' 'U' 'A' 'U' 'A' 'U' 'A' 'U' 'M' 'A' 'M' 'M' 'M' 'M' 'M' 'M' 'M'
 'U' 'M' 'M' 'U' 'A' 'M' 'U' 'M' 'U' 'M' 'U' 'M' 'U' 'M' 'U' 'U' 'A' 'A'
 'A' 'A' 'A' 'A' 'M' 'U' 'M' 'U' 'M' 'U' 'M' 'A' 'U' 'M' 'U' 'A' 'U' 'U'
 'A' 'U' 'U' 'M' 'A' 'U' 'A' 'U' 'A' 'U' 'U' 'M' 'A' 'A' 'A' 'A' 'U' 'A'
 'U' 'A' 'U' 'A' 'A' 'A' 'A' 'A' 'A' 'A' 'A' 'A' 'A' 'U' 'U' 'U' 'M' 'U'
 'U' 'M' 'A' 'A' 'A' 'A' 'U' 'U' 'U' 'M' 'M' 'A' 'A' 'M' 'M' 'A' 'U' 'U'
 'U' 'U' 'A' 'A' 'A' 'U' 'M' 'U' 'U' 'U' 'M' 'M' 'A' 'U' 'M' 'A' 'U' 'M'
 'U' 'A' 'A' 'A' 'A' 'U' 'U' 'U' 'A' 'A' 'A' 'A' 'M' 'A' 'A' 'A' 'U' 'U']"
45401,0,114,69,45,84,0,1,"['A' 'U' 'U' 'A' 'M' 'U' 'U' 'M' 'U' 'A' 'U' 'U' 'A' 'U' 'A' 'A' 'M' 'U'
 'M' 'U' 'U' 'M' 'A' 'U' 'M' 'M' 'M' 'M' 'U' 'U' 'M' 'U' 'A' 'M' 'A' 'M'
 'M' 'U' 'U' 'U' 'M' 'A' 'U' 'A' 'M' 'A' 'A' 'A' 'M' 'U' 'A' 'U' 'U' 'A'
 'M' 'U' 'U' 'A' 'U' 'A' 'U' 'A' 'U' 'M' 'A' 'M' 'U' 'M' 'M' 'M' 'M' 'M'
 'M' 'M' 'M' 'U' 'U' 'M' 'U' 'U' 'U' 'U' 'U' 'M' 'U' 'U' 'U' 'A' 'A' 'A'
 'U' 'A' 'U' 'A' 'M' 'U' 'A' 'U' 'A' 'U' 'U' 'U' 'U' 'M' 'U' 'A' 'U' 'U'
 'A' 'U' 'U' 'M' 'A' 'A' 'A' 'U' 'A' 'A' 'U' 'M' 'U' 'A' 'A' 'U' 'U' 'A'
 'U' 'A' 'U' 'A' 'A' 'A' 'A' 'U' 'A' 'A' 'A' 'A' 'A' 'U' 'A' 'U' 'M' 'A'
 'U' 'U' 'A' 'A' 'A' 'U' 'U' 'M' 'U' 'M' 'M' 'A' 'A' 'U' 'M' 'A' 'U' 'M'
 'U' 'U' 'A' 'A' 'A' 'U' 'M' 'U' 'U' 'U' 'M' 'U' 'A' 'U' 'U' 'U' 'U' 'M'
 'U' 'A' 'A' 'A' 'U' 'U' 'A' 'M' 'A' 'A' 'U' 'A' 'M' 'A' 'A' 'A' 'M' 'U']"
45501,2,123,71,52,75,0,0,"['A' 'U' 'U' 'U' 'M' 'A' 'A' 'U' 'U' 'U' 'U' 'U' 'A' 'U' 'A' 'U' 'M' 'M'
 'M' 'M' 'A' 'M' 'U' 'U' 'M' 'M' 'U' 'M' 'A' 'U' 'U' 'U' 'A' 'M' 'A' 'M'
 'M' 'U' 'U' 'U' 'M' 'M' 'U' 'A' 'M' 'A' 'U' 'A' 'M' 'U' 'M' 'A' 'U' 'A'
 'M' 'U' 'U' 'A' 'U' 'A' 'U' 'A' 'U' 'M' 'A' 'U' 'M' 'M' 'M' 'M' 'M' 'M'
 'M' 'M' 'M' 'U' 'A' 'M' 'U' 'U' 'A' 'U' 'U' 'M' 'A' 'U' 'M' 'A' 'A' 'A'
 'U' 'A' 'U' 'A' 'M' 'U' 'A' 'U' 'A' 'M' 'A' 'U' 'U' 'M' 'A' 'A' 'U' 'U'
 'M' 'M' 'U' 'M' 'A' 'U' 'A' 'U' 'A' 'A' 'U' 'M' 'A' 'A' 'M' 'M' 'A' 'A'
 'M' 'A' 'A' 'U' 'A' 'A' 'A' 'A' 'A' 'A' 'A' 'A' 'A' 'M' 'A' 'U' 'M' 'A'
 'U' 'M' 'A' 'A' 'A' 'A' 'U' 'A' 'U' 'M' 'U' 'A' 'A' 'U' 'M' 'A' 'U' 'M'
 'U' 'U' 'A' 'U' 'A' 'U' 'M' 'U' 'U' 'U' 'U' 'U' 'A' 'U' 'U' 'U' 'A' 'M'
 'U' 'A' 'A' 'A' 'U' 'U' 'U' 'U' 'U' 'A' 'U' 'A' 'M' 'A' 'A' 'U' 'M' 'M']"
45601,2,128,70,58,70,1,0,"['A' 'U' 'U' 'U' 'M' 'M' 'A' 'A' 'M' 'U' 'U' 'U' 'A' 'U' 'A' 'U' 'M' 'M'
 'M' 'U' 'A' 'M' 'A' 'U' 'U' 'M' 'U' 'M' 'A' 'U' 'M' 'M' 'A' 'M' 'A' 'M'
 'M' 'U' 'A' 'M' 'M' 'M' 'U' 'A' 'U' 'A' 'U' 'U' 'M' 'A' 'U' 'A' 'U' 'U'
 'M' 'U' 'M' 'M' 'U' 'A' 'A' 'A' 'U' 'U' 'A' 'M' 'U' 'M' 'M' 'M' 'M' 'M'
 'M' 'M' 'M' 'U' 'A' 'M' 'U' 'M' 'A' 'U' 'U' 'M' 'U' 'U' 'M' 'A' 'U' 'U'
 'U' 'A' 'U' 'A' 'M' 'M' 'U' 'A' 'A' 'M' 'A' 'U' 'U' 'M' 'A' 'U' 'U' 'A'
 'U' 'M' 'U' 'M' 'A' 'U' 'U' 'M' 'A' 'A' 'U' 'M' 'A' 'A' 'U' 'M' 'A' 'A'
 'M' 'A' 'A' 'U' 'A' 'A' 'A' 'A' 'U' 'A' 'A' 'A' 'A' 'M' 'A' 'U' 'U' 'A'
 'U' 'M' 'A' 'A' 'A' 'A' 'U' 'U' 'U' 'M' 'A' 'A' 'A' 'U' 'M' 'A' 'M' 'U'
 'U' 'M' 'A' 'A' 'U' 'A' 'U' 'U' 'U' 'M' 'U' 'M' 'A' 'U' 'U' 'U' 'A' 'M'
 'M' 'A' 'A' 'A' 'U' 'M' 'A' 'A' 'U' 'A' 'U' 'A' 'M' 'A' 'A' 'U' 'M' 'M']"
45701,2,117,59,58,81,0,1,"['A' 'U' 'U' 'U' 'U' 'M' 'A' 'A' 'M' 'M' 'M' 'U' 'U' 'U' 'A' 'U' 'M' 'U'
 'M' 'U' 'A' 'M' 'A' 'U' 'U' 'U' 'U' 'U' 'A' 'U' 'M' 'M' 'A' 'M' 'U' 'M'
 'M' 'U' 'A' 'M' 'M' 'M' 'U' 'A' 'U' 'M' 'U' 'U' 'U' 'U' 'U' 'A' 'U' 'U'
 'M' 'U' 'M' 'M' 'U' 'A' 'A' 'A' 'U' 'M' 'A' 'M' 'M' 'U' 'M' 'M' 'M' 'M'
 'M' 'M' 'M' 'U' 'A' 'U' 'U' 'M' 'A' 'U' 'U' 'M' 'U' 'U' 'M' 'A' 'A' 'U'
 'U' 'A' 'U' 'A' 'U' 'M' 'U' 'A' 'A' 'M' 'A' 'A' 'U' 'M' 'A' 'U' 'M' 'A'
 'U' 'M' 'U' 'M' 'A' 'U' 'U' 'M' 'U' 'A' 'U' 'M' 'A' 'A' 'M' 'U' 'U' 'A'
 'M' 'A' 'U' 'M' 'A' 'A' 'A' 'A' 'A' 'A' 'A' 'A' 'A' 'M' 'U' 'A' 'U' 'A'
 'U' 'M' 'A' 'U' 'A' 'A' 'U' 'U' 'U' 'U' 'A' 'A' 'A' 'M' 'M' 'A' 'M' 'U'
 'U' 'M' 'A' 'M' 'U' 'U' 'U' 'U' 'U' 'M' 'U' 'M' 'U' 'U' 'U' 'M' 'A' 'M'
 'U' 'A' 'A' 'A' 'U' 'M' 'U' 'A' 'U' 'U' 'U' 'A' 'M' 'U' 'A' 'U' 'M' 'M']"
45801,0,111,57,54,87,0,1,"['A' 'A' 'A' 'U' 'U' 'U' 'A' 'A' 'M' 'U' 'U' 'U' 'U' 'U' 'A' 'U' 'M' 'U'
 'M' 'U' 'A' 'M' 'A' 'U' 'U' 'U' 'U' 'U' 'A' 'U' 'M' 'M' 'A' 'M' 'U' 'M'
 'M' 'M' 'A' 'M' 'M' 'M' 'U' 'U' 'U' 'M' 'U' 'U' 'U' 'U' 'U' 'A' 'U' 'U'
 'M' 'U' 'M' 'U' 'U' 'U' 'A' 'A' 'U' 'M' 'A' 'M' 'M' 'M' 'U' 'M' 'M' 'M'
 'M' 'M' 'M' 'U' 'A' 'U' 'U' 'U' 'A' 'U' 'A' 'M' 'U' 'M' 'U' 'A' 'A' 'U'
 'U' 'U' 'U' 'A' 'A' 'M' 'U' 'A' 'A' 'M' 'A' 'A' 'A' 'M' 'U' 'U' 'M' 'A'
 'U' 'M' 'U' 'M' 'A' 'U' 'U' 'M' 'U' 'A' 'A' 'M' 'A' 'U' 'M' 'U' 'A' 'A'
 'M' 'A' 'U' 'M' 'U' 'A' 'A' 'A' 'A' 'A' 'A' 'A' 'A' 'M' 'U' 'A' 'U' 'A'
 'U' 'M' 'A' 'U' 'A' 'A' 'U' 'U' 'U' 'U' 'A' 'U' 'U' 'M' 'M' 'U' 'M' 'A'
 'U' 'M' 'A' 'M' 'U' 'U' 'U' 'U' 'U' 'M' 'U' 'M' 'U' 'U' 'U' 'M' 'A' 'M'
 'U' 'A' 'A' 'U' 'U' 'M' 'U' 'A' 'U' 'A' 'U' 'M' 'U' 'U' 'A' 'U' 'M' 'M']"
45901,3,118,57,61,80,0,1,"['A' 'A' 'A' 'U' 'U' 'U' 'A' 'A' 'M' 'U' 'U' 'U' 'U' 'U' 'A' 'M' 'M' 'U'
 'M' 'U' 'A' 'M' 'U' 'M' 'U' 'U' 'A' 'U' 'A' 'M' 'M' 'A' 'A' 'M' 'U' 'M'
 'M' 'M' 'A' 'U' 'M' 'M' 'U' 'U' 'U' 'M' 'U' 'M' 'U' 'U' 'U' 'A' 'U' 'U'
 'U' 'U' 'A' 'U' 'U' 'M' 'A' 'A' 'U' 'M' 'U' 'M' 'M' 'M' 'M' 'M' 'M' 'M'
 'M' 'M' 'U' 'U' 'A' 'U' 'M' 'M' 'A' 'U' 'A' 'M' 'A' 'U' 'U' 'A' 'A' 'M'
 'U' 'M' 'U' 'U' 'A' 'U' 'U' 'A' 'A' 'M' 'A' 'A' 'A' 'M' 'U' 'U' 'M' 'U'
 'U' 'M' 'A' 'M' 'A' 'U' 'U' 'M' 'U' 'A' 'A' 'U' 'A' 'M' 'M' 'U' 'A' 'A'
 'M' 'A' 'U' 'M' 'U' 'A' 'A' 'A' 'A' 'A' 'A' 'A' 'A' 'U' 'U' 'U' 'U' 'A'
 'U' 'M' 'M' 'U' 'U' 'A' 'M' 'A' 'U' 'U' 'A' 'A' 'U' 'M' 'M' 'M' 'U' 'A'
 'M' 'M' 'A' 'M' 'A' 'U' 'U' 'U' 'M' 'M' 'M' 'M' 'U' 'U' 'U' 'M' 'U' 'U'
 'M' 'A' 'U' 'U' 'U' 'M' 'U' 'A' 'U' 'A' 'U' 'M' 'A' 'U' 'A' 'U' 'M' 'M']"
46001,2,117,58,59,81,1,0,"['A' 'U' 'A' 'U' 'U' 'U' 'A' 'A' 'M' 'U' 'U' 'U' 'U' 'U' 'A' 'M' 'M' 'U'
 'M' 'U' 'A' 'M' 'U' 'M' 'U' 'U' 'U' 'U' 'U' 'M' 'U' 'A' 'A' 'M' 'U' 'M'
 'U' 'U' 'A' 'U' 'M' 'M' 'A' 'U' 'U' 'M' 'M' 'M' 'U' 'U' 'U' 'U' 'U' 'A'
 'U' 'U' 'A' 'A' 'U' 'M' 'A' 'A' 'U' 'M' 'U' 'M' 'M' 'M' 'M' 'M' 'M' 'M'
 'M' 'U' 'M' 'U' 'A' 'A' 'M' 'M' 'A' 'U' 'A' 'U' 'A' 'U' 'U' 'M' 'A' 'M'
 'U' 'U' 'U' 'U' 'A' 'U' 'M' 'A' 'A' 'M' 'A' 'A' 'A' 'M' 'A' 'M' 'M' 'U'
 'U' 'U' 'A' 'U' 'A' 'A' 'U' 'M' 'U' 'A' 'A' 'U' 'A' 'U' 'M' 'U' 'A' 'A'
 'M' 'A' 'U' 'M' 'U' 'A' 'A' 'A' 'A' 'A' 'A' 'A' 'A' 'U' 'U' 'U' 'U' 'A'
 'M' 'M' 'M' 'U' 'U' 'A' 'M' 'A' 'M' 'U' 'A' 'A' 'U' 'M' 'U' 'U' 'U' 'M'
 'M' 'M' 'A' 'M' 'A' 'U' 'A' 'M' 'M' 'M' 'M' 'M' 'M' 'M' 'U' 'M' 'U' 'U'
 'M' 'U' 'M' 'A' 'U' 'U' 'U' 'U' 'U' 'A' 'U' 'U' 'A' 'A' 'A' 'U' 'M' 'U']"
46101,0,115,50,65,83,0,1,"['A' 'U' 'A' 'U' 'U' 'U' 'A' 'A' 'M' 'U' 'U' 'U' 'U' 'U' 'A' 'U' 'U' 'U'
 'M' 'U' 'A' 'M' 'U' 'M' 'U' 'U' 'A' 'U' 'U' 'M' 'U' 'A' 'U' 'M' 'A' 'M'
 'U' 'U' 'A' 'U' 'M' 'M' 'U' 'U' 'U' 'M' 'M' 'U' 'M' 'U' 'M' 'U' 'M' 'A'
 'U' 'M' 'A' 'A' 'U' 'M' 'A' 'A' 'M' 'M' 'U' 'M' 'M' 'M' 'M' 'M' 'M' 'M'
 'M' 'M' 'U' 'M' 'U' 'A' 'M' 'M' 'U' 'U' 'U' 'U' 'A' 'U' 'U' 'M' 'A' 'M'
 'U' 'U' 'U' 'U' 'A' 'U' 'M' 'U' 'A' 'M' 'U' 'A' 'U' 'M' 'A' 'M' 'M' 'A'
 'U' 'M' 'A' 'U' 'A' 'A' 'U' 'M' 'U' 'A' 'A' 'U' 'A' 'U' 'M' 'U' 'U' 'A'
 'M' 'A' 'U' 'U' 'M' 'A' 'A' 'A' 'A' 'A' 'A' 'A' 'A' 'U' 'U' 'U' 'M' 'A'
 'M' 'M' 'U' 'U' 'M' 'U' 'U' 'A' 'M' 'U' 'A' 'U' 'U' 'M' 'U' 'M' 'U' 'M'
 'M' 'M' 'A' 'M' 'A' 'U' 'U' 'M' 'M' 'M' 'U' 'M' 'M' 'M' 'A' 'M' 'U' 'A'
 'M' 'U' 'M' 'A' 'U' 'U' 'M' 'U' 'U' 'U' 'M' 'U' 'A' 'A' 'A' 'U' 'M' 'U']"
46201,0,126,56,70,72,0,1,"['A' 'M' 'U' 'U' 'U' 'U' 'A' 'A' 'M' 'U' 'U' 'U' 'U' 'U' 'A' 'U' 'U' 'U'
 'M' 'U' 'A' 'M' 'U' 'M' 'U' 'A' 'A' 'M' 'U' 'M' 'U' 'A' 'U' 'M' 'A' 'M'
 'M' 'A' 'A' 'A' 'M' 'U' 'M' 'U' 'U' 'M' 'M' 'A' 'M' 'U' 'U' 'U' 'M' 'A'
 'M' 'M' 'A' 'A' 'U' 'M' 'A' 'A' 'M' 'U' 'A' 'M' 'M' 'U' 'M' 'M' 'M' 'M'
 'M' 'M' 'M' 'M' 'U' 'A' 'M' 'M' 'M' 'A' 'M' 'U' 'A' 'U' 'U' 'M' 'U' 'M'
 'U' 'A' 'U' 'U' 'U' 'U' 'U' 'A' 'U' 'M' 'U' 'A' 'U' 'M' 'A' 'M' 'M' 'U'
 'U' 'M' 'A' 'M' 'A' 'A' 'U' 'M' 'U' 'A' 'A' 'U' 'A' 'A' 'M' 'U' 'U' 'A'
 'U' 'A' 'U' 'U' 'M' 'A' 'A' 'A' 'A' 'A' 'A' 'A' 'A' 'U' 'U' 'U' 'M' 'A'
 'U' 'M' 'U' 'U' 'M' 'U' 'M' 'U' 'M' 'A' 'A' 'U' 'U' 'M' 'U' 'M' 'U' 'U'
 'M' 'M' 'A' 'M' 'A' 'U' 'M' 'M' 'M' 'M' 'M' 'M' 'M' 'M' 'A' 'M' 'A' 'A'
 'M' 'U' 'M' 'A' 'A' 'U' 'U' 'U' 'U' 'U' 'M' 'M' 'A' 'A' 'A' 'M' 'M' 'U']"
46301,0,124,50,74,74,0,1,"['A' 'M' 'M' 'U' 'M' 'A' 'A' 'A' 'M' 'U' 'U' 'U' 'U' 'U' 'A' 'U' 'U' 'U'
 'M' 'A' 'A' 'M' 'U' 'M' 'M' 'M' 'U' 'M' 'U' 'U' 'U' 'A' 'U' 'M' 'U' 'M'
 'M' 'A' 'A' 'U' 'U' 'A' 'M' 'U' 'U' 'M' 'M' 'M' 'M' 'U' 'M' 'U' 'M' 'A'
 'M' 'M' 'A' 'U' 'U' 'M' 'A' 'A' 'M' 'U' 'U' 'M' 'M' 'M' 'M' 'U' 'M' 'M'
 'M' 'M' 'M' 'M' 'A' 'A' 'A' 'M' 'M' 'M' 'M' 'A' 'A' 'U' 'U' 'M' 'U' 'M'
 'U' 'A' 'U' 'U' 'U' 'M' 'U' 'A' 'U' 'U' 'U' 'A' 'A' 'M' 'A' 'M' 'M' 'U'
 'U' 'M' 'A' 'M' 'U' 'A' 'U' 'M' 'U' 'U' 'A' 'U' 'A' 'U' 'M' 'U' 'U' 'U'
 'M' 'U' 'U' 'U' 'M' 'A' 'A' 'A' 'A' 'A' 'A' 'A' 'A' 'U' 'M' 'U' 'U' 'A'
 'A' 'M' 'A' 'U' 'M' 'U' 'M' 'U' 'M' 'A' 'A' 'U' 'U' 'M' 'U' 'M' 'U' 'U'
 'M' 'M' 'A' 'M' 'A' 'U' 'M' 'M' 'U' 'M' 'M' 'M' 'M' 'M' 'A' 'M' 'A' 'U'
 'M' 'U' 'M' 'A' 'A' 'U' 'M' 'U' 'A' 'U' 'U' 'M' 'U' 'A' 'U' 'M' 'M' 'U']"
46401,1,127,53,74,71,0,0,"['A' 'M' 'M' 'M' 'M' 'A' 'A' 'A' 'M' 'U' 'A' 'A' 'U' 'U' 'M' 'U' 'M' 'U'
 'M' 'A' 'A' 'M' 'U' 'U' 'M' 'U' 'M' 'M' 'A' 'A' 'U' 'A' 'U' 'M' 'A' 'M'
 'M' 'A' 'A' 'U' 'U' 'A' 'M' 'U' 'U' 'U' 'M' 'M' 'M' 'U' 'M' 'U' 'U' 'A'
 'M' 'M' 'U' 'U' 'U' 'M' 'A' 'A' 'M' 'U' 'U' 'M' 'M' 'M' 'M' 'M' 'M' 'M'
 'U' 'M' 'M' 'M' 'U' 'A' 'A' 'M' 'M' 'M' 'U' 'A' 'A' 'A' 'M' 'M' 'M' 'U'
 'U' 'A' 'U' 'U' 'A' 'M' 'U' 'A' 'M' 'U' 'U' 'A' 'A' 'U' 'A' 'M' 'M' 'U'
 'U' 'U' 'A' 'U' 'U' 'A' 'U' 'M' 'U' 'U' 'A' 'U' 'M' 'M' 'M' 'U' 'U' 'U'
 'M' 'U' 'U' 'U' 'U' 'A' 'A' 'A' 'A' 'A' 'A' 'A' 'A' 'M' 'U' 'M' 'U' 'A'
 'A' 'M' 'A' 'U' 'M' 'U' 'M' 'U' 'M' 'A' 'A' 'M' 'U' 'M' 'M' 'M' 'U' 'U'
 'U' 'M' 'A' 'M' 'A' 'U' 'U' 'M' 'M' 'M' 'M' 'A' 'U' 'M' 'A' 'M' 'U' 'M'
 'M' 'M' 'U' 'U' 'A' 'U' 'M' 'U' 'A' 'U' 'A' 'M' 'U' 'U' 'U' 'M' 'M' 'A']"
46501,2,128,56,72,70,0,0,"['A' 'M' 'M' 'M' 'M' 'A' 'A' 'A' 'M' 'U' 'A' 'A' 'U' 'U' 'M' 'M' 'M' 'U'
 'M' 'A' 'A' 'M' 'M' 'U' 'M' 'U' 'M' 'M' 'A' 'A' 'U' 'A' 'U' 'M' 'A' 'M'
 'M' 'A' 'U' 'A' 'A' 'A' 'M' 'A' 'U' 'U' 'M' 'M' 'U' 'U' 'M' 'A' 'U' 'A'
 'U' 'U' 'U' 'A' 'A' 'U' 'A' 'U' 'M' 'U' 'U' 'M' 'M' 'M' 'M' 'M' 'U' 'M'
 'M' 'M' 'M' 'M' 'U' 'A' 'A' 'M' 'A' 'M' 'U' 'A' 'U' 'A' 'U' 'M' 'M' 'U'
 'U' 'A' 'U' 'M' 'A' 'M' 'U' 'M' 'M' 'U' 'U' 'A' 'U' 'U' 'U' 'M' 'U' 'U'
 'A' 'U' 'A' 'M' 'U' 'A' 'A' 'U' 'M' 'A' 'A' 'M' 'U' 'M' 'M' 'U' 'U' 'M'
 'M' 'U' 'U' 'U' 'U' 'A' 'A' 'A' 'A' 'A' 'A' 'A' 'A' 'M' 'U' 'U' 'U' 'U'
 'A' 'M' 'A' 'U' 'M' 'U' 'M' 'U' 'M' 'A' 'A' 'M' 'A' 'M' 'M' 'M' 'U' 'U'
 'U' 'M' 'A' 'M' 'M' 'U' 'U' 'M' 'M' 'M' 'M' 'A' 'U' 'M' 'A' 'M' 'U' 'M'
 'M' 'M' 'U' 'U' 'A' 'A' 'M' 'A' 'U' 'U' 'A' 'M' 'U' 'U' 'U' 'U' 'M' 'U']"
46601,3,125,56,69,73,0,0,"['A' 'M' 'M' 'M' 'M' 'U' 'A' 'U' 'M' 'U' 'A' 'A' 'U' 'U' 'M' 'M' 'M' 'U'
 'M' 'A' 'A' 'U' 'M' 'A' 'M' 'A' 'M' 'M' 'A' 'A' 'M' 'U' 'U' 'U' 'A' 'M'
 'U' 'A' 'M' 'A' 'A' 'U' 'M' 'A' 'U' 'U' 'U' 'M' 'U' 'A' 'M' 'A' 'M' 'A'
 'U' 'U' 'U' 'U' 'A' 'U' 'A' 'U' 'M' 'M' 'U' 'M' 'M' 'U' 'M' 'M' 'M' 'M'
 'M' 'M' 'M' 'M' 'U' 'A' 'U' 'A' 'A' 'M' 'U' 'A' 'U' 'A' 'U' 'M' 'M' 'U'
 'U' 'A' 'U' 'U' 'A' 'U' 'U' 'M' 'M' 'U' 'M' 'U' 'M' 'U' 'U' 'M' 'A' 'U'
 'U' 'A' 'A' 'M' 'U' 'A' 'M' 'U' 'U' 'U' 'A' 'M' 'U' 'M' 'M' 'A' 'U' 'M'
 'M' 'U' 'U' 'U' 'U' 'A' 'A' 'A' 'A' 'A' 'A' 'A' 'A' 'M' 'A' 'A' 'U' 'U'
 'A' 'M' 'A' 'U' 'U' 'U' 'M' 'U' 'M' 'A' 'A' 'M' 'U' 'M' 'M' 'M' 'U' 'U'
 'M' 'M' 'A' 'A' 'M' 'M' 'U' 'U' 'M' 'M' 'M' 'A' 'U' 'U' 'A' 'M' 'U' 'M'
 'U' 'M' 'U' 'A' 'A' 'A' 'U' 'U' 'U' 'U' 'A' 'M' 'U' 'A' 'U' 'M' 'M' 'M']"
46701,3,116,51,65,82,1,0,"['A' 'M' 'U' 'M' 'M' 'U' 'U' 'U' 'M' 'A' 'A' 'A' 'U' 'U' 'U' 'M' 'M' 'U'
 'U' 'A' 'A' 'U' 'U' 'A' 'U' 'A' 'U' 'U' 'A' 'M' 'M' 'U' 'U' 'U' 'M' 'M'
 'M' 'A' 'M' 'A' 'A' 'U' 'M' 'U' 'U' 'U' 'U' 'M' 'U' 'U' 'M' 'A' 'U' 'A'
 'U' 'A' 'U' 'U' 'A' 'U' 'M' 'U' 'M' 'M' 'U' 'M' 'M' 'M' 'M' 'M' 'M' 'M'
 'M' 'M' 'U' 'M' 'U' 'A' 'U' 'U' 'A' 'M' 'U' 'A' 'M' 'A' 'U' 'M' 'M' 'M'
 'M' 'A' 'A' 'U' 'A' 'U' 'U' 'U' 'M' 'U' 'M' 'U' 'M' 'A' 'U' 'M' 'A' 'U'
 'U' 'A' 'A' 'M' 'M' 'U' 'M' 'U' 'U' 'A' 'A' 'M' 'U' 'M' 'U' 'A' 'A' 'M'
 'M' 'M' 'M' 'U' 'U' 'A' 'A' 'U' 'A' 'A' 'A' 'A' 'A' 'M' 'A' 'A' 'A' 'U'
 'A' 'U' 'A' 'U' 'U' 'U' 'U' 'U' 'M' 'A' 'A' 'M' 'U' 'M' 'U' 'M' 'M' 'U'
 'U' 'U' 'A' 'U' 'M' 'M' 'U' 'U' 'M' 'U' 'M' 'A' 'U' 'U' 'A' 'M' 'U' 'M'
 'U' 'M' 'U' 'A' 'A' 'U' 'U' 'M' 'U' 'U' 'A' 'M' 'U' 'U' 'M' 'U' 'M' 'M']"
46801,0,120,56,64,78,0,1,"['A' 'U' 'U' 'M' 'M' 'U' 'U' 'U' 'M' 'A' 'A' 'U' 'U' 'A' 'U' 'M' 'A' 'U'
 'M' 'U' 'A' 'U' 'A' 'A' 'U' 'A' 'U' 'M' 'U' 'M' 'M' 'U' 'U' 'A' 'U' 'M'
 'M' 'A' 'M' 'A' 'U' 'U' 'M' 'U' 'U' 'A' 'M' 'M' 'U' 'U' 'M' 'A' 'U' 'A'
 'M' 'U' 'U' 'M' 'A' 'M' 'M' 'U' 'U' 'U' 'U' 'M' 'M' 'U' 'M' 'M' 'M' 'M'
 'M' 'M' 'M' 'A' 'U' 'A' 'A' 'U' 'A' 'U' 'A' 'A' 'M' 'A' 'U' 'U' 'M' 'M'
 'M' 'A' 'A' 'A' 'A' 'U' 'U' 'U' 'M' 'U' 'M' 'A' 'U' 'A' 'U' 'M' 'A' 'U'
 'U' 'A' 'A' 'U' 'M' 'U' 'U' 'U' 'U' 'A' 'U' 'M' 'M' 'M' 'U' 'A' 'A' 'M'
 'M' 'U' 'M' 'U' 'U' 'A' 'A' 'A' 'A' 'A' 'A' 'A' 'A' 'M' 'U' 'A' 'A' 'M'
 'U' 'U' 'A' 'M' 'U' 'M' 'M' 'U' 'M' 'A' 'U' 'M' 'A' 'U' 'M' 'M' 'M' 'U'
 'U' 'U' 'U' 'U' 'M' 'M' 'U' 'M' 'U' 'A' 'M' 'A' 'U' 'U' 'A' 'U' 'M' 'M'
 'U' 'M' 'U' 'A' 'A' 'U' 'A' 'U' 'U' 'U' 'A' 'M' 'M' 'A' 'M' 'U' 'M' 'M']"
46901,0,124,62,62,74,1,0,"['A' 'U' 'U' 'M' 'U' 'U' 'U' 'U' 'A' 'A' 'A' 'U' 'M' 'A' 'U' 'M' 'U' 'M'
 'M' 'U' 'A' 'U' 'A' 'A' 'U' 'M' 'U' 'M' 'A' 'M' 'U' 'U' 'U' 'A' 'U' 'M'
 'U' 'A' 'U' 'A' 'U' 'U' 'A' 'U' 'A' 'A' 'A' 'M' 'A' 'U' 'U' 'A' 'U' 'A'
 'U' 'A' 'U' 'M' 'A' 'M' 'M' 'M' 'U' 'U' 'U' 'M' 'M' 'M' 'M' 'M' 'M' 'M'
 'M' 'M' 'U' 'A' 'U' 'A' 'A' 'U' 'A' 'U' 'A' 'U' 'U' 'A' 'U' 'A' 'M' 'M'
 'M' 'A' 'A' 'A' 'A' 'U' 'U' 'U' 'M' 'U' 'M' 'A' 'M' 'A' 'U' 'M' 'A' 'U'
 'U' 'A' 'U' 'U' 'M' 'U' 'A' 'U' 'A' 'A' 'M' 'U' 'M' 'M' 'U' 'A' 'A' 'M'
 'U' 'U' 'M' 'U' 'U' 'A' 'A' 'A' 'A' 'A' 'A' 'A' 'A' 'M' 'U' 'A' 'A' 'M'
 'U' 'U' 'A' 'M' 'M' 'M' 'M' 'U' 'M' 'A' 'U' 'M' 'A' 'U' 'M' 'M' 'M' 'U'
 'M' 'M' 'U' 'M' 'M' 'M' 'U' 'M' 'U' 'A' 'M' 'M' 'M' 'U' 'U' 'A' 'M' 'U'
 'M' 'U' 'U' 'A' 'A' 'U' 'A' 'U' 'A' 'U' 'A' 'U' 'M' 'A' 'M' 'U' 'M' 'M']"
47001,1,127,65,62,71,0,0,"['A' 'M' 'M' 'M' 'M' 'U' 'U' 'U' 'A' 'A' 'A' 'M' 'M' 'A' 'U' 'U' 'A' 'M'
 'U' 'M' 'A' 'A' 'A' 'A' 'A' 'M' 'U' 'M' 'U' 'M' 'M' 'M' 'U' 'A' 'A' 'M'
 'U' 'A' 'M' 'U' 'U' 'U' 'A' 'U' 'A' 'A' 'A' 'M' 'U' 'U' 'U' 'A' 'U' 'A'
 'U' 'A' 'M' 'M' 'U' 'M' 'M' 'A' 'U' 'U' 'A' 'M' 'M' 'U' 'M' 'M' 'M' 'M'
 'M' 'M' 'M' 'A' 'U' 'A' 'U' 'U' 'A' 'U' 'A' 'U' 'U' 'A' 'U' 'A' 'M' 'M'
 'M' 'U' 'U' 'A' 'U' 'A' 'A' 'U' 'M' 'M' 'M' 'A' 'M' 'A' 'U' 'M' 'A' 'U'
 'U' 'A' 'U' 'U' 'M' 'A' 'A' 'U' 'A' 'A' 'M' 'U' 'M' 'M' 'U' 'U' 'U' 'M'
 'A' 'U' 'M' 'A' 'U' 'A' 'A' 'A' 'A' 'A' 'A' 'A' 'U' 'M' 'U' 'A' 'A' 'M'
 'U' 'U' 'A' 'M' 'M' 'U' 'M' 'U' 'M' 'U' 'U' 'M' 'U' 'A' 'U' 'M' 'U' 'U'
 'M' 'M' 'A' 'M' 'U' 'A' 'U' 'M' 'M' 'A' 'U' 'M' 'U' 'A' 'U' 'A' 'M' 'U'
 'M' 'U' 'U' 'A' 'U' 'A' 'A' 'U' 'A' 'U' 'A' 'U' 'M' 'A' 'M' 'A' 'M' 'U']"
47101,2,127,65,62,71,0,1,"['A' 'M' 'M' 'M' 'M' 'U' 'U' 'A' 'A' 'A' 'U' 'M' 'M' 'A' 'U' 'A' 'A' 'M'
 'A' 'M' 'U' 'A' 'A' 'A' 'U' 'M' 'A' 'M' 'U' 'M' 'M' 'U' 'U' 'A' 'A' 'M'
 'U' 'U' 'M' 'U' 'U' 'U' 'U' 'M' 'A' 'U' 'A' 'A' 'U' 'U' 'U' 'A' 'U' 'A'
 'U' 'A' 'M' 'M' 'M' 'M' 'M' 'A' 'U' 'M' 'A' 'U' 'M' 'M' 'M' 'M' 'M' 'M'
 'M' 'M' 'M' 'A' 'M' 'U' 'U' 'U' 'A' 'U' 'U' 'M' 'A' 'U' 'U' 'A' 'M' 'U'
 'M' 'U' 'U' 'A' 'U' 'A' 'A' 'U' 'M' 'U' 'U' 'A' 'M' 'U' 'M' 'U' 'A' 'U'
 'U' 'A' 'M' 'U' 'M' 'A' 'U' 'A' 'A' 'A' 'M' 'U' 'U' 'M' 'U' 'U' 'M' 'M'
 'A' 'U' 'M' 'A' 'M' 'A' 'A' 'A' 'A' 'A' 'A' 'A' 'A' 'M' 'U' 'A' 'A' 'M'
 'A' 'A' 'A' 'U' 'M' 'A' 'U' 'A' 'U' 'U' 'U' 'M' 'U' 'A' 'U' 'U' 'U' 'M'
 'M' 'U' 'A' 'M' 'U' 'A' 'M' 'M' 'M' 'A' 'M' 'M' 'U' 'A' 'U' 'A' 'M' 'U'
 'M' 'M' 'U' 'U' 'U' 'A' 'U' 'U' 'A' 'U' 'A' 'U' 'A' 'A' 'M' 'U' 'M' 'A']"
47201,4,116,58,58,82,0,0,"['A' 'M' 'M' 'M' 'U' 'U' 'U' 'A' 'A' 'U' 'U' 'U' 'M' 'A' 'M' 'A' 'A' 'M'
 'A' 'M' 'U' 'A' 'A' 'A' 'M' 'M' 'A' 'M' 'M' 'U' 'U' 'U' 'U' 'U' 'A' 'M'
 'U' 'U' 'M' 'M' 'U' 'A' 'M' 'M' 'U' 'U' 'M' 'A' 'U' 'U' 'U' 'A' 'A' 'A'
 'A' 'A' 'M' 'M' 'M' 'M' 'M' 'A' 'U' 'M' 'A' 'M' 'M' 'M' 'M' 'M' 'U' 'M'
 'M' 'M' 'M' 'A' 'U' 'U' 'U' 'U' 'U' 'U' 'U' 'M' 'U' 'M' 'U' 'A' 'U' 'U'
 'M' 'M' 'U' 'A' 'U' 'U' 'U' 'U' 'M' 'U' 'A' 'A' 'M' 'U' 'M' 'U' 'A' 'U'
 'U' 'A' 'M' 'M' 'M' 'A' 'U' 'A' 'A' 'A' 'M' 'U' 'U' 'M' 'U' 'U' 'M' 'M'
 'A' 'U' 'U' 'A' 'U' 'A' 'A' 'A' 'A' 'A' 'A' 'A' 'A' 'M' 'U' 'U' 'U' 'M'
 'A' 'A' 'U' 'A' 'M' 'A' 'U' 'U' 'U' 'U' 'U' 'U' 'A' 'A' 'U' 'U' 'U' 'M'
 'M' 'U' 'A' 'M' 'U' 'A' 'M' 'U' 'M' 'A' 'A' 'M' 'U' 'A' 'U' 'U' 'U' 'U'
 'U' 'M' 'U' 'U' 'U' 'A' 'U' 'U' 'U' 'U' 'A' 'U' 'A' 'A' 'M' 'U' 'M' 'A']"
47301,1,114,59,55,84,1,0,"['A' 'M' 'M' 'M' 'M' 'U' 'A' 'A' 'A' 'U' 'U' 'U' 'M' 'A' 'M' 'A' 'A' 'M'
 'A' 'M' 'U' 'A' 'U' 'A' 'M' 'M' 'A' 'M' 'M' 'U' 'U' 'U' 'U' 'U' 'A' 'M'
 'U' 'A' 'M' 'U' 'U' 'A' 'M' 'M' 'U' 'U' 'M' 'A' 'U' 'U' 'U' 'A' 'A' 'U'
 'U' 'A' 'M' 'M' 'M' 'U' 'M' 'A' 'A' 'M' 'A' 'M' 'M' 'M' 'M' 'M' 'M' 'U'
 'M' 'M' 'M' 'A' 'U' 'U' 'U' 'U' 'U' 'U' 'A' 'U' 'U' 'M' 'M' 'U' 'M' 'U'
 'M' 'M' 'U' 'A' 'A' 'U' 'M' 'U' 'U' 'U' 'U' 'U' 'M' 'U' 'M' 'U' 'A' 'U'
 'U' 'A' 'U' 'U' 'U' 'A' 'U' 'A' 'A' 'U' 'M' 'U' 'U' 'U' 'U' 'U' 'M' 'M'
 'A' 'U' 'U' 'A' 'U' 'A' 'A' 'A' 'A' 'A' 'A' 'A' 'A' 'M' 'M' 'U' 'U' 'M'
 'A' 'A' 'A' 'A' 'M' 'A' 'U' 'M' 'U' 'U' 'U' 'U' 'A' 'A' 'U' 'M' 'U' 'M'
 'M' 'U' 'A' 'M' 'U' 'U' 'M' 'A' 'U' 'A' 'A' 'M' 'U' 'A' 'A' 'U' 'U' 'A'
 'M' 'U' 'U' 'U' 'U' 'A' 'U' 'U' 'A' 'U' 'A' 'U' 'U' 'A' 'M' 'U' 'U' 'A']"
47401,2,120,62,58,78,0,1,"['A' 'U' 'M' 'U' 'M' 'A' 'A' 'A' 'A' 'U' 'U' 'U' 'U' 'U' 'M' 'U' 'A' 'U'
 'A' 'U' 'M' 'A' 'M' 'A' 'M' 'U' 'A' 'M' 'M' 'U' 'U' 'U' 'U' 'M' 'A' 'M'
 'A' 'A' 'M' 'A' 'U' 'A' 'M' 'M' 'M' 'M' 'M' 'A' 'U' 'M' 'U' 'A' 'A' 'M'
 'U' 'A' 'M' 'M' 'M' 'U' 'M' 'A' 'A' 'M' 'A' 'M' 'M' 'M' 'M' 'M' 'M' 'M'
 'M' 'U' 'M' 'A' 'A' 'U' 'U' 'U' 'U' 'U' 'A' 'U' 'U' 'M' 'M' 'M' 'M' 'U'
 'M' 'M' 'M' 'A' 'A' 'A' 'M' 'U' 'U' 'A' 'M' 'U' 'U' 'U' 'U' 'U' 'A' 'U'
 'U' 'U' 'A' 'A' 'U' 'A' 'U' 'A' 'U' 'U' 'M' 'A' 'U' 'U' 'U' 'U' 'M' 'M'
 'A' 'U' 'U' 'U' 'U' 'U' 'A' 'A' 'A' 'A' 'A' 'A' 'A' 'M' 'A' 'U' 'U' 'U'
 'A' 'A' 'A' 'A' 'M' 'A' 'U' 'M' 'A' 'U' 'U' 'M' 'A' 'U' 'M' 'M' 'U' 'M'
 'M' 'A' 'A' 'M' 'U' 'U' 'U' 'U' 'U' 'A' 'U' 'M' 'U' 'A' 'A' 'U' 'U' 'A'
 'M' 'U' 'U' 'A' 'U' 'A' 'U' 'M' 'A' 'U' 'A' 'U' 'U' 'U' 'M' 'U' 'M' 'A']"
47501,2,122,58,64,76,1,0,"['A' 'U' 'M' 'U' 'U' 'A' 'A' 'A' 'A' 'U' 'U' 'U' 'U' 'A' 'A' 'U' 'A' 'U'
 'U' 'M' 'M' 'U' 'M' 'M' 'M' 'U' 'U' 'M' 'M' 'U' 'U' 'U' 'U' 'M' 'A' 'U'
 'A' 'A' 'M' 'U' 'A' 'A' 'U' 'U' 'M' 'M' 'M' 'U' 'U' 'M' 'A' 'A' 'M' 'M'
 'U' 'U' 'M' 'M' 'M' 'A' 'M' 'A' 'A' 'M' 'A' 'U' 'M' 'M' 'M' 'M' 'M' 'M'
 'M' 'M' 'M' 'M' 'A' 'U' 'U' 'U' 'U' 'U' 'A' 'U' 'U' 'M' 'U' 'M' 'M' 'U'
 'M' 'M' 'M' 'A' 'U' 'A' 'M' 'U' 'U' 'A' 'M' 'U' 'U' 'U' 'U' 'U' 'A' 'U'
 'M' 'U' 'A' 'A' 'U' 'A' 'M' 'A' 'A' 'U' 'A' 'M' 'M' 'U' 'U' 'A' 'M' 'M'
 'A' 'U' 'U' 'M' 'U' 'A' 'A' 'A' 'A' 'A' 'A' 'A' 'A' 'M' 'A' 'U' 'U' 'A'
 'A' 'A' 'U' 'A' 'M' 'A' 'A' 'M' 'U' 'U' 'M' 'M' 'A' 'A' 'M' 'M' 'U' 'M'
 'M' 'M' 'A' 'M' 'U' 'U' 'U' 'U' 'A' 'M' 'U' 'M' 'A' 'A' 'A' 'U' 'U' 'U'
 'M' 'U' 'U' 'M' 'U' 'U' 'M' 'U' 'A' 'M' 'A' 'U' 'U' 'U' 'M' 'U' 'U' 'A']"
47601,1,135,62,73,63,0,0,"['A' 'M' 'M' 'M' 'U' 'A' 'A' 'M' 'A' 'U' 'M' 'A' 'M' 'U' 'A' 'A' 'A' 'A'
 'U' 'M' 'M' 'U' 'M' 'M' 'M' 'U' 'U' 'M' 'M' 'A' 'M' 'U' 'U' 'M' 'A' 'U'
 'A' 'U' 'M' 'A' 'A' 'A' 'U' 'U' 'M' 'U' 'M' 'U' 'M' 'M' 'A' 'A' 'U' 'M'
 'M' 'A' 'M' 'M' 'M' 'A' 'U' 'A' 'A' 'A' 'A' 'M' 'U' 'M' 'M' 'M' 'M' 'M'
 'M' 'M' 'M' 'M' 'U' 'M' 'U' 'U' 'U' 'M' 'A' 'U' 'U' 'M' 'M' 'M' 'U' 'U'
 'M' 'M' 'M' 'A' 'M' 'A' 'M' 'U' 'A' 'A' 'M' 'U' 'A' 'U' 'M' 'U' 'A' 'M'
 'M' 'U' 'A' 'A' 'U' 'A' 'A' 'U' 'A' 'U' 'A' 'M' 'M' 'M' 'U' 'A' 'M' 'M'
 'A' 'U' 'A' 'M' 'U' 'A' 'A' 'A' 'A' 'A' 'U' 'A' 'A' 'M' 'U' 'U' 'U' 'A'
 'A' 'A' 'M' 'A' 'U' 'A' 'U' 'M' 'M' 'U' 'M' 'M' 'A' 'A' 'M' 'M' 'U' 'U'
 'M' 'U' 'A' 'M' 'U' 'U' 'A' 'A' 'U' 'M' 'U' 'M' 'A' 'A' 'M' 'U' 'U' 'U'
 'M' 'U' 'U' 'M' 'U' 'U' 'M' 'U' 'A' 'U' 'A' 'U' 'U' 'M' 'M' 'U' 'A' 'A']"
47701,1,136,64,72,62,1,0,"['A' 'M' 'M' 'M' 'A' 'A' 'A' 'A' 'A' 'U' 'A' 'A' 'M' 'U' 'A' 'A' 'A' 'A'
 'U' 'U' 'U' 'M' 'U' 'U' 'M' 'A' 'U' 'M' 'A' 'A' 'U' 'A' 'U' 'M' 'A' 'U'
 'A' 'U' 'M' 'A' 'A' 'U' 'U' 'A' 'U' 'U' 'M' 'U' 'M' 'M' 'A' 'A' 'U' 'M'
 'M' 'U' 'M' 'M' 'M' 'A' 'U' 'U' 'A' 'A' 'A' 'M' 'M' 'M' 'M' 'M' 'M' 'M'
 'M' 'U' 'M' 'M' 'U' 'U' 'A' 'U' 'M' 'M' 'U' 'U' 'U' 'M' 'M' 'M' 'M' 'U'
 'M' 'M' 'U' 'A' 'M' 'A' 'M' 'U' 'A' 'U' 'M' 'M' 'A' 'M' 'M' 'M' 'A' 'M'
 'M' 'M' 'U' 'A' 'A' 'A' 'A' 'M' 'A' 'U' 'A' 'M' 'M' 'M' 'A' 'A' 'M' 'U'
 'U' 'M' 'A' 'M' 'U' 'A' 'A' 'U' 'A' 'A' 'A' 'A' 'A' 'U' 'U' 'U' 'U' 'A'
 'U' 'U' 'M' 'U' 'U' 'A' 'U' 'M' 'M' 'U' 'M' 'M' 'A' 'A' 'M' 'M' 'U' 'A'
 'U' 'U' 'A' 'A' 'M' 'M' 'A' 'A' 'U' 'M' 'U' 'M' 'A' 'A' 'M' 'A' 'U' 'U'
 'M' 'M' 'M' 'M' 'U' 'U' 'M' 'U' 'A' 'U' 'A' 'M' 'U' 'U' 'M' 'M' 'A' 'U']"
47801,0,132,57,75,66,0,0,"['A' 'M' 'M' 'M' 'A' 'A' 'A' 'U' 'U' 'U' 'A' 'A' 'U' 'U' 'A' 'A' 'A' 'A'
 'M' 'U' 'U' 'U' 'U' 'A' 'M' 'A' 'A' 'M' 'A' 'A' 'U' 'A' 'M' 'M' 'A' 'U'
 'A' 'M' 'M' 'A' 'U' 'U' 'M' 'A' 'U' 'A' 'U' 'M' 'U' 'M' 'U' 'A' 'M' 'M'
 'M' 'U' 'M' 'M' 'M' 'A' 'U' 'U' 'U' 'A' 'U' 'M' 'M' 'M' 'M' 'M' 'M' 'M'
 'M' 'U' 'M' 'M' 'U' 'U' 'A' 'M' 'M' 'M' 'U' 'U' 'A' 'M' 'M' 'M' 'M' 'U'
 'M' 'M' 'U' 'U' 'M' 'U' 'M' 'U' 'A' 'M' 'M' 'M' 'U' 'U' 'M' 'M' 'A' 'M'
 'M' 'M' 'U' 'A' 'U' 'U' 'A' 'M' 'A' 'U' 'U' 'M' 'U' 'M' 'A' 'A' 'M' 'U'
 'U' 'A' 'A' 'M' 'U' 'A' 'A' 'A' 'A' 'A' 'A' 'A' 'A' 'U' 'U' 'U' 'M' 'A'
 'U' 'U' 'M' 'U' 'U' 'A' 'A' 'U' 'M' 'U' 'M' 'M' 'U' 'A' 'M' 'M' 'U' 'A'
 'U' 'M' 'A' 'A' 'M' 'M' 'A' 'A' 'M' 'M' 'M' 'M' 'U' 'A' 'U' 'A' 'M' 'U'
 'M' 'U' 'M' 'M' 'U' 'U' 'M' 'U' 'U' 'U' 'A' 'M' 'U' 'A' 'U' 'M' 'A' 'M']"
47901,1,117,47,70,81,0,1,"['A' 'M' 'M' 'M' 'A' 'A' 'A' 'U' 'U' 'U' 'A' 'U' 'U' 'M' 'U' 'A' 'A' 'A'
 'M' 'U' 'U' 'A' 'U' 'U' 'M' 'U' 'A' 'U' 'A' 'A' 'U' 'A' 'M' 'U' 'U' 'A'
 'A' 'M' 'U' 'A' 'U' 'U' 'M' 'U' 'U' 'A' 'M' 'U' 'M' 'U' 'U' 'A' 'U' 'M'
 'M' 'U' 'M' 'M' 'M' 'A' 'M' 'U' 'U' 'A' 'U' 'M' 'M' 'M' 'M' 'U' 'M' 'M'
 'M' 'M' 'M' 'M' 'U' 'U' 'U' 'M' 'U' 'U' 'M' 'U' 'U' 'M' 'M' 'M' 'M' 'A'
 'M' 'M' 'U' 'U' 'M' 'U' 'M' 'M' 'U' 'M' 'M' 'U' 'U' 'M' 'M' 'M' 'U' 'M'
 'U' 'M' 'U' 'A' 'U' 'A' 'A' 'M' 'A' 'U' 'A' 'M' 'U' 'U' 'A' 'A' 'M' 'U'
 'U' 'U' 'U' 'M' 'U' 'A' 'A' 'A' 'A' 'A' 'A' 'A' 'A' 'M' 'U' 'M' 'M' 'U'
 'U' 'U' 'U' 'U' 'U' 'A' 'A' 'A' 'M' 'U' 'M' 'U' 'U' 'U' 'M' 'M' 'U' 'A'
 'U' 'M' 'U' 'A' 'M' 'M' 'A' 'A' 'M' 'M' 'M' 'U' 'U' 'A' 'U' 'U' 'M' 'U'
 'U' 'U' 'M' 'U' 'U' 'M' 'U' 'M' 'U' 'M' 'A' 'M' 'U' 'A' 'U' 'M' 'A' 'M']"
48001,3,123,50,73,75,1,0,"['A' 'M' 'M' 'M' 'A' 'U' 'A' 'U' 'U' 'U' 'U' 'U' 'U' 'M' 'U' 'A' 'A' 'A'
 'M' 'U' 'U' 'A' 'M' 'U' 'M' 'U' 'A' 'U' 'A' 'A' 'U' 'U' 'U' 'U' 'M' 'A'
 'A' 'M' 'U' 'A' 'U' 'U' 'U' 'M' 'M' 'A' 'M' 'U' 'M' 'U' 'U' 'A' 'M' 'U'
 'M' 'A' 'M' 'M' 'M' 'A' 'M' 'U' 'M' 'A' 'U' 'M' 'M' 'M' 'U' 'M' 'M' 'M'
 'M' 'M' 'M' 'M' 'A' 'U' 'A' 'M' 'U' 'U' 'M' 'M' 'U' 'M' 'M' 'M' 'M' 'A'
 'U' 'U' 'U' 'U' 'U' 'U' 'U' 'M' 'U' 'M' 'M' 'U' 'U' 'M' 'U' 'M' 'U' 'M'
 'U' 'U' 'U' 'A' 'M' 'U' 'A' 'M' 'A' 'U' 'A' 'M' 'A' 'M' 'M' 'A' 'U' 'U'
 'U' 'U' 'U' 'M' 'U' 'A' 'A' 'A' 'A' 'A' 'A' 'A' 'A' 'M' 'A' 'M' 'M' 'U'
 'U' 'M' 'U' 'U' 'A' 'A' 'A' 'A' 'M' 'U' 'M' 'U' 'M' 'U' 'M' 'M' 'M' 'A'
 'A' 'M' 'U' 'A' 'M' 'M' 'U' 'A' 'M' 'M' 'A' 'U' 'U' 'A' 'U' 'U' 'M' 'M'
 'U' 'U' 'M' 'U' 'M' 'M' 'U' 'M' 'A' 'M' 'U' 'M' 'U' 'A' 'A' 'U' 'A' 'M']"
48101,2,133,57,76,65,0,1,"['A' 'M' 'U' 'M' 'A' 'M' 'A' 'U' 'A' 'U' 'U' 'A' 'M' 'M' 'U' 'A' 'A' 'A'
 'M' 'A' 'U' 'A' 'M' 'U' 'M' 'U' 'A' 'U' 'A' 'A' 'A' 'U' 'U' 'U' 'M' 'A'
 'U' 'M' 'A' 'A' 'A' 'U' 'U' 'M' 'M' 'A' 'M' 'A' 'M' 'U' 'M' 'U' 'U' 'U'
 'M' 'A' 'M' 'M' 'M' 'U' 'U' 'M' 'M' 'U' 'U' 'U' 'M' 'M' 'M' 'M' 'M' 'M'
 'M' 'M' 'M' 'M' 'A' 'U' 'A' 'M' 'A' 'U' 'M' 'M' 'U' 'M' 'U' 'M' 'M' 'A'
 'U' 'A' 'U' 'U' 'M' 'A' 'M' 'U' 'U' 'M' 'M' 'M' 'U' 'U' 'M' 'M' 'U' 'M'
 'A' 'U' 'A' 'M' 'M' 'U' 'A' 'M' 'A' 'U' 'A' 'U' 'A' 'M' 'U' 'U' 'M' 'U'
 'U' 'U' 'U' 'M' 'A' 'A' 'A' 'A' 'A' 'A' 'A' 'A' 'A' 'M' 'A' 'M' 'M' 'U'
 'U' 'M' 'U' 'U' 'A' 'A' 'A' 'U' 'M' 'U' 'U' 'A' 'M' 'U' 'M' 'M' 'M' 'A'
 'A' 'M' 'M' 'A' 'M' 'M' 'U' 'A' 'M' 'M' 'A' 'M' 'U' 'U' 'M' 'U' 'M' 'M'
 'U' 'A' 'M' 'U' 'M' 'M' 'U' 'M' 'U' 'U' 'U' 'M' 'U' 'A' 'A' 'A' 'A' 'M']"
48201,1,133,65,68,65,1,0,"['A' 'M' 'U' 'M' 'A' 'U' 'A' 'U' 'A' 'M' 'U' 'U' 'M' 'M' 'U' 'A' 'A' 'A'
 'M' 'A' 'U' 'A' 'U' 'M' 'M' 'U' 'A' 'U' 'A' 'A' 'A' 'U' 'A' 'M' 'M' 'A'
 'M' 'M' 'A' 'U' 'U' 'A' 'U' 'A' 'U' 'U' 'M' 'A' 'M' 'A' 'U' 'U' 'A' 'A'
 'M' 'A' 'U' 'U' 'M' 'U' 'U' 'M' 'M' 'U' 'A' 'M' 'M' 'M' 'M' 'M' 'M' 'U'
 'M' 'M' 'M' 'M' 'A' 'U' 'A' 'M' 'U' 'U' 'M' 'M' 'U' 'A' 'A' 'A' 'M' 'A'
 'U' 'A' 'U' 'U' 'M' 'A' 'M' 'U' 'U' 'M' 'M' 'U' 'U' 'U' 'U' 'M' 'U' 'M'
 'A' 'U' 'A' 'M' 'M' 'U' 'A' 'M' 'A' 'U' 'A' 'U' 'A' 'M' 'A' 'U' 'M' 'U'
 'U' 'U' 'M' 'U' 'A' 'A' 'A' 'A' 'A' 'A' 'A' 'A' 'A' 'M' 'A' 'M' 'U' 'U'
 'U' 'M' 'A' 'M' 'A' 'U' 'A' 'U' 'M' 'U' 'M' 'A' 'M' 'M' 'M' 'M' 'M' 'A'
 'A' 'M' 'M' 'A' 'M' 'U' 'U' 'A' 'U' 'M' 'A' 'M' 'A' 'A' 'U' 'U' 'U' 'M'
 'A' 'A' 'M' 'U' 'U' 'M' 'M' 'M' 'U' 'U' 'M' 'M' 'U' 'A' 'A' 'U' 'A' 'M']"
48301,5,122,59,63,76,0,0,"['A' 'U' 'M' 'M' 'M' 'U' 'U' 'U' 'U' 'M' 'U' 'U' 'M' 'U' 'U' 'A' 'A' 'A'
 'M' 'U' 'U' 'A' 'U' 'M' 'M' 'M' 'A' 'U' 'A' 'U' 'A' 'U' 'A' 'M' 'U' 'A'
 'M' 'M' 'A' 'U' 'U' 'U' 'U' 'U' 'U' 'U' 'U' 'A' 'M' 'A' 'U' 'U' 'U' 'A'
 'M' 'A' 'U' 'U' 'U' 'A' 'U' 'M' 'M' 'U' 'A' 'M' 'U' 'M' 'M' 'M' 'M' 'M'
 'M' 'M' 'M' 'M' 'A' 'A' 'A' 'M' 'M' 'U' 'M' 'M' 'U' 'A' 'U' 'A' 'M' 'A'
 'U' 'A' 'U' 'U' 'M' 'A' 'M' 'A' 'U' 'M' 'M' 'U' 'U' 'U' 'M' 'U' 'U' 'U'
 'A' 'U' 'A' 'A' 'M' 'A' 'A' 'M' 'U' 'U' 'A' 'U' 'A' 'M' 'A' 'U' 'M' 'U'
 'U' 'U' 'M' 'U' 'A' 'A' 'A' 'A' 'A' 'A' 'A' 'A' 'A' 'M' 'A' 'M' 'U' 'U'
 'U' 'M' 'A' 'M' 'A' 'M' 'A' 'U' 'M' 'A' 'U' 'A' 'M' 'U' 'M' 'M' 'M' 'A'
 'U' 'M' 'M' 'A' 'M' 'U' 'U' 'A' 'M' 'M' 'U' 'M' 'A' 'U' 'U' 'U' 'U' 'M'
 'A' 'A' 'M' 'U' 'U' 'M' 'M' 'U' 'M' 'U' 'M' 'U' 'U' 'A' 'A' 'U' 'A' 'A']"
48401,0,120,55,65,78,1,0,"['A' 'U' 'U' 'M' 'M' 'A' 'U' 'U' 'U' 'M' 'U' 'M' 'M' 'U' 'U' 'U' 'A' 'A'
 'M' 'U' 'M' 'A' 'U' 'M' 'U' 'U' 'A' 'U' 'A' 'U' 'A' 'A' 'A' 'M' 'A' 'A'
 'M' 'U' 'U' 'A' 'A' 'U' 'U' 'U' 'U' 'U' 'U' 'U' 'M' 'A' 'U' 'U' 'M' 'A'
 'M' 'A' 'M' 'M' 'U' 'U' 'U' 'U' 'U' 'U' 'A' 'M' 'M' 'M' 'M' 'U' 'M' 'M'
 'M' 'M' 'M' 'M' 'A' 'A' 'U' 'M' 'M' 'U' 'M' 'M' 'U' 'A' 'A' 'A' 'M' 'A'
 'U' 'A' 'U' 'A' 'U' 'A' 'M' 'U' 'U' 'U' 'M' 'U' 'U' 'U' 'M' 'M' 'U' 'U'
 'A' 'M' 'A' 'U' 'M' 'A' 'A' 'M' 'M' 'U' 'A' 'M' 'A' 'M' 'A' 'M' 'U' 'M'
 'M' 'U' 'M' 'U' 'A' 'A' 'A' 'A' 'A' 'A' 'A' 'A' 'A' 'M' 'A' 'M' 'M' 'U'
 'M' 'U' 'U' 'M' 'A' 'M' 'A' 'U' 'M' 'A' 'U' 'U' 'M' 'U' 'M' 'U' 'U' 'U'
 'U' 'M' 'U' 'U' 'M' 'U' 'U' 'A' 'M' 'M' 'U' 'M' 'A' 'U' 'U' 'U' 'U' 'M'
 'A' 'U' 'M' 'U' 'U' 'M' 'M' 'A' 'U' 'A' 'M' 'M' 'U' 'A' 'A' 'M' 'U' 'A']"
48501,1,112,51,61,86,0,0,"['A' 'U' 'U' 'M' 'U' 'A' 'A' 'A' 'U' 'M' 'U' 'M' 'U' 'U' 'U' 'U' 'A' 'A'
 'M' 'U' 'U' 'A' 'U' 'M' 'U' 'U' 'A' 'U' 'A' 'U' 'A' 'A' 'U' 'M' 'A' 'A'
 'M' 'U' 'A' 'A' 'A' 'U' 'U' 'U' 'U' 'U' 'U' 'M' 'M' 'A' 'U' 'M' 'M' 'A'
 'M' 'A' 'A' 'M' 'U' 'M' 'U' 'U' 'U' 'U' 'U' 'M' 'U' 'M' 'M' 'M' 'M' 'M'
 'M' 'M' 'M' 'M' 'A' 'A' 'M' 'U' 'U' 'U' 'U' 'M' 'U' 'A' 'A' 'M' 'M' 'U'
 'U' 'A' 'U' 'A' 'U' 'A' 'M' 'U' 'U' 'U' 'M' 'U' 'U' 'U' 'U' 'U' 'M' 'U'
 'A' 'M' 'A' 'U' 'M' 'A' 'A' 'M' 'M' 'A' 'A' 'M' 'U' 'M' 'U' 'M' 'U' 'M'
 'U' 'U' 'M' 'A' 'A' 'A' 'U' 'U' 'A' 'A' 'A' 'A' 'U' 'M' 'U' 'M' 'M' 'A'
 'M' 'U' 'U' 'M' 'A' 'M' 'A' 'U' 'M' 'A' 'A' 'U' 'M' 'U' 'U' 'U' 'U' 'A'
 'U' 'M' 'U' 'U' 'M' 'U' 'U' 'A' 'M' 'M' 'U' 'M' 'A' 'U' 'M' 'U' 'U' 'M'
 'U' 'U' 'M' 'M' 'U' 'U' 'M' 'A' 'U' 'A' 'M' 'M' 'U' 'U' 'A' 'M' 'U' 'U']"
48601,0,117,56,61,81,1,0,"['A' 'A' 'U' 'U' 'U' 'A' 'A' 'A' 'A' 'M' 'U' 'M' 'U' 'U' 'U' 'A' 'A' 'A'
 'M' 'A' 'U' 'A' 'U' 'A' 'A' 'U' 'A' 'U' 'A' 'U' 'A' 'A' 'U' 'M' 'A' 'M'
 'M' 'U' 'A' 'A' 'A' 'U' 'U' 'M' 'M' 'U' 'U' 'M' 'U' 'U' 'U' 'M' 'M' 'A'
 'M' 'A' 'U' 'M' 'U' 'M' 'M' 'U' 'U' 'A' 'U' 'M' 'M' 'M' 'M' 'M' 'M' 'M'
 'U' 'M' 'M' 'M' 'U' 'A' 'M' 'U' 'U' 'U' 'U' 'M' 'U' 'A' 'A' 'M' 'M' 'M'
 'A' 'U' 'U' 'A' 'M' 'A' 'M' 'U' 'U' 'U' 'M' 'U' 'M' 'U' 'U' 'U' 'M' 'U'
 'U' 'M' 'A' 'U' 'U' 'A' 'U' 'M' 'M' 'A' 'U' 'U' 'U' 'U' 'U' 'M' 'U' 'M'
 'U' 'U' 'M' 'A' 'M' 'A' 'A' 'A' 'A' 'A' 'A' 'U' 'A' 'M' 'U' 'M' 'M' 'A'
 'M' 'A' 'U' 'M' 'A' 'U' 'A' 'U' 'M' 'U' 'A' 'U' 'M' 'U' 'U' 'A' 'U' 'A'
 'U' 'M' 'U' 'U' 'M' 'A' 'U' 'A' 'M' 'M' 'A' 'M' 'A' 'A' 'M' 'U' 'U' 'U'
 'U' 'U' 'M' 'M' 'U' 'M' 'M' 'A' 'U' 'U' 'U' 'M' 'U' 'A' 'A' 'M' 'U' 'U']"
48701,0,107,51,56,91,1,0,"['A' 'U' 'U' 'U' 'U' 'A' 'A' 'A' 'A' 'M' 'U' 'M' 'U' 'U' 'U' 'U' 'A' 'A'
 'M' 'A' 'U' 'A' 'U' 'A' 'A' 'M' 'A' 'M' 'U' 'M' 'A' 'A' 'U' 'M' 'A' 'M'
 'U' 'U' 'A' 'U' 'A' 'U' 'U' 'U' 'M' 'U' 'U' 'U' 'U' 'A' 'U' 'M' 'M' 'A'
 'U' 'A' 'U' 'M' 'U' 'M' 'M' 'U' 'M' 'U' 'U' 'M' 'M' 'M' 'U' 'M' 'M' 'M'
 'M' 'M' 'M' 'U' 'U' 'A' 'M' 'U' 'A' 'U' 'U' 'M' 'M' 'A' 'U' 'M' 'U' 'M'
 'A' 'A' 'U' 'A' 'M' 'A' 'M' 'U' 'U' 'U' 'M' 'U' 'M' 'U' 'U' 'U' 'M' 'U'
 'U' 'U' 'A' 'A' 'U' 'U' 'A' 'M' 'M' 'A' 'A' 'U' 'U' 'U' 'U' 'M' 'A' 'U'
 'U' 'M' 'M' 'A' 'M' 'A' 'A' 'A' 'A' 'A' 'A' 'A' 'A' 'M' 'U' 'M' 'U' 'U'
 'M' 'A' 'U' 'U' 'A' 'U' 'A' 'U' 'M' 'U' 'U' 'U' 'M' 'U' 'U' 'A' 'U' 'A'
 'U' 'M' 'U' 'M' 'M' 'U' 'U' 'A' 'M' 'U' 'U' 'M' 'A' 'U' 'U' 'U' 'U' 'U'
 'A' 'U' 'U' 'M' 'M' 'U' 'M' 'A' 'U' 'U' 'U' 'M' 'M' 'U' 'U' 'M' 'U' 'U']"
48801,2,112,52,60,86,0,1,"['A' 'U' 'A' 'U' 'U' 'A' 'U' 'A' 'A' 'M' 'A' 'M' 'U' 'U' 'U' 'M' 'A' 'A'
 'M' 'A' 'U' 'A' 'U' 'A' 'A' 'M' 'A' 'M' 'M' 'M' 'A' 'A' 'M' 'M' 'A' 'M'
 'U' 'U' 'U' 'U' 'A' 'U' 'U' 'U' 'M' 'U' 'U' 'M' 'U' 'A' 'U' 'M' 'U' 'A'
 'U' 'A' 'U' 'M' 'A' 'M' 'M' 'U' 'M' 'U' 'A' 'M' 'U' 'M' 'M' 'M' 'M' 'M'
 'M' 'M' 'M' 'M' 'U' 'A' 'M' 'M' 'U' 'U' 'A' 'M' 'M' 'A' 'U' 'U' 'U' 'U'
 'A' 'A' 'U' 'A' 'M' 'A' 'M' 'U' 'U' 'A' 'M' 'U' 'M' 'U' 'M' 'U' 'M' 'M'
 'U' 'U' 'U' 'U' 'U' 'A' 'A' 'M' 'M' 'U' 'U' 'A' 'U' 'U' 'U' 'M' 'U' 'U'
 'U' 'U' 'M' 'U' 'M' 'U' 'A' 'A' 'A' 'A' 'A' 'A' 'A' 'M' 'U' 'M' 'U' 'M'
 'M' 'A' 'U' 'U' 'U' 'U' 'A' 'U' 'U' 'U' 'U' 'U' 'M' 'M' 'U' 'A' 'U' 'A'
 'A' 'M' 'U' 'M' 'U' 'U' 'U' 'U' 'M' 'A' 'U' 'M' 'A' 'A' 'U' 'A' 'A' 'U'
 'A' 'U' 'M' 'M' 'M' 'U' 'U' 'A' 'M' 'U' 'U' 'M' 'M' 'U' 'U' 'U' 'U' 'U']"
48901,1,121,61,60,77,0,0,"['A' 'U' 'A' 'U' 'U' 'U' 'A' 'A' 'A' 'U' 'A' 'M' 'A' 'U' 'U' 'M' 'A' 'M'
 'M' 'A' 'U' 'U' 'U' 'A' 'A' 'M' 'A' 'M' 'U' 'M' 'U' 'A' 'M' 'M' 'A' 'M'
 'U' 'U' 'U' 'U' 'A' 'M' 'U' 'U' 'M' 'U' 'U' 'M' 'U' 'A' 'M' 'M' 'U' 'A'
 'A' 'A' 'U' 'M' 'A' 'M' 'M' 'A' 'M' 'U' 'A' 'M' 'M' 'M' 'M' 'M' 'M' 'M'
 'M' 'U' 'M' 'M' 'A' 'A' 'M' 'M' 'U' 'U' 'U' 'U' 'M' 'A' 'U' 'U' 'M' 'U'
 'A' 'A' 'U' 'A' 'M' 'A' 'U' 'U' 'U' 'A' 'U' 'U' 'M' 'A' 'M' 'M' 'A' 'M'
 'M' 'M' 'U' 'U' 'U' 'A' 'A' 'M' 'M' 'U' 'U' 'A' 'U' 'U' 'A' 'M' 'U' 'U'
 'U' 'U' 'M' 'U' 'M' 'A' 'A' 'A' 'A' 'A' 'A' 'A' 'A' 'U' 'M' 'M' 'U' 'M'
 'M' 'A' 'U' 'U' 'U' 'U' 'A' 'U' 'U' 'U' 'A' 'M' 'M' 'M' 'A' 'A' 'A' 'A'
 'A' 'M' 'U' 'M' 'A' 'U' 'A' 'U' 'M' 'U' 'U' 'U' 'A' 'U' 'U' 'A' 'A' 'A'
 'A' 'U' 'M' 'M' 'U' 'U' 'U' 'A' 'U' 'U' 'U' 'M' 'M' 'U' 'A' 'M' 'U' 'U']"
49001,1,118,57,61,80,0,0,"['A' 'U' 'A' 'U' 'U' 'U' 'A' 'A' 'A' 'U' 'A' 'M' 'U' 'U' 'U' 'M' 'A' 'M'
 'M' 'A' 'U' 'U' 'A' 'A' 'A' 'M' 'U' 'M' 'U' 'M' 'U' 'A' 'M' 'M' 'A' 'M'
 'U' 'U' 'U' 'A' 'A' 'M' 'U' 'U' 'M' 'M' 'U' 'M' 'U' 'A' 'M' 'M' 'U' 'A'
 'A' 'U' 'U' 'M' 'A' 'U' 'U' 'A' 'M' 'M' 'A' 'M' 'M' 'M' 'M' 'M' 'M' 'U'
 'M' 'M' 'M' 'M' 'A' 'A' 'M' 'M' 'U' 'U' 'U' 'U' 'M' 'U' 'M' 'M' 'M' 'M'
 'A' 'A' 'M' 'U' 'M' 'A' 'U' 'U' 'U' 'A' 'U' 'U' 'M' 'A' 'M' 'U' 'A' 'M'
 'M' 'M' 'U' 'U' 'U' 'U' 'A' 'M' 'M' 'U' 'U' 'A' 'A' 'U' 'A' 'U' 'U' 'A'
 'U' 'U' 'U' 'U' 'U' 'M' 'A' 'A' 'A' 'A' 'A' 'A' 'A' 'U' 'M' 'U' 'A' 'M'
 'M' 'A' 'U' 'U' 'U' 'U' 'A' 'A' 'U' 'M' 'A' 'U' 'M' 'M' 'A' 'A' 'A' 'U'
 'A' 'M' 'A' 'M' 'A' 'U' 'U' 'M' 'M' 'U' 'U' 'M' 'A' 'M' 'U' 'M' 'U' 'U'
 'A' 'U' 'U' 'U' 'U' 'U' 'U' 'A' 'U' 'U' 'U' 'M' 'A' 'U' 'A' 'M' 'U' 'U']"
49101,2,127,56,71,71,0,0,"['A' 'M' 'M' 'U' 'M' 'M' 'A' 'A' 'A' 'U' 'A' 'U' 'U' 'U' 'A' 'M' 'A' 'M'
 'M' 'U' 'U' 'A' 'M' 'A' 'A' 'M' 'U' 'M' 'M' 'M' 'U' 'M' 'M' 'M' 'A' 'U'
 'A' 'U' 'U' 'A' 'A' 'M' 'M' 'M' 'M' 'M' 'U' 'U' 'U' 'U' 'M' 'M' 'M' 'A'
 'A' 'U' 'A' 'M' 'A' 'M' 'U' 'U' 'M' 'M' 'A' 'M' 'M' 'M' 'M' 'M' 'U' 'M'
 'M' 'M' 'M' 'U' 'U' 'U' 'M' 'M' 'U' 'U' 'U' 'U' 'M' 'A' 'M' 'M' 'M' 'U'
 'A' 'U' 'M' 'U' 'U' 'A' 'U' 'A' 'M' 'A' 'U' 'U' 'M' 'A' 'M' 'U' 'A' 'M'
 'M' 'M' 'U' 'U' 'U' 'M' 'A' 'M' 'M' 'U' 'U' 'A' 'A' 'U' 'A' 'U' 'U' 'A'
 'U' 'U' 'U' 'M' 'U' 'A' 'A' 'A' 'A' 'A' 'A' 'A' 'A' 'U' 'M' 'A' 'A' 'U'
 'M' 'A' 'A' 'A' 'U' 'M' 'U' 'A' 'U' 'M' 'A' 'M' 'M' 'M' 'A' 'A' 'A' 'U'
 'A' 'M' 'U' 'M' 'A' 'U' 'U' 'U' 'M' 'M' 'U' 'M' 'A' 'M' 'A' 'M' 'U' 'U'
 'A' 'U' 'U' 'U' 'U' 'U' 'U' 'A' 'U' 'U' 'U' 'M' 'A' 'M' 'U' 'M' 'U' 'M']"
49201,4,121,58,63,77,0,1,"['A' 'U' 'M' 'U' 'M' 'M' 'U' 'A' 'A' 'U' 'A' 'U' 'U' 'U' 'A' 'M' 'A' 'U'
 'U' 'U' 'U' 'A' 'U' 'U' 'A' 'U' 'U' 'M' 'U' 'M' 'A' 'U' 'M' 'M' 'U' 'U'
 'A' 'U' 'U' 'A' 'A' 'M' 'A' 'M' 'U' 'M' 'A' 'U' 'A' 'U' 'M' 'M' 'M' 'A'
 'U' 'U' 'A' 'M' 'U' 'M' 'U' 'U' 'M' 'M' 'A' 'M' 'M' 'M' 'M' 'M' 'M' 'M'
 'M' 'M' 'U' 'U' 'U' 'U' 'M' 'M' 'U' 'U' 'M' 'U' 'M' 'A' 'M' 'M' 'M' 'U'
 'U' 'M' 'M' 'U' 'U' 'A' 'M' 'A' 'M' 'A' 'U' 'A' 'U' 'A' 'M' 'U' 'A' 'M'
 'M' 'M' 'U' 'M' 'U' 'A' 'A' 'U' 'M' 'U' 'A' 'A' 'A' 'U' 'U' 'U' 'A' 'A'
 'U' 'U' 'U' 'A' 'U' 'A' 'A' 'A' 'A' 'A' 'A' 'A' 'A' 'U' 'M' 'A' 'A' 'U'
 'M' 'A' 'A' 'A' 'A' 'M' 'A' 'U' 'U' 'M' 'A' 'M' 'M' 'M' 'A' 'A' 'A' 'U'
 'A' 'M' 'U' 'M' 'A' 'U' 'U' 'U' 'M' 'U' 'M' 'M' 'A' 'M' 'A' 'M' 'U' 'U'
 'M' 'U' 'U' 'U' 'U' 'U' 'U' 'A' 'U' 'M' 'U' 'M' 'A' 'U' 'U' 'M' 'U' 'M']"
49301,2,122,59,63,76,0,1,"['A' 'A' 'U' 'U' 'M' 'M' 'U' 'A' 'A' 'M' 'A' 'U' 'U' 'U' 'A' 'U' 'A' 'M'
 'U' 'U' 'U' 'U' 'A' 'U' 'A' 'A' 'U' 'M' 'A' 'U' 'U' 'U' 'M' 'M' 'M' 'U'
 'A' 'A' 'U' 'A' 'A' 'U' 'A' 'M' 'U' 'M' 'A' 'U' 'U' 'U' 'U' 'M' 'M' 'A'
 'U' 'A' 'A' 'M' 'M' 'M' 'U' 'U' 'M' 'M' 'A' 'M' 'M' 'M' 'M' 'M' 'M' 'M'
 'U' 'M' 'M' 'U' 'U' 'A' 'M' 'M' 'M' 'U' 'M' 'A' 'M' 'A' 'M' 'U' 'U' 'U'
 'U' 'M' 'M' 'M' 'M' 'A' 'M' 'A' 'M' 'A' 'U' 'A' 'U' 'A' 'U' 'M' 'A' 'M'
 'M' 'M' 'U' 'M' 'U' 'A' 'U' 'M' 'M' 'U' 'U' 'A' 'A' 'M' 'U' 'M' 'U' 'A'
 'M' 'U' 'U' 'U' 'U' 'U' 'A' 'A' 'A' 'A' 'A' 'A' 'A' 'M' 'M' 'U' 'A' 'A'
 'M' 'A' 'A' 'U' 'A' 'U' 'A' 'M' 'A' 'M' 'A' 'U' 'M' 'U' 'A' 'A' 'A' 'U'
 'A' 'M' 'U' 'M' 'A' 'U' 'U' 'A' 'U' 'U' 'M' 'M' 'A' 'M' 'U' 'U' 'U' 'A'
 'M' 'U' 'U' 'U' 'U' 'U' 'U' 'U' 'U' 'M' 'U' 'M' 'A' 'A' 'U' 'M' 'U' 'U']"
49401,3,120,63,57,78,0,0,"['A' 'A' 'U' 'U' 'M' 'M' 'U' 'A' 'U' 'M' 'A' 'U' 'U' 'A' 'U' 'U' 'A' 'M'
 'U' 'A' 'U' 'U' 'A' 'U' 'A' 'A' 'A' 'M' 'U' 'U' 'U' 'U' 'U' 'M' 'U' 'M'
 'A' 'A' 'U' 'A' 'A' 'U' 'A' 'U' 'U' 'M' 'A' 'U' 'A' 'U' 'U' 'M' 'U' 'A'
 'U' 'A' 'A' 'M' 'M' 'M' 'U' 'U' 'M' 'M' 'A' 'M' 'M' 'M' 'M' 'M' 'M' 'M'
 'M' 'U' 'M' 'U' 'U' 'A' 'A' 'M' 'U' 'U' 'M' 'M' 'M' 'A' 'M' 'U' 'U' 'U'
 'U' 'U' 'M' 'U' 'M' 'A' 'M' 'A' 'U' 'A' 'A' 'A' 'U' 'A' 'U' 'M' 'A' 'A'
 'M' 'M' 'U' 'M' 'U' 'A' 'U' 'A' 'M' 'M' 'M' 'A' 'A' 'M' 'U' 'A' 'M' 'A'
 'M' 'M' 'U' 'U' 'M' 'A' 'A' 'A' 'A' 'A' 'A' 'A' 'A' 'M' 'M' 'U' 'A' 'A'
 'M' 'U' 'A' 'U' 'A' 'U' 'A' 'M' 'A' 'M' 'A' 'U' 'M' 'U' 'A' 'A' 'M' 'U'
 'U' 'M' 'U' 'M' 'U' 'U' 'U' 'A' 'U' 'A' 'M' 'U' 'A' 'U' 'U' 'U' 'U' 'U'
 'U' 'U' 'M' 'U' 'A' 'U' 'U' 'U' 'A' 'U' 'U' 'M' 'A' 'A' 'M' 'M' 'U' 'U']"
49501,0,121,60,61,77,0,0,"['A' 'A' 'U' 'U' 'U' 'M' 'A' 'A' 'U' 'M' 'A' 'U' 'U' 'A' 'U' 'M' 'A' 'M'
 'U' 'A' 'U' 'A' 'A' 'U' 'U' 'A' 'A' 'U' 'M' 'M' 'U' 'A' 'U' 'M' 'U' 'M'
 'A' 'A' 'U' 'U' 'A' 'A' 'A' 'U' 'U' 'M' 'A' 'U' 'U' 'U' 'A' 'M' 'U' 'A'
 'U' 'A' 'U' 'M' 'U' 'M' 'U' 'U' 'A' 'M' 'A' 'M' 'M' 'M' 'M' 'M' 'M' 'M'
 'U' 'M' 'M' 'U' 'U' 'A' 'U' 'M' 'U' 'U' 'U' 'M' 'M' 'M' 'M' 'U' 'M' 'U'
 'U' 'U' 'M' 'U' 'M' 'A' 'M' 'A' 'U' 'U' 'A' 'A' 'A' 'A' 'U' 'M' 'A' 'A'
 'M' 'M' 'A' 'M' 'U' 'A' 'U' 'A' 'M' 'M' 'M' 'U' 'A' 'M' 'U' 'U' 'M' 'A'
 'U' 'A' 'M' 'M' 'M' 'A' 'U' 'A' 'A' 'A' 'A' 'A' 'U' 'U' 'M' 'U' 'A' 'U'
 'M' 'M' 'A' 'U' 'U' 'U' 'A' 'U' 'A' 'M' 'A' 'U' 'M' 'U' 'A' 'A' 'M' 'M'
 'A' 'M' 'U' 'M' 'U' 'U' 'A' 'A' 'U' 'A' 'M' 'U' 'U' 'U' 'M' 'U' 'U' 'U'
 'U' 'M' 'U' 'U' 'A' 'M' 'M' 'U' 'A' 'M' 'U' 'M' 'A' 'U' 'U' 'M' 'A' 'M']"
49601,3,114,53,61,84,1,0,"['A' 'U' 'U' 'U' 'U' 'M' 'U' 'A' 'M' 'M' 'A' 'U' 'A' 'A' 'U' 'M' 'A' 'M'
 'A' 'A' 'U' 'A' 'U' 'U' 'U' 'A' 'A' 'M' 'U' 'M' 'U' 'U' 'U' 'M' 'U' 'M'
 'A' 'A' 'U' 'U' 'A' 'A' 'A' 'M' 'U' 'M' 'A' 'U' 'U' 'U' 'U' 'M' 'U' 'U'
 'U' 'A' 'U' 'M' 'U' 'M' 'M' 'U' 'A' 'M' 'U' 'U' 'M' 'M' 'M' 'M' 'M' 'M'
 'M' 'M' 'M' 'U' 'M' 'A' 'A' 'M' 'U' 'U' 'U' 'M' 'U' 'M' 'M' 'U' 'M' 'U'
 'U' 'U' 'M' 'U' 'M' 'A' 'M' 'A' 'U' 'A' 'U' 'A' 'A' 'A' 'M' 'M' 'A' 'A'
 'M' 'M' 'A' 'M' 'M' 'U' 'U' 'U' 'M' 'M' 'M' 'U' 'A' 'M' 'U' 'U' 'U' 'U'
 'U' 'A' 'U' 'M' 'M' 'A' 'A' 'A' 'A' 'A' 'U' 'A' 'A' 'U' 'U' 'U' 'A' 'U'
 'M' 'M' 'U' 'U' 'A' 'U' 'U' 'U' 'U' 'M' 'U' 'U' 'U' 'U' 'A' 'A' 'M' 'M'
 'U' 'U' 'U' 'M' 'A' 'U' 'A' 'A' 'U' 'A' 'M' 'U' 'M' 'U' 'U' 'U' 'A' 'U'
 'A' 'M' 'U' 'M' 'A' 'M' 'U' 'U' 'A' 'M' 'U' 'M' 'M' 'A' 'U' 'U' 'A' 'M']"
49701,1,123,59,64,75,0,0,"['A' 'U' 'U' 'U' 'U' 'M' 'U' 'A' 'U' 'U' 'A' 'U' 'A' 'A' 'M' 'M' 'A' 'M'
 'A' 'A' 'M' 'A' 'U' 'U' 'U' 'A' 'A' 'M' 'A' 'U' 'U' 'M' 'U' 'M' 'U' 'M'
 'A' 'A' 'U' 'U' 'A' 'A' 'A' 'M' 'U' 'M' 'A' 'U' 'U' 'U' 'U' 'M' 'U' 'U'
 'M' 'A' 'U' 'U' 'M' 'M' 'M' 'U' 'A' 'U' 'U' 'M' 'U' 'M' 'M' 'M' 'M' 'M'
 'M' 'M' 'M' 'U' 'U' 'A' 'U' 'M' 'U' 'U' 'U' 'M' 'U' 'M' 'M' 'U' 'U' 'M'
 'M' 'U' 'M' 'U' 'M' 'A' 'M' 'A' 'A' 'A' 'U' 'A' 'A' 'A' 'U' 'M' 'A' 'A'
 'M' 'M' 'A' 'A' 'M' 'U' 'U' 'U' 'M' 'M' 'M' 'U' 'A' 'M' 'A' 'U' 'U' 'U'
 'U' 'M' 'A' 'M' 'M' 'A' 'A' 'A' 'A' 'A' 'A' 'A' 'A' 'U' 'U' 'U' 'A' 'M'
 'M' 'M' 'A' 'U' 'A' 'U' 'U' 'U' 'A' 'M' 'U' 'U' 'A' 'U' 'A' 'U' 'M' 'M'
 'U' 'U' 'U' 'M' 'A' 'U' 'A' 'A' 'U' 'A' 'M' 'M' 'M' 'U' 'U' 'A' 'A' 'U'
 'A' 'M' 'M' 'M' 'A' 'M' 'U' 'M' 'A' 'M' 'U' 'M' 'M' 'U' 'U' 'U' 'M' 'A']"
49801,2,123,63,60,75,0,0,"['A' 'U' 'U' 'U' 'U' 'M' 'U' 'M' 'A' 'U' 'A' 'M' 'A' 'A' 'A' 'M' 'A' 'M'
 'A' 'A' 'U' 'A' 'M' 'U' 'U' 'A' 'A' 'A' 'A' 'U' 'U' 'M' 'U' 'U' 'U' 'M'
 'A' 'A' 'A' 'U' 'A' 'A' 'A' 'M' 'U' 'M' 'A' 'U' 'U' 'U' 'U' 'M' 'M' 'U'
 'M' 'U' 'A' 'U' 'M' 'U' 'M' 'U' 'U' 'M' 'A' 'M' 'M' 'U' 'M' 'M' 'M' 'M'
 'M' 'M' 'M' 'U' 'U' 'U' 'U' 'M' 'A' 'U' 'U' 'U' 'U' 'M' 'M' 'U' 'U' 'M'
 'M' 'M' 'M' 'U' 'M' 'A' 'U' 'U' 'A' 'A' 'M' 'U' 'A' 'A' 'A' 'M' 'A' 'A'
 'M' 'M' 'A' 'A' 'U' 'U' 'U' 'U' 'M' 'M' 'M' 'U' 'A' 'A' 'A' 'M' 'U' 'U'
 'U' 'M' 'A' 'M' 'M' 'A' 'A' 'A' 'A' 'A' 'A' 'A' 'A' 'U' 'U' 'A' 'A' 'U'
 'M' 'U' 'A' 'U' 'U' 'U' 'U' 'U' 'A' 'A' 'M' 'U' 'U' 'U' 'A' 'U' 'M' 'M'
 'U' 'U' 'U' 'M' 'A' 'U' 'A' 'A' 'A' 'A' 'M' 'M' 'M' 'U' 'U' 'U' 'A' 'A'
 'A' 'M' 'U' 'M' 'A' 'U' 'M' 'M' 'U' 'M' 'U' 'M' 'M' 'U' 'U' 'A' 'M' 'A']"
49901,0,115,57,58,83,0,0,"['A' 'A' 'M' 'A' 'U' 'U' 'U' 'U' 'U' 'U' 'A' 'M' 'A' 'U' 'A' 'M' 'A' 'M'
 'A' 'A' 'U' 'A' 'M' 'M' 'U' 'U' 'A' 'A' 'U' 'U' 'U' 'M' 'U' 'M' 'U' 'M'
 'A' 'A' 'A' 'U' 'A' 'A' 'M' 'M' 'U' 'M' 'U' 'U' 'M' 'U' 'U' 'M' 'U' 'U'
 'M' 'U' 'U' 'M' 'M' 'U' 'M' 'U' 'U' 'M' 'A' 'M' 'M' 'M' 'M' 'M' 'M' 'M'
 'U' 'M' 'M' 'U' 'U' 'U' 'U' 'U' 'A' 'M' 'U' 'U' 'U' 'M' 'U' 'U' 'U' 'U'
 'M' 'M' 'U' 'U' 'M' 'A' 'U' 'M' 'A' 'U' 'M' 'U' 'A' 'A' 'M' 'U' 'A' 'A'
 'M' 'M' 'A' 'A' 'U' 'M' 'A' 'U' 'M' 'M' 'A' 'U' 'A' 'A' 'U' 'U' 'U' 'A'
 'U' 'M' 'U' 'M' 'M' 'A' 'A' 'A' 'A' 'A' 'A' 'A' 'A' 'U' 'M' 'A' 'A' 'U'
 'M' 'U' 'A' 'U' 'U' 'U' 'U' 'U' 'A' 'A' 'M' 'U' 'A' 'U' 'A' 'U' 'M' 'M'
 'U' 'U' 'U' 'M' 'U' 'U' 'A' 'A' 'U' 'A' 'M' 'U' 'M' 'U' 'U' 'U' 'A' 'A'
 'A' 'U' 'A' 'M' 'A' 'U' 'M' 'M' 'U' 'M' 'U' 'M' 'U' 'U' 'U' 'A' 'M' 'A']"
